,state_id,state_name,area_type,age_group,education_level,male,female,total
0,0,INDIA,Total,All ages,Total,623270258,587584719,1210854977
1,0,INDIA,Total,0-6,Total,85752254,78762999,164515253
2,0,INDIA,Total,7,Total,12903364,11923276,24826640
3,0,INDIA,Total,8,Total,14061937,12906436,26968373
4,0,INDIA,Total,9,Total,12214985,11209653,23424638
5,0,INDIA,Total,10,Total,16089436,14462671,30552107
6,0,INDIA,Total,11,Total,12962604,11778342,24740946
7,0,INDIA,Total,12,Total,14637892,13239415,27877307
8,0,INDIA,Total,13,Total,12563775,11716908,24280683
9,0,INDIA,Total,14,Total,13165128,12093041,25258169
10,0,INDIA,Total,15,Total,13739746,12159708,25899454
11,0,INDIA,Total,16,Total,13027935,11564358,24592293
12,0,INDIA,Total,17,Total,11349449,9868018,21217467
13,0,INDIA,Total,18,Total,15020851,12937296,27958147
14,0,INDIA,Total,19,Total,10844415,10014673,20859088
15,0,INDIA,Total,20-24,Total,57584693,53839529,111424222
16,0,INDIA,Total,25-29,Total,51344208,50069757,101413965
17,0,INDIA,Total,30-34,Total,44660674,43934277,88594951
18,0,INDIA,Total,35-39,Total,42919381,42221303,85140684
19,0,INDIA,Total,40-44,Total,37545386,34892726,72438112
20,0,INDIA,Total,45-49,Total,32138114,30180213,62318327
21,0,INDIA,Total,50-54,Total,25843266,23225988,49069254
22,0,INDIA,Total,55-59,Total,19456012,19690043,39146055
23,0,INDIA,Total,60-64,Total,18701749,18961958,37663707
24,0,INDIA,Total,65-69,Total,12944326,13510657,26454983
25,0,INDIA,Total,70-74,Total,9651499,9557343,19208842
26,0,INDIA,Total,75-79,Total,4490603,4741900,9232503
27,0,INDIA,Total,80+,Total,5283695,6005310,11289005
28,0,INDIA,Total,Age not stated,Total,2372881,2116921,4489802
29,0,INDIA,Rural,All ages,Total,427781058,405967794,833748852
30,0,INDIA,Rural,0-6,Total,63084449,58238416,121322865
31,0,INDIA,Rural,7,Total,9399767,8750077,18149844
32,0,INDIA,Rural,8,Total,10497018,9709963,20206981
33,0,INDIA,Rural,9,Total,8880402,8234180,17114582
34,0,INDIA,Rural,10,Total,11899758,10788008,22687766
35,0,INDIA,Rural,11,Total,9319598,8531715,17851313
36,0,INDIA,Rural,12,Total,10781450,9807869,20589319
37,0,INDIA,Rural,13,Total,9024384,8465789,17490173
38,0,INDIA,Rural,14,Total,9462968,8722955,18185923
39,0,INDIA,Rural,15,Total,9873668,8719978,18593646
40,0,INDIA,Rural,16,Total,9253785,8180014,17433799
41,0,INDIA,Rural,17,Total,7754277,6694496,14448773
42,0,INDIA,Rural,18,Total,10518623,9040991,19559614
43,0,INDIA,Rural,19,Total,7170204,6696436,13866640
44,0,INDIA,Rural,20-24,Total,38138662,35696384,73835046
45,0,INDIA,Rural,25-29,Total,33375989,32692281,66068270
46,0,INDIA,Rural,30-34,Total,28934192,28977587,57911779
47,0,INDIA,Rural,35-39,Total,28125561,27937146,56062707
48,0,INDIA,Rural,40-44,Total,24565235,23015773,47581008
49,0,INDIA,Rural,45-49,Total,20864270,19823958,40688228
50,0,INDIA,Rural,50-54,Total,16789547,15242241,32031788
51,0,INDIA,Rural,55-59,Total,12536529,13324985,25861514
52,0,INDIA,Rural,60-64,Total,12931592,13359653,26291245
53,0,INDIA,Rural,65-69,Total,9208311,9707959,18916270
54,0,INDIA,Rural,70-74,Total,6978179,6829421,13807600
55,0,INDIA,Rural,75-79,Total,3113424,3270293,6383717
56,0,INDIA,Rural,80+,Total,3765796,4129194,7894990
57,0,INDIA,Rural,Age not stated,Total,1533420,1380032,2913452
58,0,INDIA,Urban,All ages,Total,195489200,181616925,377106125
59,0,INDIA,Urban,0-6,Total,22667805,20524583,43192388
60,0,INDIA,Urban,7,Total,3503597,3173199,6676796
61,0,INDIA,Urban,8,Total,3564919,3196473,6761392
62,0,INDIA,Urban,9,Total,3334583,2975473,6310056
63,0,INDIA,Urban,10,Total,4189678,3674663,7864341
64,0,INDIA,Urban,11,Total,3643006,3246627,6889633
65,0,INDIA,Urban,12,Total,3856442,3431546,7287988
66,0,INDIA,Urban,13,Total,3539391,3251119,6790510
67,0,INDIA,Urban,14,Total,3702160,3370086,7072246
68,0,INDIA,Urban,15,Total,3866078,3439730,7305808
69,0,INDIA,Urban,16,Total,3774150,3384344,7158494
70,0,INDIA,Urban,17,Total,3595172,3173522,6768694
71,0,INDIA,Urban,18,Total,4502228,3896305,8398533
72,0,INDIA,Urban,19,Total,3674211,3318237,6992448
73,0,INDIA,Urban,20-24,Total,19446031,18143145,37589176
74,0,INDIA,Urban,25-29,Total,17968219,17377476,35345695
75,0,INDIA,Urban,30-34,Total,15726482,14956690,30683172
76,0,INDIA,Urban,35-39,Total,14793820,14284157,29077977
77,0,INDIA,Urban,40-44,Total,12980151,11876953,24857104
78,0,INDIA,Urban,45-49,Total,11273844,10356255,21630099
79,0,INDIA,Urban,50-54,Total,9053719,7983747,17037466
80,0,INDIA,Urban,55-59,Total,6919483,6365058,13284541
81,0,INDIA,Urban,60-64,Total,5770157,5602305,11372462
82,0,INDIA,Urban,65-69,Total,3736015,3802698,7538713
83,0,INDIA,Urban,70-74,Total,2673320,2727922,5401242
84,0,INDIA,Urban,75-79,Total,1377179,1471607,2848786
85,0,INDIA,Urban,80+,Total,1517899,1876116,3394015
86,0,INDIA,Urban,Age not stated,Total,839461,736889,1576350
87,1,State - JAMMU & KASHMIR,Total,All ages,Total,6640662,5900640,12541302
88,1,State - JAMMU & KASHMIR,Total,0-6,Total,1084355,934550,2018905
89,1,State - JAMMU & KASHMIR,Total,7,Total,142123,128415,270538
90,1,State - JAMMU & KASHMIR,Total,8,Total,150470,134844,285314
91,1,State - JAMMU & KASHMIR,Total,9,Total,133371,118729,252100
92,1,State - JAMMU & KASHMIR,Total,10,Total,166773,147510,314283
93,1,State - JAMMU & KASHMIR,Total,11,Total,149261,132788,282049
94,1,State - JAMMU & KASHMIR,Total,12,Total,152365,137433,289798
95,1,State - JAMMU & KASHMIR,Total,13,Total,136728,124351,261079
96,1,State - JAMMU & KASHMIR,Total,14,Total,139728,126916,266644
97,1,State - JAMMU & KASHMIR,Total,15,Total,140502,130490,270992
98,1,State - JAMMU & KASHMIR,Total,16,Total,136077,126964,263041
99,1,State - JAMMU & KASHMIR,Total,17,Total,115421,106198,221619
100,1,State - JAMMU & KASHMIR,Total,18,Total,141830,134386,276216
101,1,State - JAMMU & KASHMIR,Total,19,Total,106532,99062,205594
102,1,State - JAMMU & KASHMIR,Total,20-24,Total,603578,557335,1160913
103,1,State - JAMMU & KASHMIR,Total,25-29,Total,584559,501563,1086122
104,1,State - JAMMU & KASHMIR,Total,30-34,Total,495746,431157,926903
105,1,State - JAMMU & KASHMIR,Total,35-39,Total,441265,396680,837945
106,1,State - JAMMU & KASHMIR,Total,40-44,Total,387739,326346,714085
107,1,State - JAMMU & KASHMIR,Total,45-49,Total,311560,279230,590790
108,1,State - JAMMU & KASHMIR,Total,50-54,Total,255599,212967,468566
109,1,State - JAMMU & KASHMIR,Total,55-59,Total,172753,167278,340031
110,1,State - JAMMU & KASHMIR,Total,60-64,Total,173427,149299,322726
111,1,State - JAMMU & KASHMIR,Total,65-69,Total,102743,101222,203965
112,1,State - JAMMU & KASHMIR,Total,70-74,Total,97472,86547,184019
113,1,State - JAMMU & KASHMIR,Total,75-79,Total,43094,41982,85076
114,1,State - JAMMU & KASHMIR,Total,80+,Total,65844,61026,126870
115,1,State - JAMMU & KASHMIR,Total,Age not stated,Total,9747,5372,15119
116,1,State - JAMMU & KASHMIR,Rural,All ages,Total,4774477,4333583,9108060
117,1,State - JAMMU & KASHMIR,Rural,0-6,Total,854141,738867,1593008
118,1,State - JAMMU & KASHMIR,Rural,7,Total,111149,100775,211924
119,1,State - JAMMU & KASHMIR,Rural,8,Total,117665,106165,223830
120,1,State - JAMMU & KASHMIR,Rural,9,Total,102930,92653,195583
121,1,State - JAMMU & KASHMIR,Rural,10,Total,129213,115644,244857
122,1,State - JAMMU & KASHMIR,Rural,11,Total,115820,104224,220044
123,1,State - JAMMU & KASHMIR,Rural,12,Total,118391,107675,226066
124,1,State - JAMMU & KASHMIR,Rural,13,Total,105405,96663,202068
125,1,State - JAMMU & KASHMIR,Rural,14,Total,106682,97519,204201
126,1,State - JAMMU & KASHMIR,Rural,15,Total,106785,100355,207140
127,1,State - JAMMU & KASHMIR,Rural,16,Total,102617,96777,199394
128,1,State - JAMMU & KASHMIR,Rural,17,Total,85481,78896,164377
129,1,State - JAMMU & KASHMIR,Rural,18,Total,105200,100679,205879
130,1,State - JAMMU & KASHMIR,Rural,19,Total,77015,72303,149318
131,1,State - JAMMU & KASHMIR,Rural,20-24,Total,423292,404069,827361
132,1,State - JAMMU & KASHMIR,Rural,25-29,Total,385544,353024,738568
133,1,State - JAMMU & KASHMIR,Rural,30-34,Total,333062,303075,636137
134,1,State - JAMMU & KASHMIR,Rural,35-39,Total,294268,274557,568825
135,1,State - JAMMU & KASHMIR,Rural,40-44,Total,256988,226234,483222
136,1,State - JAMMU & KASHMIR,Rural,45-49,Total,205036,190923,395959
137,1,State - JAMMU & KASHMIR,Rural,50-54,Total,173804,146188,319992
138,1,State - JAMMU & KASHMIR,Rural,55-59,Total,114641,112854,227495
139,1,State - JAMMU & KASHMIR,Rural,60-64,Total,121240,104765,226005
140,1,State - JAMMU & KASHMIR,Rural,65-69,Total,70780,69940,140720
141,1,State - JAMMU & KASHMIR,Rural,70-74,Total,70777,61307,132084
142,1,State - JAMMU & KASHMIR,Rural,75-79,Total,29980,28938,58918
143,1,State - JAMMU & KASHMIR,Rural,80+,Total,49712,44530,94242
144,1,State - JAMMU & KASHMIR,Rural,Age not stated,Total,6859,3984,10843
145,1,State - JAMMU & KASHMIR,Urban,All ages,Total,1866185,1567057,3433242
146,1,State - JAMMU & KASHMIR,Urban,0-6,Total,230214,195683,425897
147,1,State - JAMMU & KASHMIR,Urban,7,Total,30974,27640,58614
148,1,State - JAMMU & KASHMIR,Urban,8,Total,32805,28679,61484
149,1,State - JAMMU & KASHMIR,Urban,9,Total,30441,26076,56517
150,1,State - JAMMU & KASHMIR,Urban,10,Total,37560,31866,69426
151,1,State - JAMMU & KASHMIR,Urban,11,Total,33441,28564,62005
152,1,State - JAMMU & KASHMIR,Urban,12,Total,33974,29758,63732
153,1,State - JAMMU & KASHMIR,Urban,13,Total,31323,27688,59011
154,1,State - JAMMU & KASHMIR,Urban,14,Total,33046,29397,62443
155,1,State - JAMMU & KASHMIR,Urban,15,Total,33717,30135,63852
156,1,State - JAMMU & KASHMIR,Urban,16,Total,33460,30187,63647
157,1,State - JAMMU & KASHMIR,Urban,17,Total,29940,27302,57242
158,1,State - JAMMU & KASHMIR,Urban,18,Total,36630,33707,70337
159,1,State - JAMMU & KASHMIR,Urban,19,Total,29517,26759,56276
160,1,State - JAMMU & KASHMIR,Urban,20-24,Total,180286,153266,333552
161,1,State - JAMMU & KASHMIR,Urban,25-29,Total,199015,148539,347554
162,1,State - JAMMU & KASHMIR,Urban,30-34,Total,162684,128082,290766
163,1,State - JAMMU & KASHMIR,Urban,35-39,Total,146997,122123,269120
164,1,State - JAMMU & KASHMIR,Urban,40-44,Total,130751,100112,230863
165,1,State - JAMMU & KASHMIR,Urban,45-49,Total,106524,88307,194831
166,1,State - JAMMU & KASHMIR,Urban,50-54,Total,81795,66779,148574
167,1,State - JAMMU & KASHMIR,Urban,55-59,Total,58112,54424,112536
168,1,State - JAMMU & KASHMIR,Urban,60-64,Total,52187,44534,96721
169,1,State - JAMMU & KASHMIR,Urban,65-69,Total,31963,31282,63245
170,1,State - JAMMU & KASHMIR,Urban,70-74,Total,26695,25240,51935
171,1,State - JAMMU & KASHMIR,Urban,75-79,Total,13114,13044,26158
172,1,State - JAMMU & KASHMIR,Urban,80+,Total,16132,16496,32628
173,1,State - JAMMU & KASHMIR,Urban,Age not stated,Total,2888,1388,4276
174,2,State - HIMACHAL PRADESH,Total,All ages,Total,3481873,3382729,6864602
175,2,State - HIMACHAL PRADESH,Total,0-6,Total,407459,370439,777898
176,2,State - HIMACHAL PRADESH,Total,7,Total,63842,58197,122039
177,2,State - HIMACHAL PRADESH,Total,8,Total,61593,55531,117124
178,2,State - HIMACHAL PRADESH,Total,9,Total,63574,55526,119100
179,2,State - HIMACHAL PRADESH,Total,10,Total,71647,62949,134596
180,2,State - HIMACHAL PRADESH,Total,11,Total,67693,59754,127447
181,2,State - HIMACHAL PRADESH,Total,12,Total,66799,59031,125830
182,2,State - HIMACHAL PRADESH,Total,13,Total,65336,58789,124125
183,2,State - HIMACHAL PRADESH,Total,14,Total,66765,60461,127226
184,2,State - HIMACHAL PRADESH,Total,15,Total,67225,60153,127378
185,2,State - HIMACHAL PRADESH,Total,16,Total,66658,59752,126410
186,2,State - HIMACHAL PRADESH,Total,17,Total,65721,58864,124585
187,2,State - HIMACHAL PRADESH,Total,18,Total,72265,64494,136759
188,2,State - HIMACHAL PRADESH,Total,19,Total,64860,60469,125329
189,2,State - HIMACHAL PRADESH,Total,20-24,Total,323720,320146,643866
190,2,State - HIMACHAL PRADESH,Total,25-29,Total,290125,299035,589160
191,2,State - HIMACHAL PRADESH,Total,30-34,Total,271253,275104,546357
192,2,State - HIMACHAL PRADESH,Total,35-39,Total,258230,259736,517966
193,2,State - HIMACHAL PRADESH,Total,40-44,Total,222269,223291,445560
194,2,State - HIMACHAL PRADESH,Total,45-49,Total,197642,197486,395128
195,2,State - HIMACHAL PRADESH,Total,50-54,Total,165724,164963,330687
196,2,State - HIMACHAL PRADESH,Total,55-59,Total,135245,131615,266860
197,2,State - HIMACHAL PRADESH,Total,60-64,Total,115464,115908,231372
198,2,State - HIMACHAL PRADESH,Total,65-69,Total,78387,80220,158607
199,2,State - HIMACHAL PRADESH,Total,70-74,Total,62119,68468,130587
200,2,State - HIMACHAL PRADESH,Total,75-79,Total,36440,39266,75706
201,2,State - HIMACHAL PRADESH,Total,80+,Total,48465,58272,106737
202,2,State - HIMACHAL PRADESH,Total,Age not stated,Total,5353,4810,10163
203,2,State - HIMACHAL PRADESH,Rural,All ages,Total,3110345,3065705,6176050
204,2,State - HIMACHAL PRADESH,Rural,0-6,Total,372854,339968,712822
205,2,State - HIMACHAL PRADESH,Rural,7,Total,58014,53171,111185
206,2,State - HIMACHAL PRADESH,Rural,8,Total,55716,50577,106293
207,2,State - HIMACHAL PRADESH,Rural,9,Total,57600,50590,108190
208,2,State - HIMACHAL PRADESH,Rural,10,Total,64852,57482,122334
209,2,State - HIMACHAL PRADESH,Rural,11,Total,61000,54507,115507
210,2,State - HIMACHAL PRADESH,Rural,12,Total,60324,53913,114237
211,2,State - HIMACHAL PRADESH,Rural,13,Total,59005,53673,112678
212,2,State - HIMACHAL PRADESH,Rural,14,Total,60319,55190,115509
213,2,State - HIMACHAL PRADESH,Rural,15,Total,60443,54671,115114
214,2,State - HIMACHAL PRADESH,Rural,16,Total,59746,54335,114081
215,2,State - HIMACHAL PRADESH,Rural,17,Total,59015,53324,112339
216,2,State - HIMACHAL PRADESH,Rural,18,Total,64005,58515,122520
217,2,State - HIMACHAL PRADESH,Rural,19,Total,57345,54592,111937
218,2,State - HIMACHAL PRADESH,Rural,20-24,Total,285167,288272,573439
219,2,State - HIMACHAL PRADESH,Rural,25-29,Total,255016,268589,523605
220,2,State - HIMACHAL PRADESH,Rural,30-34,Total,239272,246103,485375
221,2,State - HIMACHAL PRADESH,Rural,35-39,Total,227906,231369,459275
222,2,State - HIMACHAL PRADESH,Rural,40-44,Total,195137,199498,394635
223,2,State - HIMACHAL PRADESH,Rural,45-49,Total,173489,177304,350793
224,2,State - HIMACHAL PRADESH,Rural,50-54,Total,145792,149619,295411
225,2,State - HIMACHAL PRADESH,Rural,55-59,Total,119998,120095,240093
226,2,State - HIMACHAL PRADESH,Rural,60-64,Total,105331,106932,212263
227,2,State - HIMACHAL PRADESH,Rural,65-69,Total,71950,74146,146096
228,2,State - HIMACHAL PRADESH,Rural,70-74,Total,57250,63682,120932
229,2,State - HIMACHAL PRADESH,Rural,75-79,Total,33561,36397,69958
230,2,State - HIMACHAL PRADESH,Rural,80+,Total,45339,54704,100043
231,2,State - HIMACHAL PRADESH,Rural,Age not stated,Total,4899,4487,9386
232,2,State - HIMACHAL PRADESH,Urban,All ages,Total,371528,317024,688552
233,2,State - HIMACHAL PRADESH,Urban,0-6,Total,34605,30471,65076
234,2,State - HIMACHAL PRADESH,Urban,7,Total,5828,5026,10854
235,2,State - HIMACHAL PRADESH,Urban,8,Total,5877,4954,10831
236,2,State - HIMACHAL PRADESH,Urban,9,Total,5974,4936,10910
237,2,State - HIMACHAL PRADESH,Urban,10,Total,6795,5467,12262
238,2,State - HIMACHAL PRADESH,Urban,11,Total,6693,5247,11940
239,2,State - HIMACHAL PRADESH,Urban,12,Total,6475,5118,11593
240,2,State - HIMACHAL PRADESH,Urban,13,Total,6331,5116,11447
241,2,State - HIMACHAL PRADESH,Urban,14,Total,6446,5271,11717
242,2,State - HIMACHAL PRADESH,Urban,15,Total,6782,5482,12264
243,2,State - HIMACHAL PRADESH,Urban,16,Total,6912,5417,12329
244,2,State - HIMACHAL PRADESH,Urban,17,Total,6706,5540,12246
245,2,State - HIMACHAL PRADESH,Urban,18,Total,8260,5979,14239
246,2,State - HIMACHAL PRADESH,Urban,19,Total,7515,5877,13392
247,2,State - HIMACHAL PRADESH,Urban,20-24,Total,38553,31874,70427
248,2,State - HIMACHAL PRADESH,Urban,25-29,Total,35109,30446,65555
249,2,State - HIMACHAL PRADESH,Urban,30-34,Total,31981,29001,60982
250,2,State - HIMACHAL PRADESH,Urban,35-39,Total,30324,28367,58691
251,2,State - HIMACHAL PRADESH,Urban,40-44,Total,27132,23793,50925
252,2,State - HIMACHAL PRADESH,Urban,45-49,Total,24153,20182,44335
253,2,State - HIMACHAL PRADESH,Urban,50-54,Total,19932,15344,35276
254,2,State - HIMACHAL PRADESH,Urban,55-59,Total,15247,11520,26767
255,2,State - HIMACHAL PRADESH,Urban,60-64,Total,10133,8976,19109
256,2,State - HIMACHAL PRADESH,Urban,65-69,Total,6437,6074,12511
257,2,State - HIMACHAL PRADESH,Urban,70-74,Total,4869,4786,9655
258,2,State - HIMACHAL PRADESH,Urban,75-79,Total,2879,2869,5748
259,2,State - HIMACHAL PRADESH,Urban,80+,Total,3126,3568,6694
260,2,State - HIMACHAL PRADESH,Urban,Age not stated,Total,454,323,777
261,3,State - PUNJAB,Total,All ages,Total,14639465,13103873,27743338
262,3,State - PUNJAB,Total,0-6,Total,1665994,1410225,3076219
263,3,State - PUNJAB,Total,7,Total,262427,220853,483280
264,3,State - PUNJAB,Total,8,Total,263834,215613,479447
265,3,State - PUNJAB,Total,9,Total,259383,203219,462602
266,3,State - PUNJAB,Total,10,Total,303757,233267,537024
267,3,State - PUNJAB,Total,11,Total,274903,213274,488177
268,3,State - PUNJAB,Total,12,Total,289167,227788,516955
269,3,State - PUNJAB,Total,13,Total,283488,227353,510841
270,3,State - PUNJAB,Total,14,Total,294215,236190,530405
271,3,State - PUNJAB,Total,15,Total,309954,245771,555725
272,3,State - PUNJAB,Total,16,Total,311992,250175,562167
273,3,State - PUNJAB,Total,17,Total,299464,237455,536919
274,3,State - PUNJAB,Total,18,Total,355581,276032,631613
275,3,State - PUNJAB,Total,19,Total,293189,238070,531259
276,3,State - PUNJAB,Total,20-24,Total,1465531,1311105,2776636
277,3,State - PUNJAB,Total,25-29,Total,1270405,1193456,2463861
278,3,State - PUNJAB,Total,30-34,Total,1082533,1034006,2116539
279,3,State - PUNJAB,Total,35-39,Total,1010862,978209,1989071
280,3,State - PUNJAB,Total,40-44,Total,909208,879261,1788469
281,3,State - PUNJAB,Total,45-49,Total,818135,769636,1587771
282,3,State - PUNJAB,Total,50-54,Total,663664,590800,1254464
283,3,State - PUNJAB,Total,55-59,Total,485845,470710,956555
284,3,State - PUNJAB,Total,60-64,Total,482483,514107,996590
285,3,State - PUNJAB,Total,65-69,Total,372806,346782,719588
286,3,State - PUNJAB,Total,70-74,Total,272120,241352,513472
287,3,State - PUNJAB,Total,75-79,Total,130203,126463,256666
288,3,State - PUNJAB,Total,80+,Total,186050,193451,379501
289,3,State - PUNJAB,Total,Age not stated,Total,22272,19250,41522
290,3,State - PUNJAB,Rural,All ages,Total,9093476,8250716,17344192
291,3,State - PUNJAB,Rural,0-6,Total,1055297,890205,1945502
292,3,State - PUNJAB,Rural,7,Total,167169,140944,308113
293,3,State - PUNJAB,Rural,8,Total,169036,138615,307651
294,3,State - PUNJAB,Rural,9,Total,166387,130738,297125
295,3,State - PUNJAB,Rural,10,Total,192450,148780,341230
296,3,State - PUNJAB,Rural,11,Total,176351,137011,313362
297,3,State - PUNJAB,Rural,12,Total,187214,147877,335091
298,3,State - PUNJAB,Rural,13,Total,183924,149015,332939
299,3,State - PUNJAB,Rural,14,Total,191427,154779,346206
300,3,State - PUNJAB,Rural,15,Total,200124,161088,361212
301,3,State - PUNJAB,Rural,16,Total,202731,164826,367557
302,3,State - PUNJAB,Rural,17,Total,192977,154984,347961
303,3,State - PUNJAB,Rural,18,Total,225644,178798,404442
304,3,State - PUNJAB,Rural,19,Total,182355,150900,333255
305,3,State - PUNJAB,Rural,20-24,Total,888739,818094,1706833
306,3,State - PUNJAB,Rural,25-29,Total,738196,717260,1455456
307,3,State - PUNJAB,Rural,30-34,Total,636268,627238,1263506
308,3,State - PUNJAB,Rural,35-39,Total,604249,598593,1202842
309,3,State - PUNJAB,Rural,40-44,Total,555906,546738,1102644
310,3,State - PUNJAB,Rural,45-49,Total,495583,469359,964942
311,3,State - PUNJAB,Rural,50-54,Total,397863,351994,749857
312,3,State - PUNJAB,Rural,55-59,Total,283796,285350,569146
313,3,State - PUNJAB,Rural,60-64,Total,309825,344904,654729
314,3,State - PUNJAB,Rural,65-69,Total,257824,238287,496111
315,3,State - PUNJAB,Rural,70-74,Total,191121,164996,356117
316,3,State - PUNJAB,Rural,75-79,Total,89364,86608,175972
317,3,State - PUNJAB,Rural,80+,Total,135823,138958,274781
318,3,State - PUNJAB,Rural,Age not stated,Total,15833,13777,29610
319,3,State - PUNJAB,Urban,All ages,Total,5545989,4853157,10399146
320,3,State - PUNJAB,Urban,0-6,Total,610697,520020,1130717
321,3,State - PUNJAB,Urban,7,Total,95258,79909,175167
322,3,State - PUNJAB,Urban,8,Total,94798,76998,171796
323,3,State - PUNJAB,Urban,9,Total,92996,72481,165477
324,3,State - PUNJAB,Urban,10,Total,111307,84487,195794
325,3,State - PUNJAB,Urban,11,Total,98552,76263,174815
326,3,State - PUNJAB,Urban,12,Total,101953,79911,181864
327,3,State - PUNJAB,Urban,13,Total,99564,78338,177902
328,3,State - PUNJAB,Urban,14,Total,102788,81411,184199
329,3,State - PUNJAB,Urban,15,Total,109830,84683,194513
330,3,State - PUNJAB,Urban,16,Total,109261,85349,194610
331,3,State - PUNJAB,Urban,17,Total,106487,82471,188958
332,3,State - PUNJAB,Urban,18,Total,129937,97234,227171
333,3,State - PUNJAB,Urban,19,Total,110834,87170,198004
334,3,State - PUNJAB,Urban,20-24,Total,576792,493011,1069803
335,3,State - PUNJAB,Urban,25-29,Total,532209,476196,1008405
336,3,State - PUNJAB,Urban,30-34,Total,446265,406768,853033
337,3,State - PUNJAB,Urban,35-39,Total,406613,379616,786229
338,3,State - PUNJAB,Urban,40-44,Total,353302,332523,685825
339,3,State - PUNJAB,Urban,45-49,Total,322552,300277,622829
340,3,State - PUNJAB,Urban,50-54,Total,265801,238806,504607
341,3,State - PUNJAB,Urban,55-59,Total,202049,185360,387409
342,3,State - PUNJAB,Urban,60-64,Total,172658,169203,341861
343,3,State - PUNJAB,Urban,65-69,Total,114982,108495,223477
344,3,State - PUNJAB,Urban,70-74,Total,80999,76356,157355
345,3,State - PUNJAB,Urban,75-79,Total,40839,39855,80694
346,3,State - PUNJAB,Urban,80+,Total,50227,54493,104720
347,3,State - PUNJAB,Urban,Age not stated,Total,6439,5473,11912
348,4,State - CHANDIGARH,Total,All ages,Total,580663,474787,1055450
349,4,State - CHANDIGARH,Total,0-6,Total,63536,55898,119434
350,4,State - CHANDIGARH,Total,7,Total,9987,8637,18624
351,4,State - CHANDIGARH,Total,8,Total,9413,7858,17271
352,4,State - CHANDIGARH,Total,9,Total,9666,8053,17719
353,4,State - CHANDIGARH,Total,10,Total,11410,8950,20360
354,4,State - CHANDIGARH,Total,11,Total,10180,8116,18296
355,4,State - CHANDIGARH,Total,12,Total,10461,8212,18673
356,4,State - CHANDIGARH,Total,13,Total,9846,7906,17752
357,4,State - CHANDIGARH,Total,14,Total,10243,8140,18383
358,4,State - CHANDIGARH,Total,15,Total,10603,8335,18938
359,4,State - CHANDIGARH,Total,16,Total,11116,8438,19554
360,4,State - CHANDIGARH,Total,17,Total,11139,7977,19116
361,4,State - CHANDIGARH,Total,18,Total,14792,9868,24660
362,4,State - CHANDIGARH,Total,19,Total,12871,9279,22150
363,4,State - CHANDIGARH,Total,20-24,Total,68467,52777,121244
364,4,State - CHANDIGARH,Total,25-29,Total,60694,49543,110237
365,4,State - CHANDIGARH,Total,30-34,Total,49625,41178,90803
366,4,State - CHANDIGARH,Total,35-39,Total,45566,38106,83672
367,4,State - CHANDIGARH,Total,40-44,Total,37268,31653,68921
368,4,State - CHANDIGARH,Total,45-49,Total,32893,27459,60352
369,4,State - CHANDIGARH,Total,50-54,Total,26108,20834,46942
370,4,State - CHANDIGARH,Total,55-59,Total,19745,15180,34925
371,4,State - CHANDIGARH,Total,60-64,Total,13530,12271,25801
372,4,State - CHANDIGARH,Total,65-69,Total,8250,7589,15839
373,4,State - CHANDIGARH,Total,70-74,Total,5998,5387,11385
374,4,State - CHANDIGARH,Total,75-79,Total,3255,3167,6422
375,4,State - CHANDIGARH,Total,80+,Total,3800,3831,7631
376,4,State - CHANDIGARH,Total,Age not stated,Total,201,145,346
377,4,State - CHANDIGARH,Rural,All ages,Total,17150,11841,28991
378,4,State - CHANDIGARH,Rural,0-6,Total,2282,1988,4270
379,4,State - CHANDIGARH,Rural,7,Total,332,264,596
380,4,State - CHANDIGARH,Rural,8,Total,298,257,555
381,4,State - CHANDIGARH,Rural,9,Total,271,250,521
382,4,State - CHANDIGARH,Rural,10,Total,350,265,615
383,4,State - CHANDIGARH,Rural,11,Total,302,245,547
384,4,State - CHANDIGARH,Rural,12,Total,299,200,499
385,4,State - CHANDIGARH,Rural,13,Total,232,195,427
386,4,State - CHANDIGARH,Rural,14,Total,238,211,449
387,4,State - CHANDIGARH,Rural,15,Total,302,210,512
388,4,State - CHANDIGARH,Rural,16,Total,324,181,505
389,4,State - CHANDIGARH,Rural,17,Total,284,177,461
390,4,State - CHANDIGARH,Rural,18,Total,486,205,691
391,4,State - CHANDIGARH,Rural,19,Total,391,205,596
392,4,State - CHANDIGARH,Rural,20-24,Total,2255,1338,3593
393,4,State - CHANDIGARH,Rural,25-29,Total,2260,1546,3806
394,4,State - CHANDIGARH,Rural,30-34,Total,1902,1199,3101
395,4,State - CHANDIGARH,Rural,35-39,Total,1455,866,2321
396,4,State - CHANDIGARH,Rural,40-44,Total,947,600,1547
397,4,State - CHANDIGARH,Rural,45-49,Total,638,411,1049
398,4,State - CHANDIGARH,Rural,50-54,Total,415,308,723
399,4,State - CHANDIGARH,Rural,55-59,Total,272,231,503
400,4,State - CHANDIGARH,Rural,60-64,Total,277,204,481
401,4,State - CHANDIGARH,Rural,65-69,Total,140,115,255
402,4,State - CHANDIGARH,Rural,70-74,Total,96,85,181
403,4,State - CHANDIGARH,Rural,75-79,Total,43,32,75
404,4,State - CHANDIGARH,Rural,80+,Total,55,51,106
405,4,State - CHANDIGARH,Rural,Age not stated,Total,4,2,6
406,4,State - CHANDIGARH,Urban,All ages,Total,563513,462946,1026459
407,4,State - CHANDIGARH,Urban,0-6,Total,61254,53910,115164
408,4,State - CHANDIGARH,Urban,7,Total,9655,8373,18028
409,4,State - CHANDIGARH,Urban,8,Total,9115,7601,16716
410,4,State - CHANDIGARH,Urban,9,Total,9395,7803,17198
411,4,State - CHANDIGARH,Urban,10,Total,11060,8685,19745
412,4,State - CHANDIGARH,Urban,11,Total,9878,7871,17749
413,4,State - CHANDIGARH,Urban,12,Total,10162,8012,18174
414,4,State - CHANDIGARH,Urban,13,Total,9614,7711,17325
415,4,State - CHANDIGARH,Urban,14,Total,10005,7929,17934
416,4,State - CHANDIGARH,Urban,15,Total,10301,8125,18426
417,4,State - CHANDIGARH,Urban,16,Total,10792,8257,19049
418,4,State - CHANDIGARH,Urban,17,Total,10855,7800,18655
419,4,State - CHANDIGARH,Urban,18,Total,14306,9663,23969
420,4,State - CHANDIGARH,Urban,19,Total,12480,9074,21554
421,4,State - CHANDIGARH,Urban,20-24,Total,66212,51439,117651
422,4,State - CHANDIGARH,Urban,25-29,Total,58434,47997,106431
423,4,State - CHANDIGARH,Urban,30-34,Total,47723,39979,87702
424,4,State - CHANDIGARH,Urban,35-39,Total,44111,37240,81351
425,4,State - CHANDIGARH,Urban,40-44,Total,36321,31053,67374
426,4,State - CHANDIGARH,Urban,45-49,Total,32255,27048,59303
427,4,State - CHANDIGARH,Urban,50-54,Total,25693,20526,46219
428,4,State - CHANDIGARH,Urban,55-59,Total,19473,14949,34422
429,4,State - CHANDIGARH,Urban,60-64,Total,13253,12067,25320
430,4,State - CHANDIGARH,Urban,65-69,Total,8110,7474,15584
431,4,State - CHANDIGARH,Urban,70-74,Total,5902,5302,11204
432,4,State - CHANDIGARH,Urban,75-79,Total,3212,3135,6347
433,4,State - CHANDIGARH,Urban,80+,Total,3745,3780,7525
434,4,State - CHANDIGARH,Urban,Age not stated,Total,197,143,340
435,5,State - UTTARAKHAND,Total,All ages,Total,5137773,4948519,10086292
436,5,State - UTTARAKHAND,Total,0-6,Total,717199,638615,1355814
437,5,State - UTTARAKHAND,Total,7,Total,110555,99785,210340
438,5,State - UTTARAKHAND,Total,8,Total,114848,102048,216896
439,5,State - UTTARAKHAND,Total,9,Total,106565,94050,200615
440,5,State - UTTARAKHAND,Total,10,Total,134113,116189,250302
441,5,State - UTTARAKHAND,Total,11,Total,114025,101011,215036
442,5,State - UTTARAKHAND,Total,12,Total,124845,111517,236362
443,5,State - UTTARAKHAND,Total,13,Total,111390,103545,214935
444,5,State - UTTARAKHAND,Total,14,Total,118901,109807,228708
445,5,State - UTTARAKHAND,Total,15,Total,121583,112207,233790
446,5,State - UTTARAKHAND,Total,16,Total,119257,110854,230111
447,5,State - UTTARAKHAND,Total,17,Total,108809,98392,207201
448,5,State - UTTARAKHAND,Total,18,Total,135318,119066,254384
449,5,State - UTTARAKHAND,Total,19,Total,103516,95108,198624
450,5,State - UTTARAKHAND,Total,20-24,Total,484614,485454,970068
451,5,State - UTTARAKHAND,Total,25-29,Total,397363,412821,810184
452,5,State - UTTARAKHAND,Total,30-34,Total,345427,352873,698300
453,5,State - UTTARAKHAND,Total,35-39,Total,330834,334666,665500
454,5,State - UTTARAKHAND,Total,40-44,Total,285531,281178,566709
455,5,State - UTTARAKHAND,Total,45-49,Total,247982,241395,489377
456,5,State - UTTARAKHAND,Total,50-54,Total,202024,195134,397158
457,5,State - UTTARAKHAND,Total,55-59,Total,151865,166596,318461
458,5,State - UTTARAKHAND,Total,60-64,Total,163220,165836,329056
459,5,State - UTTARAKHAND,Total,65-69,Total,108412,110347,218759
460,5,State - UTTARAKHAND,Total,70-74,Total,80970,82473,163443
461,5,State - UTTARAKHAND,Total,75-79,Total,40837,43809,84646
462,5,State - UTTARAKHAND,Total,80+,Total,48458,56447,104905
463,5,State - UTTARAKHAND,Total,Age not stated,Total,9312,7296,16608
464,5,State - UTTARAKHAND,Rural,All ages,Total,3519042,3517912,7036954
465,5,State - UTTARAKHAND,Rural,0-6,Total,521792,468984,990776
466,5,State - UTTARAKHAND,Rural,7,Total,79455,72999,152454
467,5,State - UTTARAKHAND,Rural,8,Total,83099,75103,158202
468,5,State - UTTARAKHAND,Rural,9,Total,76846,69597,146443
469,5,State - UTTARAKHAND,Rural,10,Total,96251,85520,181771
470,5,State - UTTARAKHAND,Rural,11,Total,82153,74778,156931
471,5,State - UTTARAKHAND,Rural,12,Total,90621,83124,173745
472,5,State - UTTARAKHAND,Rural,13,Total,80262,76791,157053
473,5,State - UTTARAKHAND,Rural,14,Total,85291,80627,165918
474,5,State - UTTARAKHAND,Rural,15,Total,86504,82025,168529
475,5,State - UTTARAKHAND,Rural,16,Total,84160,80897,165057
476,5,State - UTTARAKHAND,Rural,17,Total,75319,70190,145509
477,5,State - UTTARAKHAND,Rural,18,Total,92407,85170,177577
478,5,State - UTTARAKHAND,Rural,19,Total,68679,67547,136226
479,5,State - UTTARAKHAND,Rural,20-24,Total,312431,335596,648027
480,5,State - UTTARAKHAND,Rural,25-29,Total,253277,276477,529754
481,5,State - UTTARAKHAND,Rural,30-34,Total,221890,237266,459156
482,5,State - UTTARAKHAND,Rural,35-39,Total,215242,226106,441348
483,5,State - UTTARAKHAND,Rural,40-44,Total,187060,191592,378652
484,5,State - UTTARAKHAND,Rural,45-49,Total,160955,164945,325900
485,5,State - UTTARAKHAND,Rural,50-54,Total,133037,137037,270074
486,5,State - UTTARAKHAND,Rural,55-59,Total,100962,120404,221366
487,5,State - UTTARAKHAND,Rural,60-64,Total,119263,125528,244791
488,5,State - UTTARAKHAND,Rural,65-69,Total,78840,84262,163102
489,5,State - UTTARAKHAND,Rural,70-74,Total,60605,64302,124907
490,5,State - UTTARAKHAND,Rural,75-79,Total,30697,33864,64561
491,5,State - UTTARAKHAND,Rural,80+,Total,36196,42457,78653
492,5,State - UTTARAKHAND,Rural,Age not stated,Total,5748,4724,10472
493,5,State - UTTARAKHAND,Urban,All ages,Total,1618731,1430607,3049338
494,5,State - UTTARAKHAND,Urban,0-6,Total,195407,169631,365038
495,5,State - UTTARAKHAND,Urban,7,Total,31100,26786,57886
496,5,State - UTTARAKHAND,Urban,8,Total,31749,26945,58694
497,5,State - UTTARAKHAND,Urban,9,Total,29719,24453,54172
498,5,State - UTTARAKHAND,Urban,10,Total,37862,30669,68531
499,5,State - UTTARAKHAND,Urban,11,Total,31872,26233,58105
500,5,State - UTTARAKHAND,Urban,12,Total,34224,28393,62617
501,5,State - UTTARAKHAND,Urban,13,Total,31128,26754,57882
502,5,State - UTTARAKHAND,Urban,14,Total,33610,29180,62790
503,5,State - UTTARAKHAND,Urban,15,Total,35079,30182,65261
504,5,State - UTTARAKHAND,Urban,16,Total,35097,29957,65054
505,5,State - UTTARAKHAND,Urban,17,Total,33490,28202,61692
506,5,State - UTTARAKHAND,Urban,18,Total,42911,33896,76807
507,5,State - UTTARAKHAND,Urban,19,Total,34837,27561,62398
508,5,State - UTTARAKHAND,Urban,20-24,Total,172183,149858,322041
509,5,State - UTTARAKHAND,Urban,25-29,Total,144086,136344,280430
510,5,State - UTTARAKHAND,Urban,30-34,Total,123537,115607,239144
511,5,State - UTTARAKHAND,Urban,35-39,Total,115592,108560,224152
512,5,State - UTTARAKHAND,Urban,40-44,Total,98471,89586,188057
513,5,State - UTTARAKHAND,Urban,45-49,Total,87027,76450,163477
514,5,State - UTTARAKHAND,Urban,50-54,Total,68987,58097,127084
515,5,State - UTTARAKHAND,Urban,55-59,Total,50903,46192,97095
516,5,State - UTTARAKHAND,Urban,60-64,Total,43957,40308,84265
517,5,State - UTTARAKHAND,Urban,65-69,Total,29572,26085,55657
518,5,State - UTTARAKHAND,Urban,70-74,Total,20365,18171,38536
519,5,State - UTTARAKHAND,Urban,75-79,Total,10140,9945,20085
520,5,State - UTTARAKHAND,Urban,80+,Total,12262,13990,26252
521,5,State - UTTARAKHAND,Urban,Age not stated,Total,3564,2572,6136
522,6,State - HARYANA,Total,All ages,Total,13494734,11856728,25351462
523,6,State - HARYANA,Total,0-6,Total,1843109,1537612,3380721
524,6,State - HARYANA,Total,7,Total,270994,226755,497749
525,6,State - HARYANA,Total,8,Total,281655,232252,513907
526,6,State - HARYANA,Total,9,Total,259856,209043,468899
527,6,State - HARYANA,Total,10,Total,320318,253384,573702
528,6,State - HARYANA,Total,11,Total,282039,224845,506884
529,6,State - HARYANA,Total,12,Total,305753,245137,550890
530,6,State - HARYANA,Total,13,Total,277252,231454,508706
531,6,State - HARYANA,Total,14,Total,288774,239722,528496
532,6,State - HARYANA,Total,15,Total,306076,247651,553727
533,6,State - HARYANA,Total,16,Total,302833,242802,545635
534,6,State - HARYANA,Total,17,Total,274242,216151,490393
535,6,State - HARYANA,Total,18,Total,340968,266823,607791
536,6,State - HARYANA,Total,19,Total,263429,216415,479844
537,6,State - HARYANA,Total,20-24,Total,1372799,1194687,2567486
538,6,State - HARYANA,Total,25-29,Total,1178340,1053619,2231959
539,6,State - HARYANA,Total,30-34,Total,976844,916747,1893591
540,6,State - HARYANA,Total,35-39,Total,912717,849146,1761863
541,6,State - HARYANA,Total,40-44,Total,790581,715369,1505950
542,6,State - HARYANA,Total,45-49,Total,655749,586065,1241814
543,6,State - HARYANA,Total,50-54,Total,510688,454540,965228
544,6,State - HARYANA,Total,55-59,Total,374209,376729,750938
545,6,State - HARYANA,Total,60-64,Total,413958,430391,844349
546,6,State - HARYANA,Total,65-69,Total,255270,249169,504439
547,6,State - HARYANA,Total,70-74,Total,188304,185857,374161
548,6,State - HARYANA,Total,75-79,Total,97692,98525,196217
549,6,State - HARYANA,Total,80+,Total,133397,141192,274589
550,6,State - HARYANA,Total,Age not stated,Total,16888,14646,31534
551,6,State - HARYANA,Rural,All ages,Total,8774006,7735353,16509359
552,6,State - HARYANA,Rural,0-6,Total,1245090,1040022,2285112
553,6,State - HARYANA,Rural,7,Total,181029,152148,333177
554,6,State - HARYANA,Rural,8,Total,190498,158037,348535
555,6,State - HARYANA,Rural,9,Total,174478,141503,315981
556,6,State - HARYANA,Rural,10,Total,214227,171899,386126
557,6,State - HARYANA,Rural,11,Total,190067,153569,343636
558,6,State - HARYANA,Rural,12,Total,208087,168345,376432
559,6,State - HARYANA,Rural,13,Total,188180,158541,346721
560,6,State - HARYANA,Rural,14,Total,195525,164419,359944
561,6,State - HARYANA,Rural,15,Total,207291,169608,376899
562,6,State - HARYANA,Rural,16,Total,205491,166525,372016
563,6,State - HARYANA,Rural,17,Total,182705,145315,328020
564,6,State - HARYANA,Rural,18,Total,227291,180284,407575
565,6,State - HARYANA,Rural,19,Total,171613,143868,315481
566,6,State - HARYANA,Rural,20-24,Total,889577,769002,1658579
567,6,State - HARYANA,Rural,25-29,Total,737729,646512,1384241
568,6,State - HARYANA,Rural,30-34,Total,605409,568791,1174200
569,6,State - HARYANA,Rural,35-39,Total,569510,528103,1097613
570,6,State - HARYANA,Rural,40-44,Total,495956,451413,947369
571,6,State - HARYANA,Rural,45-49,Total,403338,361716,765054
572,6,State - HARYANA,Rural,50-54,Total,310495,279793,590288
573,6,State - HARYANA,Rural,55-59,Total,224344,238544,462888
574,6,State - HARYANA,Rural,60-64,Total,276636,297321,573957
575,6,State - HARYANA,Rural,65-69,Total,171739,171688,343427
576,6,State - HARYANA,Rural,70-74,Total,130774,129624,260398
577,6,State - HARYANA,Rural,75-79,Total,68101,68863,136964
578,6,State - HARYANA,Rural,80+,Total,97815,100330,198145
579,6,State - HARYANA,Rural,Age not stated,Total,11011,9570,20581
580,6,State - HARYANA,Urban,All ages,Total,4720728,4121375,8842103
581,6,State - HARYANA,Urban,0-6,Total,598019,497590,1095609
582,6,State - HARYANA,Urban,7,Total,89965,74607,164572
583,6,State - HARYANA,Urban,8,Total,91157,74215,165372
584,6,State - HARYANA,Urban,9,Total,85378,67540,152918
585,6,State - HARYANA,Urban,10,Total,106091,81485,187576
586,6,State - HARYANA,Urban,11,Total,91972,71276,163248
587,6,State - HARYANA,Urban,12,Total,97666,76792,174458
588,6,State - HARYANA,Urban,13,Total,89072,72913,161985
589,6,State - HARYANA,Urban,14,Total,93249,75303,168552
590,6,State - HARYANA,Urban,15,Total,98785,78043,176828
591,6,State - HARYANA,Urban,16,Total,97342,76277,173619
592,6,State - HARYANA,Urban,17,Total,91537,70836,162373
593,6,State - HARYANA,Urban,18,Total,113677,86539,200216
594,6,State - HARYANA,Urban,19,Total,91816,72547,164363
595,6,State - HARYANA,Urban,20-24,Total,483222,425685,908907
596,6,State - HARYANA,Urban,25-29,Total,440611,407107,847718
597,6,State - HARYANA,Urban,30-34,Total,371435,347956,719391
598,6,State - HARYANA,Urban,35-39,Total,343207,321043,664250
599,6,State - HARYANA,Urban,40-44,Total,294625,263956,558581
600,6,State - HARYANA,Urban,45-49,Total,252411,224349,476760
601,6,State - HARYANA,Urban,50-54,Total,200193,174747,374940
602,6,State - HARYANA,Urban,55-59,Total,149865,138185,288050
603,6,State - HARYANA,Urban,60-64,Total,137322,133070,270392
604,6,State - HARYANA,Urban,65-69,Total,83531,77481,161012
605,6,State - HARYANA,Urban,70-74,Total,57530,56233,113763
606,6,State - HARYANA,Urban,75-79,Total,29591,29662,59253
607,6,State - HARYANA,Urban,80+,Total,35582,40862,76444
608,6,State - HARYANA,Urban,Age not stated,Total,5877,5076,10953
609,7,State - NCT OF DELHI,Total,All ages,Total,8987326,7800615,16787941
610,7,State - NCT OF DELHI,Total,0-6,Total,1075440,937014,2012454
611,7,State - NCT OF DELHI,Total,7,Total,163769,142530,306299
612,7,State - NCT OF DELHI,Total,8,Total,166754,141635,308389
613,7,State - NCT OF DELHI,Total,9,Total,157860,132170,290030
614,7,State - NCT OF DELHI,Total,10,Total,199751,163789,363540
615,7,State - NCT OF DELHI,Total,11,Total,170780,142958,313738
616,7,State - NCT OF DELHI,Total,12,Total,183037,152546,335583
617,7,State - NCT OF DELHI,Total,13,Total,166567,143679,310246
618,7,State - NCT OF DELHI,Total,14,Total,175311,149729,325040
619,7,State - NCT OF DELHI,Total,15,Total,183018,151604,334622
620,7,State - NCT OF DELHI,Total,16,Total,179164,148387,327551
621,7,State - NCT OF DELHI,Total,17,Total,171583,138103,309686
622,7,State - NCT OF DELHI,Total,18,Total,217908,166264,384172
623,7,State - NCT OF DELHI,Total,19,Total,173445,137899,311344
624,7,State - NCT OF DELHI,Total,20-24,Total,951411,812649,1764060
625,7,State - NCT OF DELHI,Total,25-29,Total,878196,790130,1668326
626,7,State - NCT OF DELHI,Total,30-34,Total,757455,677244,1434699
627,7,State - NCT OF DELHI,Total,35-39,Total,698455,620789,1319244
628,7,State - NCT OF DELHI,Total,40-44,Total,590858,506339,1097197
629,7,State - NCT OF DELHI,Total,45-49,Total,495227,415986,911213
630,7,State - NCT OF DELHI,Total,50-54,Total,376222,311247,687469
631,7,State - NCT OF DELHI,Total,55-59,Total,269185,239707,508892
632,7,State - NCT OF DELHI,Total,60-64,Total,238103,233916,472019
633,7,State - NCT OF DELHI,Total,65-69,Total,139398,133054,272452
634,7,State - NCT OF DELHI,Total,70-74,Total,94947,94303,189250
635,7,State - NCT OF DELHI,Total,75-79,Total,50446,50247,100693
636,7,State - NCT OF DELHI,Total,80+,Total,53861,59170,113031
637,7,State - NCT OF DELHI,Total,Age not stated,Total,9175,7527,16702
638,7,State - NCT OF DELHI,Rural,All ages,Total,226321,192721,419042
639,7,State - NCT OF DELHI,Rural,0-6,Total,31259,25457,56716
640,7,State - NCT OF DELHI,Rural,7,Total,4710,3804,8514
641,7,State - NCT OF DELHI,Rural,8,Total,4705,3829,8534
642,7,State - NCT OF DELHI,Rural,9,Total,4505,3450,7955
643,7,State - NCT OF DELHI,Rural,10,Total,5823,4648,10471
644,7,State - NCT OF DELHI,Rural,11,Total,4770,3792,8562
645,7,State - NCT OF DELHI,Rural,12,Total,5240,4183,9423
646,7,State - NCT OF DELHI,Rural,13,Total,4835,3782,8617
647,7,State - NCT OF DELHI,Rural,14,Total,4811,3999,8810
648,7,State - NCT OF DELHI,Rural,15,Total,4996,4082,9078
649,7,State - NCT OF DELHI,Rural,16,Total,4988,4001,8989
650,7,State - NCT OF DELHI,Rural,17,Total,4707,3504,8211
651,7,State - NCT OF DELHI,Rural,18,Total,5802,4367,10169
652,7,State - NCT OF DELHI,Rural,19,Total,4423,3497,7920
653,7,State - NCT OF DELHI,Rural,20-24,Total,23805,20602,44407
654,7,State - NCT OF DELHI,Rural,25-29,Total,20584,18666,39250
655,7,State - NCT OF DELHI,Rural,30-34,Total,17431,16402,33833
656,7,State - NCT OF DELHI,Rural,35-39,Total,16738,14910,31648
657,7,State - NCT OF DELHI,Rural,40-44,Total,14180,11782,25962
658,7,State - NCT OF DELHI,Rural,45-49,Total,10981,8695,19676
659,7,State - NCT OF DELHI,Rural,50-54,Total,7917,6430,14347
660,7,State - NCT OF DELHI,Rural,55-59,Total,5372,4927,10299
661,7,State - NCT OF DELHI,Rural,60-64,Total,5700,5924,11624
662,7,State - NCT OF DELHI,Rural,65-69,Total,3125,2998,6123
663,7,State - NCT OF DELHI,Rural,70-74,Total,2171,2147,4318
664,7,State - NCT OF DELHI,Rural,75-79,Total,980,1067,2047
665,7,State - NCT OF DELHI,Rural,80+,Total,1482,1540,3022
666,7,State - NCT OF DELHI,Rural,Age not stated,Total,281,236,517
667,7,State - NCT OF DELHI,Urban,All ages,Total,8761005,7607894,16368899
668,7,State - NCT OF DELHI,Urban,0-6,Total,1044181,911557,1955738
669,7,State - NCT OF DELHI,Urban,7,Total,159059,138726,297785
670,7,State - NCT OF DELHI,Urban,8,Total,162049,137806,299855
671,7,State - NCT OF DELHI,Urban,9,Total,153355,128720,282075
672,7,State - NCT OF DELHI,Urban,10,Total,193928,159141,353069
673,7,State - NCT OF DELHI,Urban,11,Total,166010,139166,305176
674,7,State - NCT OF DELHI,Urban,12,Total,177797,148363,326160
675,7,State - NCT OF DELHI,Urban,13,Total,161732,139897,301629
676,7,State - NCT OF DELHI,Urban,14,Total,170500,145730,316230
677,7,State - NCT OF DELHI,Urban,15,Total,178022,147522,325544
678,7,State - NCT OF DELHI,Urban,16,Total,174176,144386,318562
679,7,State - NCT OF DELHI,Urban,17,Total,166876,134599,301475
680,7,State - NCT OF DELHI,Urban,18,Total,212106,161897,374003
681,7,State - NCT OF DELHI,Urban,19,Total,169022,134402,303424
682,7,State - NCT OF DELHI,Urban,20-24,Total,927606,792047,1719653
683,7,State - NCT OF DELHI,Urban,25-29,Total,857612,771464,1629076
684,7,State - NCT OF DELHI,Urban,30-34,Total,740024,660842,1400866
685,7,State - NCT OF DELHI,Urban,35-39,Total,681717,605879,1287596
686,7,State - NCT OF DELHI,Urban,40-44,Total,576678,494557,1071235
687,7,State - NCT OF DELHI,Urban,45-49,Total,484246,407291,891537
688,7,State - NCT OF DELHI,Urban,50-54,Total,368305,304817,673122
689,7,State - NCT OF DELHI,Urban,55-59,Total,263813,234780,498593
690,7,State - NCT OF DELHI,Urban,60-64,Total,232403,227992,460395
691,7,State - NCT OF DELHI,Urban,65-69,Total,136273,130056,266329
692,7,State - NCT OF DELHI,Urban,70-74,Total,92776,92156,184932
693,7,State - NCT OF DELHI,Urban,75-79,Total,49466,49180,98646
694,7,State - NCT OF DELHI,Urban,80+,Total,52379,57630,110009
695,7,State - NCT OF DELHI,Urban,Age not stated,Total,8894,7291,16185
696,8,State - RAJASTHAN,Total,All ages,Total,35550997,32997440,68548437
697,8,State - RAJASTHAN,Total,0-6,Total,5639176,5010328,10649504
698,8,State - RAJASTHAN,Total,7,Total,802370,721301,1523671
699,8,State - RAJASTHAN,Total,8,Total,932409,835396,1767805
700,8,State - RAJASTHAN,Total,9,Total,743492,660436,1403928
701,8,State - RAJASTHAN,Total,10,Total,1046140,927195,1973335
702,8,State - RAJASTHAN,Total,11,Total,809002,711707,1520709
703,8,State - RAJASTHAN,Total,12,Total,955169,844767,1799936
704,8,State - RAJASTHAN,Total,13,Total,795839,727456,1523295
705,8,State - RAJASTHAN,Total,14,Total,824546,738697,1563243
706,8,State - RAJASTHAN,Total,15,Total,867769,751875,1619644
707,8,State - RAJASTHAN,Total,16,Total,831610,724333,1555943
708,8,State - RAJASTHAN,Total,17,Total,666499,569266,1235765
709,8,State - RAJASTHAN,Total,18,Total,931689,825909,1757598
710,8,State - RAJASTHAN,Total,19,Total,592307,552760,1145067
711,8,State - RAJASTHAN,Total,20-24,Total,3377483,3049011,6426494
712,8,State - RAJASTHAN,Total,25-29,Total,2763059,2585438,5348497
713,8,State - RAJASTHAN,Total,30-34,Total,2384569,2338114,4722683
714,8,State - RAJASTHAN,Total,35-39,Total,2201790,2132774,4334564
715,8,State - RAJASTHAN,Total,40-44,Total,1926916,1808439,3735355
716,8,State - RAJASTHAN,Total,45-49,Total,1608512,1536892,3145404
717,8,State - RAJASTHAN,Total,50-54,Total,1345007,1171801,2516808
718,8,State - RAJASTHAN,Total,55-59,Total,935866,961583,1897449
719,8,State - RAJASTHAN,Total,60-64,Total,884024,886115,1770139
720,8,State - RAJASTHAN,Total,65-69,Total,589471,670905,1260376
721,8,State - RAJASTHAN,Total,70-74,Total,490011,526904,1016915
722,8,State - RAJASTHAN,Total,75-79,Total,216016,261639,477655
723,8,State - RAJASTHAN,Total,80+,Total,252741,334312,587053
724,8,State - RAJASTHAN,Total,Age not stated,Total,137515,132087,269602
725,8,State - RAJASTHAN,Rural,All ages,Total,26641747,24858605,51500352
726,8,State - RAJASTHAN,Rural,0-6,Total,4446599,3968284,8414883
727,8,State - RAJASTHAN,Rural,7,Total,624090,564023,1188113
728,8,State - RAJASTHAN,Rural,8,Total,736168,665311,1401479
729,8,State - RAJASTHAN,Rural,9,Total,575854,516974,1092828
730,8,State - RAJASTHAN,Rural,10,Total,820171,735755,1555926
731,8,State - RAJASTHAN,Rural,11,Total,627418,554417,1181835
732,8,State - RAJASTHAN,Rural,12,Total,748140,666519,1414659
733,8,State - RAJASTHAN,Rural,13,Total,614099,562703,1176802
734,8,State - RAJASTHAN,Rural,14,Total,636904,571063,1207967
735,8,State - RAJASTHAN,Rural,15,Total,664544,576711,1241255
736,8,State - RAJASTHAN,Rural,16,Total,636615,554029,1190644
737,8,State - RAJASTHAN,Rural,17,Total,490892,418669,909561
738,8,State - RAJASTHAN,Rural,18,Total,700636,626083,1326719
739,8,State - RAJASTHAN,Rural,19,Total,425396,403360,828756
740,8,State - RAJASTHAN,Rural,20-24,Total,2471674,2211087,4682761
741,8,State - RAJASTHAN,Rural,25-29,Total,1981853,1850840,3832693
742,8,State - RAJASTHAN,Rural,30-34,Total,1716111,1696706,3412817
743,8,State - RAJASTHAN,Rural,35-39,Total,1585834,1544561,3130395
744,8,State - RAJASTHAN,Rural,40-44,Total,1390594,1314207,2704801
745,8,State - RAJASTHAN,Rural,45-49,Total,1150068,1115603,2265671
746,8,State - RAJASTHAN,Rural,50-54,Total,968094,849535,1817629
747,8,State - RAJASTHAN,Rural,55-59,Total,668669,715210,1383879
748,8,State - RAJASTHAN,Rural,60-64,Total,666272,677057,1343329
749,8,State - RAJASTHAN,Rural,65-69,Total,448876,522444,971320
750,8,State - RAJASTHAN,Rural,70-74,Total,382456,412974,795430
751,8,State - RAJASTHAN,Rural,75-79,Total,162014,202628,364642
752,8,State - RAJASTHAN,Rural,80+,Total,193050,256021,449071
753,8,State - RAJASTHAN,Rural,Age not stated,Total,108656,105831,214487
754,8,State - RAJASTHAN,Urban,All ages,Total,8909250,8138835,17048085
755,8,State - RAJASTHAN,Urban,0-6,Total,1192577,1042044,2234621
756,8,State - RAJASTHAN,Urban,7,Total,178280,157278,335558
757,8,State - RAJASTHAN,Urban,8,Total,196241,170085,366326
758,8,State - RAJASTHAN,Urban,9,Total,167638,143462,311100
759,8,State - RAJASTHAN,Urban,10,Total,225969,191440,417409
760,8,State - RAJASTHAN,Urban,11,Total,181584,157290,338874
761,8,State - RAJASTHAN,Urban,12,Total,207029,178248,385277
762,8,State - RAJASTHAN,Urban,13,Total,181740,164753,346493
763,8,State - RAJASTHAN,Urban,14,Total,187642,167634,355276
764,8,State - RAJASTHAN,Urban,15,Total,203225,175164,378389
765,8,State - RAJASTHAN,Urban,16,Total,194995,170304,365299
766,8,State - RAJASTHAN,Urban,17,Total,175607,150597,326204
767,8,State - RAJASTHAN,Urban,18,Total,231053,199826,430879
768,8,State - RAJASTHAN,Urban,19,Total,166911,149400,316311
769,8,State - RAJASTHAN,Urban,20-24,Total,905809,837924,1743733
770,8,State - RAJASTHAN,Urban,25-29,Total,781206,734598,1515804
771,8,State - RAJASTHAN,Urban,30-34,Total,668458,641408,1309866
772,8,State - RAJASTHAN,Urban,35-39,Total,615956,588213,1204169
773,8,State - RAJASTHAN,Urban,40-44,Total,536322,494232,1030554
774,8,State - RAJASTHAN,Urban,45-49,Total,458444,421289,879733
775,8,State - RAJASTHAN,Urban,50-54,Total,376913,322266,699179
776,8,State - RAJASTHAN,Urban,55-59,Total,267197,246373,513570
777,8,State - RAJASTHAN,Urban,60-64,Total,217752,209058,426810
778,8,State - RAJASTHAN,Urban,65-69,Total,140595,148461,289056
779,8,State - RAJASTHAN,Urban,70-74,Total,107555,113930,221485
780,8,State - RAJASTHAN,Urban,75-79,Total,54002,59011,113013
781,8,State - RAJASTHAN,Urban,80+,Total,59691,78291,137982
782,8,State - RAJASTHAN,Urban,Age not stated,Total,28859,26256,55115
783,9,State - UTTAR PRADESH,Total,All ages,Total,104480510,95331831,199812341
784,9,State - UTTAR PRADESH,Total,0-6,Total,16185581,14605750,30791331
785,9,State - UTTAR PRADESH,Total,7,Total,2516369,2267439,4783808
786,9,State - UTTAR PRADESH,Total,8,Total,2915118,2599422,5514540
787,9,State - UTTAR PRADESH,Total,9,Total,2293737,2054969,4348706
788,9,State - UTTAR PRADESH,Total,10,Total,3397755,2949523,6347278
789,9,State - UTTAR PRADESH,Total,11,Total,2425324,2133968,4559292
790,9,State - UTTAR PRADESH,Total,12,Total,2961012,2598983,5559995
791,9,State - UTTAR PRADESH,Total,13,Total,2301450,2131162,4432612
792,9,State - UTTAR PRADESH,Total,14,Total,2593613,2377091,4970704
793,9,State - UTTAR PRADESH,Total,15,Total,2760508,2427101,5187609
794,9,State - UTTAR PRADESH,Total,16,Total,2591691,2361441,4953132
795,9,State - UTTAR PRADESH,Total,17,Total,2058384,1827394,3885778
796,9,State - UTTAR PRADESH,Total,18,Total,3063915,2530525,5594440
797,9,State - UTTAR PRADESH,Total,19,Total,1833075,1586346,3419421
798,9,State - UTTAR PRADESH,Total,20-24,Total,9405485,8173163,17578648
799,9,State - UTTAR PRADESH,Total,25-29,Total,7466367,7113462,14579829
800,9,State - UTTAR PRADESH,Total,30-34,Total,6431401,6523281,12954682
801,9,State - UTTAR PRADESH,Total,35-39,Total,6401231,6154991,12556222
802,9,State - UTTAR PRADESH,Total,40-44,Total,5395162,4836240,10231402
803,9,State - UTTAR PRADESH,Total,45-49,Total,4382148,4067629,8449777
804,9,State - UTTAR PRADESH,Total,50-54,Total,3571917,3015106,6587023
805,9,State - UTTAR PRADESH,Total,55-59,Total,2626201,2837945,5464146
806,9,State - UTTAR PRADESH,Total,60-64,Total,2968771,2736420,5705191
807,9,State - UTTAR PRADESH,Total,65-69,Total,1958472,1881497,3839969
808,9,State - UTTAR PRADESH,Total,70-74,Total,1535092,1297276,2832368
809,9,State - UTTAR PRADESH,Total,75-79,Total,638877,611015,1249892
810,9,State - UTTAR PRADESH,Total,80+,Total,935921,876563,1812484
811,9,State - UTTAR PRADESH,Total,Age not stated,Total,865933,756129,1622062
812,9,State - UTTAR PRADESH,Rural,All ages,Total,80992995,74324283,155317278
813,9,State - UTTAR PRADESH,Rural,0-6,Total,13135595,11904988,25040583
814,9,State - UTTAR PRADESH,Rural,7,Total,2027496,1832918,3860414
815,9,State - UTTAR PRADESH,Rural,8,Total,2380288,2133484,4513772
816,9,State - UTTAR PRADESH,Rural,9,Total,1841587,1662323,3503910
817,9,State - UTTAR PRADESH,Rural,10,Total,2759258,2410602,5169860
818,9,State - UTTAR PRADESH,Rural,11,Total,1931080,1710911,3641991
819,9,State - UTTAR PRADESH,Rural,12,Total,2386413,2103769,4490182
820,9,State - UTTAR PRADESH,Rural,13,Total,1831197,1700283,3531480
821,9,State - UTTAR PRADESH,Rural,14,Total,2054374,1886053,3940427
822,9,State - UTTAR PRADESH,Rural,15,Total,2194591,1923572,4118163
823,9,State - UTTAR PRADESH,Rural,16,Total,2029596,1848847,3878443
824,9,State - UTTAR PRADESH,Rural,17,Total,1562188,1388492,2950680
825,9,State - UTTAR PRADESH,Rural,18,Total,2360208,1949087,4309295
826,9,State - UTTAR PRADESH,Rural,19,Total,1346835,1175668,2522503
827,9,State - UTTAR PRADESH,Rural,20-24,Total,6927701,6061343,12989044
828,9,State - UTTAR PRADESH,Rural,25-29,Total,5531452,5329277,10860729
829,9,State - UTTAR PRADESH,Rural,30-34,Total,4825061,4985338,9810399
830,9,State - UTTAR PRADESH,Rural,35-39,Total,4848208,4675493,9523701
831,9,State - UTTAR PRADESH,Rural,40-44,Total,4053994,3631268,7685262
832,9,State - UTTAR PRADESH,Rural,45-49,Total,3240893,3037358,6278251
833,9,State - UTTAR PRADESH,Rural,50-54,Total,2662431,2250260,4912691
834,9,State - UTTAR PRADESH,Rural,55-59,Total,1960534,2206066,4166600
835,9,State - UTTAR PRADESH,Rural,60-64,Total,2363521,2191955,4555476
836,9,State - UTTAR PRADESH,Rural,65-69,Total,1583084,1533881,3116965
837,9,State - UTTAR PRADESH,Rural,70-74,Total,1262445,1055241,2317686
838,9,State - UTTAR PRADESH,Rural,75-79,Total,514186,494065,1008251
839,9,State - UTTAR PRADESH,Rural,80+,Total,754399,693691,1448090
840,9,State - UTTAR PRADESH,Rural,Age not stated,Total,624380,548050,1172430
841,9,State - UTTAR PRADESH,Urban,All ages,Total,23487515,21007548,44495063
842,9,State - UTTAR PRADESH,Urban,0-6,Total,3049986,2700762,5750748
843,9,State - UTTAR PRADESH,Urban,7,Total,488873,434521,923394
844,9,State - UTTAR PRADESH,Urban,8,Total,534830,465938,1000768
845,9,State - UTTAR PRADESH,Urban,9,Total,452150,392646,844796
846,9,State - UTTAR PRADESH,Urban,10,Total,638497,538921,1177418
847,9,State - UTTAR PRADESH,Urban,11,Total,494244,423057,917301
848,9,State - UTTAR PRADESH,Urban,12,Total,574599,495214,1069813
849,9,State - UTTAR PRADESH,Urban,13,Total,470253,430879,901132
850,9,State - UTTAR PRADESH,Urban,14,Total,539239,491038,1030277
851,9,State - UTTAR PRADESH,Urban,15,Total,565917,503529,1069446
852,9,State - UTTAR PRADESH,Urban,16,Total,562095,512594,1074689
853,9,State - UTTAR PRADESH,Urban,17,Total,496196,438902,935098
854,9,State - UTTAR PRADESH,Urban,18,Total,703707,581438,1285145
855,9,State - UTTAR PRADESH,Urban,19,Total,486240,410678,896918
856,9,State - UTTAR PRADESH,Urban,20-24,Total,2477784,2111820,4589604
857,9,State - UTTAR PRADESH,Urban,25-29,Total,1934915,1784185,3719100
858,9,State - UTTAR PRADESH,Urban,30-34,Total,1606340,1537943,3144283
859,9,State - UTTAR PRADESH,Urban,35-39,Total,1553023,1479498,3032521
860,9,State - UTTAR PRADESH,Urban,40-44,Total,1341168,1204972,2546140
861,9,State - UTTAR PRADESH,Urban,45-49,Total,1141255,1030271,2171526
862,9,State - UTTAR PRADESH,Urban,50-54,Total,909486,764846,1674332
863,9,State - UTTAR PRADESH,Urban,55-59,Total,665667,631879,1297546
864,9,State - UTTAR PRADESH,Urban,60-64,Total,605250,544465,1149715
865,9,State - UTTAR PRADESH,Urban,65-69,Total,375388,347616,723004
866,9,State - UTTAR PRADESH,Urban,70-74,Total,272647,242035,514682
867,9,State - UTTAR PRADESH,Urban,75-79,Total,124691,116950,241641
868,9,State - UTTAR PRADESH,Urban,80+,Total,181522,182872,364394
869,9,State - UTTAR PRADESH,Urban,Age not stated,Total,241553,208079,449632
870,10,State - BIHAR,Total,All ages,Total,54278157,49821295,104099452
871,10,State - BIHAR,Total,0-6,Total,9887239,9246725,19133964
872,10,State - BIHAR,Total,7,Total,1411042,1325132,2736174
873,10,State - BIHAR,Total,8,Total,1798593,1673605,3472198
874,10,State - BIHAR,Total,9,Total,1276356,1182614,2458970
875,10,State - BIHAR,Total,10,Total,2027478,1821190,3848668
876,10,State - BIHAR,Total,11,Total,1256269,1129384,2385653
877,10,State - BIHAR,Total,12,Total,1683310,1504957,3188267
878,10,State - BIHAR,Total,13,Total,1135187,1049840,2185027
879,10,State - BIHAR,Total,14,Total,1221587,1090680,2312267
880,10,State - BIHAR,Total,15,Total,1289350,1036675,2326025
881,10,State - BIHAR,Total,16,Total,1143121,903830,2046951
882,10,State - BIHAR,Total,17,Total,798482,610419,1408901
883,10,State - BIHAR,Total,18,Total,1320854,973158,2294012
884,10,State - BIHAR,Total,19,Total,738774,658032,1396806
885,10,State - BIHAR,Total,20-24,Total,4210585,3854150,8064735
886,10,State - BIHAR,Total,25-29,Total,3828687,3843018,7671705
887,10,State - BIHAR,Total,30-34,Total,3510596,3545141,7055737
888,10,State - BIHAR,Total,35-39,Total,3308161,3149100,6457261
889,10,State - BIHAR,Total,40-44,Total,2756809,2408883,5165692
890,10,State - BIHAR,Total,45-49,Total,2209994,2060380,4270374
891,10,State - BIHAR,Total,50-54,Total,1808425,1504315,3312740
892,10,State - BIHAR,Total,55-59,Total,1330356,1466322,2796678
893,10,State - BIHAR,Total,60-64,Total,1559925,1448083,3008008
894,10,State - BIHAR,Total,65-69,Total,1103718,986061,2089779
895,10,State - BIHAR,Total,70-74,Total,784383,595148,1379531
896,10,State - BIHAR,Total,75-79,Total,297973,252506,550479
897,10,State - BIHAR,Total,80+,Total,360594,318754,679348
898,10,State - BIHAR,Total,Age not stated,Total,220309,183193,403502
899,10,State - BIHAR,Rural,All ages,Total,48073850,44267586,92341436
900,10,State - BIHAR,Rural,0-6,Total,8971671,8412030,17383701
901,10,State - BIHAR,Rural,7,Total,1273456,1198812,2472268
902,10,State - BIHAR,Rural,8,Total,1630750,1521954,3152704
903,10,State - BIHAR,Rural,9,Total,1151911,1070505,2222416
904,10,State - BIHAR,Rural,10,Total,1834339,1651713,3486052
905,10,State - BIHAR,Rural,11,Total,1125945,1013026,2138971
906,10,State - BIHAR,Rural,12,Total,1512521,1351130,2863651
907,10,State - BIHAR,Rural,13,Total,1010688,932324,1943012
908,10,State - BIHAR,Rural,14,Total,1080482,960779,2041261
909,10,State - BIHAR,Rural,15,Total,1143650,911005,2054655
910,10,State - BIHAR,Rural,16,Total,1003054,782438,1785492
911,10,State - BIHAR,Rural,17,Total,687338,518017,1205355
912,10,State - BIHAR,Rural,18,Total,1153623,840695,1994318
913,10,State - BIHAR,Rural,19,Total,634833,569076,1203909
914,10,State - BIHAR,Rural,20-24,Total,3644529,3366524,7011053
915,10,State - BIHAR,Rural,25-29,Total,3340162,3382526,6722688
916,10,State - BIHAR,Rural,30-34,Total,3074406,3128638,6203044
917,10,State - BIHAR,Rural,35-39,Total,2902365,2768886,5671251
918,10,State - BIHAR,Rural,40-44,Total,2404576,2106292,4510868
919,10,State - BIHAR,Rural,45-49,Total,1918799,1802734,3721533
920,10,State - BIHAR,Rural,50-54,Total,1575237,1310457,2885694
921,10,State - BIHAR,Rural,55-59,Total,1151517,1298812,2450329
922,10,State - BIHAR,Rural,60-64,Total,1385714,1291723,2677437
923,10,State - BIHAR,Rural,65-69,Total,986570,884070,1870640
924,10,State - BIHAR,Rural,70-74,Total,701151,530677,1231828
925,10,State - BIHAR,Rural,75-79,Total,263161,223733,486894
926,10,State - BIHAR,Rural,80+,Total,320855,280532,601387
927,10,State - BIHAR,Rural,Age not stated,Total,190547,158478,349025
928,10,State - BIHAR,Urban,All ages,Total,6204307,5553709,11758016
929,10,State - BIHAR,Urban,0-6,Total,915568,834695,1750263
930,10,State - BIHAR,Urban,7,Total,137586,126320,263906
931,10,State - BIHAR,Urban,8,Total,167843,151651,319494
932,10,State - BIHAR,Urban,9,Total,124445,112109,236554
933,10,State - BIHAR,Urban,10,Total,193139,169477,362616
934,10,State - BIHAR,Urban,11,Total,130324,116358,246682
935,10,State - BIHAR,Urban,12,Total,170789,153827,324616
936,10,State - BIHAR,Urban,13,Total,124499,117516,242015
937,10,State - BIHAR,Urban,14,Total,141105,129901,271006
938,10,State - BIHAR,Urban,15,Total,145700,125670,271370
939,10,State - BIHAR,Urban,16,Total,140067,121392,261459
940,10,State - BIHAR,Urban,17,Total,111144,92402,203546
941,10,State - BIHAR,Urban,18,Total,167231,132463,299694
942,10,State - BIHAR,Urban,19,Total,103941,88956,192897
943,10,State - BIHAR,Urban,20-24,Total,566056,487626,1053682
944,10,State - BIHAR,Urban,25-29,Total,488525,460492,949017
945,10,State - BIHAR,Urban,30-34,Total,436190,416503,852693
946,10,State - BIHAR,Urban,35-39,Total,405796,380214,786010
947,10,State - BIHAR,Urban,40-44,Total,352233,302591,654824
948,10,State - BIHAR,Urban,45-49,Total,291195,257646,548841
949,10,State - BIHAR,Urban,50-54,Total,233188,193858,427046
950,10,State - BIHAR,Urban,55-59,Total,178839,167510,346349
951,10,State - BIHAR,Urban,60-64,Total,174211,156360,330571
952,10,State - BIHAR,Urban,65-69,Total,117148,101991,219139
953,10,State - BIHAR,Urban,70-74,Total,83232,64471,147703
954,10,State - BIHAR,Urban,75-79,Total,34812,28773,63585
955,10,State - BIHAR,Urban,80+,Total,39739,38222,77961
956,10,State - BIHAR,Urban,Age not stated,Total,29762,24715,54477
957,11,State - SIKKIM,Total,All ages,Total,323070,287507,610577
958,11,State - SIKKIM,Total,0-6,Total,32761,31350,64111
959,11,State - SIKKIM,Total,7,Total,5951,5777,11728
960,11,State - SIKKIM,Total,8,Total,5525,5497,11022
961,11,State - SIKKIM,Total,9,Total,6136,6017,12153
962,11,State - SIKKIM,Total,10,Total,6929,6614,13543
963,11,State - SIKKIM,Total,11,Total,6684,6481,13165
964,11,State - SIKKIM,Total,12,Total,6846,6554,13400
965,11,State - SIKKIM,Total,13,Total,6722,6590,13312
966,11,State - SIKKIM,Total,14,Total,6784,6719,13503
967,11,State - SIKKIM,Total,15,Total,6715,6608,13323
968,11,State - SIKKIM,Total,16,Total,6667,6761,13428
969,11,State - SIKKIM,Total,17,Total,6784,6360,13144
970,11,State - SIKKIM,Total,18,Total,7347,6907,14254
971,11,State - SIKKIM,Total,19,Total,6485,6303,12788
972,11,State - SIKKIM,Total,20-24,Total,35146,32151,67297
973,11,State - SIKKIM,Total,25-29,Total,34700,29939,64639
974,11,State - SIKKIM,Total,30-34,Total,28562,23663,52225
975,11,State - SIKKIM,Total,35-39,Total,23396,20231,43627
976,11,State - SIKKIM,Total,40-44,Total,20170,16382,36552
977,11,State - SIKKIM,Total,45-49,Total,16114,13348,29462
978,11,State - SIKKIM,Total,50-54,Total,13624,10808,24432
979,11,State - SIKKIM,Total,55-59,Total,9913,7628,17541
980,11,State - SIKKIM,Total,60-64,Total,7441,6109,13550
981,11,State - SIKKIM,Total,65-69,Total,5593,4890,10483
982,11,State - SIKKIM,Total,70-74,Total,4304,3257,7561
983,11,State - SIKKIM,Total,75-79,Total,2556,1960,4516
984,11,State - SIKKIM,Total,80+,Total,2578,2064,4642
985,11,State - SIKKIM,Total,Age not stated,Total,637,539,1176
986,11,State - SIKKIM,Rural,All ages,Total,242797,214202,456999
987,11,State - SIKKIM,Rural,0-6,Total,25061,24157,49218
988,11,State - SIKKIM,Rural,7,Total,4673,4535,9208
989,11,State - SIKKIM,Rural,8,Total,4282,4274,8556
990,11,State - SIKKIM,Rural,9,Total,4859,4699,9558
991,11,State - SIKKIM,Rural,10,Total,5444,5200,10644
992,11,State - SIKKIM,Rural,11,Total,5227,5054,10281
993,11,State - SIKKIM,Rural,12,Total,5393,5033,10426
994,11,State - SIKKIM,Rural,13,Total,5257,5092,10349
995,11,State - SIKKIM,Rural,14,Total,5267,5224,10491
996,11,State - SIKKIM,Rural,15,Total,5206,4994,10200
997,11,State - SIKKIM,Rural,16,Total,5115,5112,10227
998,11,State - SIKKIM,Rural,17,Total,5174,4782,9956
999,11,State - SIKKIM,Rural,18,Total,5593,5178,10771
1000,11,State - SIKKIM,Rural,19,Total,4855,4750,9605
1001,11,State - SIKKIM,Rural,20-24,Total,26301,23538,49839
1002,11,State - SIKKIM,Rural,25-29,Total,25475,21153,46628
1003,11,State - SIKKIM,Rural,30-34,Total,20788,16624,37412
1004,11,State - SIKKIM,Rural,35-39,Total,16613,14315,30928
1005,11,State - SIKKIM,Rural,40-44,Total,14402,11709,26111
1006,11,State - SIKKIM,Rural,45-49,Total,11394,9710,21104
1007,11,State - SIKKIM,Rural,50-54,Total,10021,8060,18081
1008,11,State - SIKKIM,Rural,55-59,Total,7390,5829,13219
1009,11,State - SIKKIM,Rural,60-64,Total,5971,4904,10875
1010,11,State - SIKKIM,Rural,65-69,Total,4584,3948,8532
1011,11,State - SIKKIM,Rural,70-74,Total,3624,2656,6280
1012,11,State - SIKKIM,Rural,75-79,Total,2150,1586,3736
1013,11,State - SIKKIM,Rural,80+,Total,2147,1630,3777
1014,11,State - SIKKIM,Rural,Age not stated,Total,531,456,987
1015,11,State - SIKKIM,Urban,All ages,Total,80273,73305,153578
1016,11,State - SIKKIM,Urban,0-6,Total,7700,7193,14893
1017,11,State - SIKKIM,Urban,7,Total,1278,1242,2520
1018,11,State - SIKKIM,Urban,8,Total,1243,1223,2466
1019,11,State - SIKKIM,Urban,9,Total,1277,1318,2595
1020,11,State - SIKKIM,Urban,10,Total,1485,1414,2899
1021,11,State - SIKKIM,Urban,11,Total,1457,1427,2884
1022,11,State - SIKKIM,Urban,12,Total,1453,1521,2974
1023,11,State - SIKKIM,Urban,13,Total,1465,1498,2963
1024,11,State - SIKKIM,Urban,14,Total,1517,1495,3012
1025,11,State - SIKKIM,Urban,15,Total,1509,1614,3123
1026,11,State - SIKKIM,Urban,16,Total,1552,1649,3201
1027,11,State - SIKKIM,Urban,17,Total,1610,1578,3188
1028,11,State - SIKKIM,Urban,18,Total,1754,1729,3483
1029,11,State - SIKKIM,Urban,19,Total,1630,1553,3183
1030,11,State - SIKKIM,Urban,20-24,Total,8845,8613,17458
1031,11,State - SIKKIM,Urban,25-29,Total,9225,8786,18011
1032,11,State - SIKKIM,Urban,30-34,Total,7774,7039,14813
1033,11,State - SIKKIM,Urban,35-39,Total,6783,5916,12699
1034,11,State - SIKKIM,Urban,40-44,Total,5768,4673,10441
1035,11,State - SIKKIM,Urban,45-49,Total,4720,3638,8358
1036,11,State - SIKKIM,Urban,50-54,Total,3603,2748,6351
1037,11,State - SIKKIM,Urban,55-59,Total,2523,1799,4322
1038,11,State - SIKKIM,Urban,60-64,Total,1470,1205,2675
1039,11,State - SIKKIM,Urban,65-69,Total,1009,942,1951
1040,11,State - SIKKIM,Urban,70-74,Total,680,601,1281
1041,11,State - SIKKIM,Urban,75-79,Total,406,374,780
1042,11,State - SIKKIM,Urban,80+,Total,431,434,865
1043,11,State - SIKKIM,Urban,Age not stated,Total,106,83,189
1044,12,State - ARUNACHAL PRADESH,Total,All ages,Total,713912,669815,1383727
1045,12,State - ARUNACHAL PRADESH,Total,0-6,Total,107624,104564,212188
1046,12,State - ARUNACHAL PRADESH,Total,7,Total,17142,16935,34077
1047,12,State - ARUNACHAL PRADESH,Total,8,Total,18189,17750,35939
1048,12,State - ARUNACHAL PRADESH,Total,9,Total,16208,15590,31798
1049,12,State - ARUNACHAL PRADESH,Total,10,Total,20115,19292,39407
1050,12,State - ARUNACHAL PRADESH,Total,11,Total,17170,16425,33595
1051,12,State - ARUNACHAL PRADESH,Total,12,Total,19251,19202,38453
1052,12,State - ARUNACHAL PRADESH,Total,13,Total,16365,16612,32977
1053,12,State - ARUNACHAL PRADESH,Total,14,Total,17538,17389,34927
1054,12,State - ARUNACHAL PRADESH,Total,15,Total,18039,17639,35678
1055,12,State - ARUNACHAL PRADESH,Total,16,Total,16310,16267,32577
1056,12,State - ARUNACHAL PRADESH,Total,17,Total,14261,13679,27940
1057,12,State - ARUNACHAL PRADESH,Total,18,Total,17304,16749,34053
1058,12,State - ARUNACHAL PRADESH,Total,19,Total,12759,12961,25720
1059,12,State - ARUNACHAL PRADESH,Total,20-24,Total,66033,65663,131696
1060,12,State - ARUNACHAL PRADESH,Total,25-29,Total,63366,60348,123714
1061,12,State - ARUNACHAL PRADESH,Total,30-34,Total,52462,48709,101171
1062,12,State - ARUNACHAL PRADESH,Total,35-39,Total,48211,46180,94391
1063,12,State - ARUNACHAL PRADESH,Total,40-44,Total,42861,35742,78603
1064,12,State - ARUNACHAL PRADESH,Total,45-49,Total,35173,28506,63679
1065,12,State - ARUNACHAL PRADESH,Total,50-54,Total,26487,19623,46110
1066,12,State - ARUNACHAL PRADESH,Total,55-59,Total,16996,12890,29886
1067,12,State - ARUNACHAL PRADESH,Total,60-64,Total,13492,11953,25445
1068,12,State - ARUNACHAL PRADESH,Total,65-69,Total,7642,7331,14973
1069,12,State - ARUNACHAL PRADESH,Total,70-74,Total,5547,5100,10647
1070,12,State - ARUNACHAL PRADESH,Total,75-79,Total,2687,2448,5135
1071,12,State - ARUNACHAL PRADESH,Total,80+,Total,3821,3618,7439
1072,12,State - ARUNACHAL PRADESH,Total,Age not stated,Total,859,650,1509
1073,12,State - ARUNACHAL PRADESH,Rural,All ages,Total,546011,520347,1066358
1074,12,State - ARUNACHAL PRADESH,Rural,0-6,Total,87241,85048,172289
1075,12,State - ARUNACHAL PRADESH,Rural,7,Total,13811,13490,27301
1076,12,State - ARUNACHAL PRADESH,Rural,8,Total,14781,14342,29123
1077,12,State - ARUNACHAL PRADESH,Rural,9,Total,12997,12411,25408
1078,12,State - ARUNACHAL PRADESH,Rural,10,Total,16093,15447,31540
1079,12,State - ARUNACHAL PRADESH,Rural,11,Total,13515,12776,26291
1080,12,State - ARUNACHAL PRADESH,Rural,12,Total,15243,15100,30343
1081,12,State - ARUNACHAL PRADESH,Rural,13,Total,12612,12597,25209
1082,12,State - ARUNACHAL PRADESH,Rural,14,Total,13517,13126,26643
1083,12,State - ARUNACHAL PRADESH,Rural,15,Total,13807,13222,27029
1084,12,State - ARUNACHAL PRADESH,Rural,16,Total,12239,11867,24106
1085,12,State - ARUNACHAL PRADESH,Rural,17,Total,10484,9813,20297
1086,12,State - ARUNACHAL PRADESH,Rural,18,Total,12988,12627,25615
1087,12,State - ARUNACHAL PRADESH,Rural,19,Total,9443,9574,19017
1088,12,State - ARUNACHAL PRADESH,Rural,20-24,Total,49023,48868,97891
1089,12,State - ARUNACHAL PRADESH,Rural,25-29,Total,45974,44957,90931
1090,12,State - ARUNACHAL PRADESH,Rural,30-34,Total,38006,36286,74292
1091,12,State - ARUNACHAL PRADESH,Rural,35-39,Total,34826,34322,69148
1092,12,State - ARUNACHAL PRADESH,Rural,40-44,Total,30631,27111,57742
1093,12,State - ARUNACHAL PRADESH,Rural,45-49,Total,25465,22316,47781
1094,12,State - ARUNACHAL PRADESH,Rural,50-54,Total,20048,16201,36249
1095,12,State - ARUNACHAL PRADESH,Rural,55-59,Total,13401,11158,24559
1096,12,State - ARUNACHAL PRADESH,Rural,60-64,Total,11659,10603,22262
1097,12,State - ARUNACHAL PRADESH,Rural,65-69,Total,6755,6591,13346
1098,12,State - ARUNACHAL PRADESH,Rural,70-74,Total,5048,4599,9647
1099,12,State - ARUNACHAL PRADESH,Rural,75-79,Total,2435,2220,4655
1100,12,State - ARUNACHAL PRADESH,Rural,80+,Total,3308,3143,6451
1101,12,State - ARUNACHAL PRADESH,Rural,Age not stated,Total,661,532,1193
1102,12,State - ARUNACHAL PRADESH,Urban,All ages,Total,167901,149468,317369
1103,12,State - ARUNACHAL PRADESH,Urban,0-6,Total,20383,19516,39899
1104,12,State - ARUNACHAL PRADESH,Urban,7,Total,3331,3445,6776
1105,12,State - ARUNACHAL PRADESH,Urban,8,Total,3408,3408,6816
1106,12,State - ARUNACHAL PRADESH,Urban,9,Total,3211,3179,6390
1107,12,State - ARUNACHAL PRADESH,Urban,10,Total,4022,3845,7867
1108,12,State - ARUNACHAL PRADESH,Urban,11,Total,3655,3649,7304
1109,12,State - ARUNACHAL PRADESH,Urban,12,Total,4008,4102,8110
1110,12,State - ARUNACHAL PRADESH,Urban,13,Total,3753,4015,7768
1111,12,State - ARUNACHAL PRADESH,Urban,14,Total,4021,4263,8284
1112,12,State - ARUNACHAL PRADESH,Urban,15,Total,4232,4417,8649
1113,12,State - ARUNACHAL PRADESH,Urban,16,Total,4071,4400,8471
1114,12,State - ARUNACHAL PRADESH,Urban,17,Total,3777,3866,7643
1115,12,State - ARUNACHAL PRADESH,Urban,18,Total,4316,4122,8438
1116,12,State - ARUNACHAL PRADESH,Urban,19,Total,3316,3387,6703
1117,12,State - ARUNACHAL PRADESH,Urban,20-24,Total,17010,16795,33805
1118,12,State - ARUNACHAL PRADESH,Urban,25-29,Total,17392,15391,32783
1119,12,State - ARUNACHAL PRADESH,Urban,30-34,Total,14456,12423,26879
1120,12,State - ARUNACHAL PRADESH,Urban,35-39,Total,13385,11858,25243
1121,12,State - ARUNACHAL PRADESH,Urban,40-44,Total,12230,8631,20861
1122,12,State - ARUNACHAL PRADESH,Urban,45-49,Total,9708,6190,15898
1123,12,State - ARUNACHAL PRADESH,Urban,50-54,Total,6439,3422,9861
1124,12,State - ARUNACHAL PRADESH,Urban,55-59,Total,3595,1732,5327
1125,12,State - ARUNACHAL PRADESH,Urban,60-64,Total,1833,1350,3183
1126,12,State - ARUNACHAL PRADESH,Urban,65-69,Total,887,740,1627
1127,12,State - ARUNACHAL PRADESH,Urban,70-74,Total,499,501,1000
1128,12,State - ARUNACHAL PRADESH,Urban,75-79,Total,252,228,480
1129,12,State - ARUNACHAL PRADESH,Urban,80+,Total,513,475,988
1130,12,State - ARUNACHAL PRADESH,Urban,Age not stated,Total,198,118,316
1131,13,State - NAGALAND,Total,All ages,Total,1024649,953853,1978502
1132,13,State - NAGALAND,Total,0-6,Total,149785,141286,291071
1133,13,State - NAGALAND,Total,7,Total,24604,22710,47314
1134,13,State - NAGALAND,Total,8,Total,24166,22453,46619
1135,13,State - NAGALAND,Total,9,Total,23383,21974,45357
1136,13,State - NAGALAND,Total,10,Total,28025,25995,54020
1137,13,State - NAGALAND,Total,11,Total,25536,23523,49059
1138,13,State - NAGALAND,Total,12,Total,26301,24375,50676
1139,13,State - NAGALAND,Total,13,Total,24785,22762,47547
1140,13,State - NAGALAND,Total,14,Total,24590,22779,47369
1141,13,State - NAGALAND,Total,15,Total,26094,24031,50125
1142,13,State - NAGALAND,Total,16,Total,24771,23480,48251
1143,13,State - NAGALAND,Total,17,Total,21890,21010,42900
1144,13,State - NAGALAND,Total,18,Total,25021,23908,48929
1145,13,State - NAGALAND,Total,19,Total,20218,19199,39417
1146,13,State - NAGALAND,Total,20-24,Total,103769,100594,204363
1147,13,State - NAGALAND,Total,25-29,Total,89598,87303,176901
1148,13,State - NAGALAND,Total,30-34,Total,76505,73419,149924
1149,13,State - NAGALAND,Total,35-39,Total,64695,63503,128198
1150,13,State - NAGALAND,Total,40-44,Total,57653,51608,109261
1151,13,State - NAGALAND,Total,45-49,Total,47757,39990,87747
1152,13,State - NAGALAND,Total,50-54,Total,36134,29725,65859
1153,13,State - NAGALAND,Total,55-59,Total,23741,19657,43398
1154,13,State - NAGALAND,Total,60-64,Total,19683,16836,36519
1155,13,State - NAGALAND,Total,65-69,Total,12801,11442,24243
1156,13,State - NAGALAND,Total,70-74,Total,9260,8333,17593
1157,13,State - NAGALAND,Total,75-79,Total,5635,4930,10565
1158,13,State - NAGALAND,Total,80+,Total,7400,6406,13806
1159,13,State - NAGALAND,Total,Age not stated,Total,849,622,1471
1160,13,State - NAGALAND,Rural,All ages,Total,725472,682064,1407536
1161,13,State - NAGALAND,Rural,0-6,Total,112483,104999,217482
1162,13,State - NAGALAND,Rural,7,Total,18330,16788,35118
1163,13,State - NAGALAND,Rural,8,Total,18029,16766,34795
1164,13,State - NAGALAND,Rural,9,Total,17259,16231,33490
1165,13,State - NAGALAND,Rural,10,Total,21140,19272,40412
1166,13,State - NAGALAND,Rural,11,Total,18749,17057,35806
1167,13,State - NAGALAND,Rural,12,Total,19355,17855,37210
1168,13,State - NAGALAND,Rural,13,Total,17795,16207,34002
1169,13,State - NAGALAND,Rural,14,Total,17619,16100,33719
1170,13,State - NAGALAND,Rural,15,Total,18914,17258,36172
1171,13,State - NAGALAND,Rural,16,Total,17583,16668,34251
1172,13,State - NAGALAND,Rural,17,Total,15280,14462,29742
1173,13,State - NAGALAND,Rural,18,Total,17757,17000,34757
1174,13,State - NAGALAND,Rural,19,Total,13825,13179,27004
1175,13,State - NAGALAND,Rural,20-24,Total,70944,68637,139581
1176,13,State - NAGALAND,Rural,25-29,Total,58588,58543,117131
1177,13,State - NAGALAND,Rural,30-34,Total,50782,49710,100492
1178,13,State - NAGALAND,Rural,35-39,Total,43067,44103,87170
1179,13,State - NAGALAND,Rural,40-44,Total,39211,36818,76029
1180,13,State - NAGALAND,Rural,45-49,Total,32644,28701,61345
1181,13,State - NAGALAND,Rural,50-54,Total,25376,22142,47518
1182,13,State - NAGALAND,Rural,55-59,Total,16898,14853,31751
1183,13,State - NAGALAND,Rural,60-64,Total,14898,13303,28201
1184,13,State - NAGALAND,Rural,65-69,Total,9930,9009,18939
1185,13,State - NAGALAND,Rural,70-74,Total,7550,6803,14353
1186,13,State - NAGALAND,Rural,75-79,Total,4606,4023,8629
1187,13,State - NAGALAND,Rural,80+,Total,6128,5035,11163
1188,13,State - NAGALAND,Rural,Age not stated,Total,732,542,1274
1189,13,State - NAGALAND,Urban,All ages,Total,299177,271789,570966
1190,13,State - NAGALAND,Urban,0-6,Total,37302,36287,73589
1191,13,State - NAGALAND,Urban,7,Total,6274,5922,12196
1192,13,State - NAGALAND,Urban,8,Total,6137,5687,11824
1193,13,State - NAGALAND,Urban,9,Total,6124,5743,11867
1194,13,State - NAGALAND,Urban,10,Total,6885,6723,13608
1195,13,State - NAGALAND,Urban,11,Total,6787,6466,13253
1196,13,State - NAGALAND,Urban,12,Total,6946,6520,13466
1197,13,State - NAGALAND,Urban,13,Total,6990,6555,13545
1198,13,State - NAGALAND,Urban,14,Total,6971,6679,13650
1199,13,State - NAGALAND,Urban,15,Total,7180,6773,13953
1200,13,State - NAGALAND,Urban,16,Total,7188,6812,14000
1201,13,State - NAGALAND,Urban,17,Total,6610,6548,13158
1202,13,State - NAGALAND,Urban,18,Total,7264,6908,14172
1203,13,State - NAGALAND,Urban,19,Total,6393,6020,12413
1204,13,State - NAGALAND,Urban,20-24,Total,32825,31957,64782
1205,13,State - NAGALAND,Urban,25-29,Total,31010,28760,59770
1206,13,State - NAGALAND,Urban,30-34,Total,25723,23709,49432
1207,13,State - NAGALAND,Urban,35-39,Total,21628,19400,41028
1208,13,State - NAGALAND,Urban,40-44,Total,18442,14790,33232
1209,13,State - NAGALAND,Urban,45-49,Total,15113,11289,26402
1210,13,State - NAGALAND,Urban,50-54,Total,10758,7583,18341
1211,13,State - NAGALAND,Urban,55-59,Total,6843,4804,11647
1212,13,State - NAGALAND,Urban,60-64,Total,4785,3533,8318
1213,13,State - NAGALAND,Urban,65-69,Total,2871,2433,5304
1214,13,State - NAGALAND,Urban,70-74,Total,1710,1530,3240
1215,13,State - NAGALAND,Urban,75-79,Total,1029,907,1936
1216,13,State - NAGALAND,Urban,80+,Total,1272,1371,2643
1217,13,State - NAGALAND,Urban,Age not stated,Total,117,80,197
1218,14,State - MANIPUR,Total,All ages,Total,1438586,1417208,2855794
1219,14,State - MANIPUR,Total,0-6,Total,194484,180873,375357
1220,14,State - MANIPUR,Total,7,Total,30285,29182,59467
1221,14,State - MANIPUR,Total,8,Total,30471,28941,59412
1222,14,State - MANIPUR,Total,9,Total,27686,26003,53689
1223,14,State - MANIPUR,Total,10,Total,35162,32579,67741
1224,14,State - MANIPUR,Total,11,Total,30781,28749,59530
1225,14,State - MANIPUR,Total,12,Total,33380,31539,64919
1226,14,State - MANIPUR,Total,13,Total,30843,29713,60556
1227,14,State - MANIPUR,Total,14,Total,30980,30037,61017
1228,14,State - MANIPUR,Total,15,Total,31912,30768,62680
1229,14,State - MANIPUR,Total,16,Total,28529,28031,56560
1230,14,State - MANIPUR,Total,17,Total,26464,26137,52601
1231,14,State - MANIPUR,Total,18,Total,32559,32291,64850
1232,14,State - MANIPUR,Total,19,Total,25031,25286,50317
1233,14,State - MANIPUR,Total,20-24,Total,139587,142195,281782
1234,14,State - MANIPUR,Total,25-29,Total,132888,137589,270477
1235,14,State - MANIPUR,Total,30-34,Total,109678,111276,220954
1236,14,State - MANIPUR,Total,35-39,Total,98019,100434,198453
1237,14,State - MANIPUR,Total,40-44,Total,85896,84933,170829
1238,14,State - MANIPUR,Total,45-49,Total,73917,73113,147030
1239,14,State - MANIPUR,Total,50-54,Total,60598,59679,120277
1240,14,State - MANIPUR,Total,55-59,Total,45409,44090,89499
1241,14,State - MANIPUR,Total,60-64,Total,36567,35330,71897
1242,14,State - MANIPUR,Total,65-69,Total,23218,23430,46648
1243,14,State - MANIPUR,Total,70-74,Total,16776,17477,34253
1244,14,State - MANIPUR,Total,75-79,Total,10663,10765,21428
1245,14,State - MANIPUR,Total,80+,Total,12571,13223,25794
1246,14,State - MANIPUR,Total,Age not stated,Total,4232,3545,7777
1247,14,State - MANIPUR,Rural,All ages,Total,1026884,994756,2021640
1248,14,State - MANIPUR,Rural,0-6,Total,142443,131503,273946
1249,14,State - MANIPUR,Rural,7,Total,22522,21490,44012
1250,14,State - MANIPUR,Rural,8,Total,22722,21425,44147
1251,14,State - MANIPUR,Rural,9,Total,20519,19201,39720
1252,14,State - MANIPUR,Rural,10,Total,26125,24212,50337
1253,14,State - MANIPUR,Rural,11,Total,22732,20981,43713
1254,14,State - MANIPUR,Rural,12,Total,24906,23110,48016
1255,14,State - MANIPUR,Rural,13,Total,22690,21460,44150
1256,14,State - MANIPUR,Rural,14,Total,22761,21865,44626
1257,14,State - MANIPUR,Rural,15,Total,23624,22553,46177
1258,14,State - MANIPUR,Rural,16,Total,21324,20781,42105
1259,14,State - MANIPUR,Rural,17,Total,19511,19129,38640
1260,14,State - MANIPUR,Rural,18,Total,24691,24038,48729
1261,14,State - MANIPUR,Rural,19,Total,18756,18632,37388
1262,14,State - MANIPUR,Rural,20-24,Total,102223,102516,204739
1263,14,State - MANIPUR,Rural,25-29,Total,93626,95261,188887
1264,14,State - MANIPUR,Rural,30-34,Total,76143,75779,151922
1265,14,State - MANIPUR,Rural,35-39,Total,67639,67986,135625
1266,14,State - MANIPUR,Rural,40-44,Total,59442,57665,117107
1267,14,State - MANIPUR,Rural,45-49,Total,50660,49541,100201
1268,14,State - MANIPUR,Rural,50-54,Total,41105,39480,80585
1269,14,State - MANIPUR,Rural,55-59,Total,30555,29046,59601
1270,14,State - MANIPUR,Rural,60-64,Total,24875,23348,48223
1271,14,State - MANIPUR,Rural,65-69,Total,15677,15329,31006
1272,14,State - MANIPUR,Rural,70-74,Total,11301,11287,22588
1273,14,State - MANIPUR,Rural,75-79,Total,6961,6695,13656
1274,14,State - MANIPUR,Rural,80+,Total,8208,7934,16142
1275,14,State - MANIPUR,Rural,Age not stated,Total,3143,2509,5652
1276,14,State - MANIPUR,Urban,All ages,Total,411702,422452,834154
1277,14,State - MANIPUR,Urban,0-6,Total,52041,49370,101411
1278,14,State - MANIPUR,Urban,7,Total,7763,7692,15455
1279,14,State - MANIPUR,Urban,8,Total,7749,7516,15265
1280,14,State - MANIPUR,Urban,9,Total,7167,6802,13969
1281,14,State - MANIPUR,Urban,10,Total,9037,8367,17404
1282,14,State - MANIPUR,Urban,11,Total,8049,7768,15817
1283,14,State - MANIPUR,Urban,12,Total,8474,8429,16903
1284,14,State - MANIPUR,Urban,13,Total,8153,8253,16406
1285,14,State - MANIPUR,Urban,14,Total,8219,8172,16391
1286,14,State - MANIPUR,Urban,15,Total,8288,8215,16503
1287,14,State - MANIPUR,Urban,16,Total,7205,7250,14455
1288,14,State - MANIPUR,Urban,17,Total,6953,7008,13961
1289,14,State - MANIPUR,Urban,18,Total,7868,8253,16121
1290,14,State - MANIPUR,Urban,19,Total,6275,6654,12929
1291,14,State - MANIPUR,Urban,20-24,Total,37364,39679,77043
1292,14,State - MANIPUR,Urban,25-29,Total,39262,42328,81590
1293,14,State - MANIPUR,Urban,30-34,Total,33535,35497,69032
1294,14,State - MANIPUR,Urban,35-39,Total,30380,32448,62828
1295,14,State - MANIPUR,Urban,40-44,Total,26454,27268,53722
1296,14,State - MANIPUR,Urban,45-49,Total,23257,23572,46829
1297,14,State - MANIPUR,Urban,50-54,Total,19493,20199,39692
1298,14,State - MANIPUR,Urban,55-59,Total,14854,15044,29898
1299,14,State - MANIPUR,Urban,60-64,Total,11692,11982,23674
1300,14,State - MANIPUR,Urban,65-69,Total,7541,8101,15642
1301,14,State - MANIPUR,Urban,70-74,Total,5475,6190,11665
1302,14,State - MANIPUR,Urban,75-79,Total,3702,4070,7772
1303,14,State - MANIPUR,Urban,80+,Total,4363,5289,9652
1304,14,State - MANIPUR,Urban,Age not stated,Total,1089,1036,2125
1305,15,State - MIZORAM,Total,All ages,Total,555339,541867,1097206
1306,15,State - MIZORAM,Total,0-6,Total,85561,82970,168531
1307,15,State - MIZORAM,Total,7,Total,12123,11967,24090
1308,15,State - MIZORAM,Total,8,Total,11951,11484,23435
1309,15,State - MIZORAM,Total,9,Total,11794,11171,22965
1310,15,State - MIZORAM,Total,10,Total,12805,12511,25316
1311,15,State - MIZORAM,Total,11,Total,11958,11432,23390
1312,15,State - MIZORAM,Total,12,Total,11701,11285,22986
1313,15,State - MIZORAM,Total,13,Total,11631,11099,22730
1314,15,State - MIZORAM,Total,14,Total,11431,11128,22559
1315,15,State - MIZORAM,Total,15,Total,11437,10928,22365
1316,15,State - MIZORAM,Total,16,Total,11424,10929,22353
1317,15,State - MIZORAM,Total,17,Total,10973,10601,21574
1318,15,State - MIZORAM,Total,18,Total,11468,11304,22772
1319,15,State - MIZORAM,Total,19,Total,10605,10674,21279
1320,15,State - MIZORAM,Total,20-24,Total,55512,56196,111708
1321,15,State - MIZORAM,Total,25-29,Total,51390,50956,102346
1322,15,State - MIZORAM,Total,30-34,Total,44341,44033,88374
1323,15,State - MIZORAM,Total,35-39,Total,36817,35567,72384
1324,15,State - MIZORAM,Total,40-44,Total,29970,28210,58180
1325,15,State - MIZORAM,Total,45-49,Total,27028,26147,53175
1326,15,State - MIZORAM,Total,50-54,Total,22556,21700,44256
1327,15,State - MIZORAM,Total,55-59,Total,16139,15038,31177
1328,15,State - MIZORAM,Total,60-64,Total,12357,12123,24480
1329,15,State - MIZORAM,Total,65-69,Total,8114,8056,16170
1330,15,State - MIZORAM,Total,70-74,Total,6108,5912,12020
1331,15,State - MIZORAM,Total,75-79,Total,3884,3900,7784
1332,15,State - MIZORAM,Total,80+,Total,3882,4292,8174
1333,15,State - MIZORAM,Total,Age not stated,Total,379,254,633
1334,15,State - MIZORAM,Rural,All ages,Total,269135,256300,525435
1335,15,State - MIZORAM,Rural,0-6,Total,47489,45895,93384
1336,15,State - MIZORAM,Rural,7,Total,6725,6634,13359
1337,15,State - MIZORAM,Rural,8,Total,6635,6298,12933
1338,15,State - MIZORAM,Rural,9,Total,6301,5891,12192
1339,15,State - MIZORAM,Rural,10,Total,6855,6634,13489
1340,15,State - MIZORAM,Rural,11,Total,6280,5813,12093
1341,15,State - MIZORAM,Rural,12,Total,6023,5864,11887
1342,15,State - MIZORAM,Rural,13,Total,5971,5598,11569
1343,15,State - MIZORAM,Rural,14,Total,5707,5343,11050
1344,15,State - MIZORAM,Rural,15,Total,5543,5071,10614
1345,15,State - MIZORAM,Rural,16,Total,5410,4920,10330
1346,15,State - MIZORAM,Rural,17,Total,5128,4582,9710
1347,15,State - MIZORAM,Rural,18,Total,5223,4905,10128
1348,15,State - MIZORAM,Rural,19,Total,4696,4779,9475
1349,15,State - MIZORAM,Rural,20-24,Total,25314,25655,50969
1350,15,State - MIZORAM,Rural,25-29,Total,23442,22942,46384
1351,15,State - MIZORAM,Rural,30-34,Total,19801,18939,38740
1352,15,State - MIZORAM,Rural,35-39,Total,16461,15168,31629
1353,15,State - MIZORAM,Rural,40-44,Total,12925,11893,24818
1354,15,State - MIZORAM,Rural,45-49,Total,11983,11062,23045
1355,15,State - MIZORAM,Rural,50-54,Total,10538,9720,20258
1356,15,State - MIZORAM,Rural,55-59,Total,7770,6833,14603
1357,15,State - MIZORAM,Rural,60-64,Total,6110,5626,11736
1358,15,State - MIZORAM,Rural,65-69,Total,4105,3773,7878
1359,15,State - MIZORAM,Rural,70-74,Total,2907,2665,5572
1360,15,State - MIZORAM,Rural,75-79,Total,1876,1723,3599
1361,15,State - MIZORAM,Rural,80+,Total,1763,1948,3711
1362,15,State - MIZORAM,Rural,Age not stated,Total,154,126,280
1363,15,State - MIZORAM,Urban,All ages,Total,286204,285567,571771
1364,15,State - MIZORAM,Urban,0-6,Total,38072,37075,75147
1365,15,State - MIZORAM,Urban,7,Total,5398,5333,10731
1366,15,State - MIZORAM,Urban,8,Total,5316,5186,10502
1367,15,State - MIZORAM,Urban,9,Total,5493,5280,10773
1368,15,State - MIZORAM,Urban,10,Total,5950,5877,11827
1369,15,State - MIZORAM,Urban,11,Total,5678,5619,11297
1370,15,State - MIZORAM,Urban,12,Total,5678,5421,11099
1371,15,State - MIZORAM,Urban,13,Total,5660,5501,11161
1372,15,State - MIZORAM,Urban,14,Total,5724,5785,11509
1373,15,State - MIZORAM,Urban,15,Total,5894,5857,11751
1374,15,State - MIZORAM,Urban,16,Total,6014,6009,12023
1375,15,State - MIZORAM,Urban,17,Total,5845,6019,11864
1376,15,State - MIZORAM,Urban,18,Total,6245,6399,12644
1377,15,State - MIZORAM,Urban,19,Total,5909,5895,11804
1378,15,State - MIZORAM,Urban,20-24,Total,30198,30541,60739
1379,15,State - MIZORAM,Urban,25-29,Total,27948,28014,55962
1380,15,State - MIZORAM,Urban,30-34,Total,24540,25094,49634
1381,15,State - MIZORAM,Urban,35-39,Total,20356,20399,40755
1382,15,State - MIZORAM,Urban,40-44,Total,17045,16317,33362
1383,15,State - MIZORAM,Urban,45-49,Total,15045,15085,30130
1384,15,State - MIZORAM,Urban,50-54,Total,12018,11980,23998
1385,15,State - MIZORAM,Urban,55-59,Total,8369,8205,16574
1386,15,State - MIZORAM,Urban,60-64,Total,6247,6497,12744
1387,15,State - MIZORAM,Urban,65-69,Total,4009,4283,8292
1388,15,State - MIZORAM,Urban,70-74,Total,3201,3247,6448
1389,15,State - MIZORAM,Urban,75-79,Total,2008,2177,4185
1390,15,State - MIZORAM,Urban,80+,Total,2119,2344,4463
1391,15,State - MIZORAM,Urban,Age not stated,Total,225,128,353
1392,16,State - TRIPURA,Total,All ages,Total,1874376,1799541,3673917
1393,16,State - TRIPURA,Total,0-6,Total,234008,224006,458014
1394,16,State - TRIPURA,Total,7,Total,33918,32512,66430
1395,16,State - TRIPURA,Total,8,Total,34968,33481,68449
1396,16,State - TRIPURA,Total,9,Total,34152,33256,67408
1397,16,State - TRIPURA,Total,10,Total,38244,36202,74446
1398,16,State - TRIPURA,Total,11,Total,35830,34324,70154
1399,16,State - TRIPURA,Total,12,Total,38045,36189,74234
1400,16,State - TRIPURA,Total,13,Total,35375,33999,69374
1401,16,State - TRIPURA,Total,14,Total,35507,33975,69482
1402,16,State - TRIPURA,Total,15,Total,36298,34722,71020
1403,16,State - TRIPURA,Total,16,Total,36901,34633,71534
1404,16,State - TRIPURA,Total,17,Total,35616,31846,67462
1405,16,State - TRIPURA,Total,18,Total,38564,38971,77535
1406,16,State - TRIPURA,Total,19,Total,33757,36521,70278
1407,16,State - TRIPURA,Total,20-24,Total,183779,189398,373177
1408,16,State - TRIPURA,Total,25-29,Total,175059,169090,344149
1409,16,State - TRIPURA,Total,30-34,Total,149231,137758,286989
1410,16,State - TRIPURA,Total,35-39,Total,143051,136291,279342
1411,16,State - TRIPURA,Total,40-44,Total,124093,114658,238751
1412,16,State - TRIPURA,Total,45-49,Total,106717,98752,205469
1413,16,State - TRIPURA,Total,50-54,Total,86627,75559,162186
1414,16,State - TRIPURA,Total,55-59,Total,61849,55025,116874
1415,16,State - TRIPURA,Total,60-64,Total,49611,47518,97129
1416,16,State - TRIPURA,Total,65-69,Total,35044,35436,70480
1417,16,State - TRIPURA,Total,70-74,Total,25535,26789,52324
1418,16,State - TRIPURA,Total,75-79,Total,14259,15827,30086
1419,16,State - TRIPURA,Total,80+,Total,17471,22054,39525
1420,16,State - TRIPURA,Total,Age not stated,Total,867,749,1616
1421,16,State - TRIPURA,Rural,All ages,Total,1387173,1325291,2712464
1422,16,State - TRIPURA,Rural,0-6,Total,186400,178909,365309
1423,16,State - TRIPURA,Rural,7,Total,26766,25565,52331
1424,16,State - TRIPURA,Rural,8,Total,27492,26379,53871
1425,16,State - TRIPURA,Rural,9,Total,26775,26164,52939
1426,16,State - TRIPURA,Rural,10,Total,30415,28822,59237
1427,16,State - TRIPURA,Rural,11,Total,28076,26942,55018
1428,16,State - TRIPURA,Rural,12,Total,30412,28881,59293
1429,16,State - TRIPURA,Rural,13,Total,28164,26834,54998
1430,16,State - TRIPURA,Rural,14,Total,27837,26611,54448
1431,16,State - TRIPURA,Rural,15,Total,28476,27167,55643
1432,16,State - TRIPURA,Rural,16,Total,28666,26679,55345
1433,16,State - TRIPURA,Rural,17,Total,27424,23979,51403
1434,16,State - TRIPURA,Rural,18,Total,29626,30143,59769
1435,16,State - TRIPURA,Rural,19,Total,25185,27543,52728
1436,16,State - TRIPURA,Rural,20-24,Total,138466,142410,280876
1437,16,State - TRIPURA,Rural,25-29,Total,129389,123471,252860
1438,16,State - TRIPURA,Rural,30-34,Total,107731,97137,204868
1439,16,State - TRIPURA,Rural,35-39,Total,101658,94471,196129
1440,16,State - TRIPURA,Rural,40-44,Total,85593,78462,164055
1441,16,State - TRIPURA,Rural,45-49,Total,72663,66634,139297
1442,16,State - TRIPURA,Rural,50-54,Total,57982,50320,108302
1443,16,State - TRIPURA,Rural,55-59,Total,40066,36881,76947
1444,16,State - TRIPURA,Rural,60-64,Total,33940,33355,67295
1445,16,State - TRIPURA,Rural,65-69,Total,25067,25359,50426
1446,16,State - TRIPURA,Rural,70-74,Total,18698,19066,37764
1447,16,State - TRIPURA,Rural,75-79,Total,10258,10907,21165
1448,16,State - TRIPURA,Rural,80+,Total,13380,15733,29113
1449,16,State - TRIPURA,Rural,Age not stated,Total,568,467,1035
1450,16,State - TRIPURA,Urban,All ages,Total,487203,474250,961453
1451,16,State - TRIPURA,Urban,0-6,Total,47608,45097,92705
1452,16,State - TRIPURA,Urban,7,Total,7152,6947,14099
1453,16,State - TRIPURA,Urban,8,Total,7476,7102,14578
1454,16,State - TRIPURA,Urban,9,Total,7377,7092,14469
1455,16,State - TRIPURA,Urban,10,Total,7829,7380,15209
1456,16,State - TRIPURA,Urban,11,Total,7754,7382,15136
1457,16,State - TRIPURA,Urban,12,Total,7633,7308,14941
1458,16,State - TRIPURA,Urban,13,Total,7211,7165,14376
1459,16,State - TRIPURA,Urban,14,Total,7670,7364,15034
1460,16,State - TRIPURA,Urban,15,Total,7822,7555,15377
1461,16,State - TRIPURA,Urban,16,Total,8235,7954,16189
1462,16,State - TRIPURA,Urban,17,Total,8192,7867,16059
1463,16,State - TRIPURA,Urban,18,Total,8938,8828,17766
1464,16,State - TRIPURA,Urban,19,Total,8572,8978,17550
1465,16,State - TRIPURA,Urban,20-24,Total,45313,46988,92301
1466,16,State - TRIPURA,Urban,25-29,Total,45670,45619,91289
1467,16,State - TRIPURA,Urban,30-34,Total,41500,40621,82121
1468,16,State - TRIPURA,Urban,35-39,Total,41393,41820,83213
1469,16,State - TRIPURA,Urban,40-44,Total,38500,36196,74696
1470,16,State - TRIPURA,Urban,45-49,Total,34054,32118,66172
1471,16,State - TRIPURA,Urban,50-54,Total,28645,25239,53884
1472,16,State - TRIPURA,Urban,55-59,Total,21783,18144,39927
1473,16,State - TRIPURA,Urban,60-64,Total,15671,14163,29834
1474,16,State - TRIPURA,Urban,65-69,Total,9977,10077,20054
1475,16,State - TRIPURA,Urban,70-74,Total,6837,7723,14560
1476,16,State - TRIPURA,Urban,75-79,Total,4001,4920,8921
1477,16,State - TRIPURA,Urban,80+,Total,4091,6321,10412
1478,16,State - TRIPURA,Urban,Age not stated,Total,299,282,581
1479,17,State - MEGHALAYA,Total,All ages,Total,1491832,1475057,2966889
1480,17,State - MEGHALAYA,Total,0-6,Total,288646,279890,568536
1481,17,State - MEGHALAYA,Total,7,Total,39338,38367,77705
1482,17,State - MEGHALAYA,Total,8,Total,38410,37883,76293
1483,17,State - MEGHALAYA,Total,9,Total,37037,35765,72802
1484,17,State - MEGHALAYA,Total,10,Total,42976,41393,84369
1485,17,State - MEGHALAYA,Total,11,Total,39148,37563,76711
1486,17,State - MEGHALAYA,Total,12,Total,39303,38291,77594
1487,17,State - MEGHALAYA,Total,13,Total,36051,36034,72085
1488,17,State - MEGHALAYA,Total,14,Total,35995,35852,71847
1489,17,State - MEGHALAYA,Total,15,Total,35883,34808,70691
1490,17,State - MEGHALAYA,Total,16,Total,35098,34117,69215
1491,17,State - MEGHALAYA,Total,17,Total,31749,30561,62310
1492,17,State - MEGHALAYA,Total,18,Total,33933,33240,67173
1493,17,State - MEGHALAYA,Total,19,Total,28053,28746,56799
1494,17,State - MEGHALAYA,Total,20-24,Total,139140,145872,285012
1495,17,State - MEGHALAYA,Total,25-29,Total,124676,126605,251281
1496,17,State - MEGHALAYA,Total,30-34,Total,95786,93871,189657
1497,17,State - MEGHALAYA,Total,35-39,Total,87320,87386,174706
1498,17,State - MEGHALAYA,Total,40-44,Total,73377,72073,145450
1499,17,State - MEGHALAYA,Total,45-49,Total,63043,60072,123115
1500,17,State - MEGHALAYA,Total,50-54,Total,45910,42833,88743
1501,17,State - MEGHALAYA,Total,55-59,Total,30692,29417,60109
1502,17,State - MEGHALAYA,Total,60-64,Total,25421,25287,50708
1503,17,State - MEGHALAYA,Total,65-69,Total,17482,18292,35774
1504,17,State - MEGHALAYA,Total,70-74,Total,11161,12537,23698
1505,17,State - MEGHALAYA,Total,75-79,Total,5848,6997,12845
1506,17,State - MEGHALAYA,Total,80+,Total,7027,8850,15877
1507,17,State - MEGHALAYA,Total,Age not stated,Total,3329,2455,5784
1508,17,State - MEGHALAYA,Rural,All ages,Total,1194260,1177179,2371439
1509,17,State - MEGHALAYA,Rural,0-6,Total,248751,241841,490592
1510,17,State - MEGHALAYA,Rural,7,Total,33508,32742,66250
1511,17,State - MEGHALAYA,Rural,8,Total,32724,32252,64976
1512,17,State - MEGHALAYA,Rural,9,Total,31195,30208,61403
1513,17,State - MEGHALAYA,Rural,10,Total,36145,34804,70949
1514,17,State - MEGHALAYA,Rural,11,Total,32440,31102,63542
1515,17,State - MEGHALAYA,Rural,12,Total,32635,31606,64241
1516,17,State - MEGHALAYA,Rural,13,Total,29415,29391,58806
1517,17,State - MEGHALAYA,Rural,14,Total,29149,28673,57822
1518,17,State - MEGHALAYA,Rural,15,Total,29040,27368,56408
1519,17,State - MEGHALAYA,Rural,16,Total,27816,26424,54240
1520,17,State - MEGHALAYA,Rural,17,Total,24934,23396,48330
1521,17,State - MEGHALAYA,Rural,18,Total,26273,25670,51943
1522,17,State - MEGHALAYA,Rural,19,Total,21075,22136,43211
1523,17,State - MEGHALAYA,Rural,20-24,Total,105372,112271,217643
1524,17,State - MEGHALAYA,Rural,25-29,Total,94964,96886,191850
1525,17,State - MEGHALAYA,Rural,30-34,Total,72034,70728,142762
1526,17,State - MEGHALAYA,Rural,35-39,Total,66890,66164,133054
1527,17,State - MEGHALAYA,Rural,40-44,Total,56095,54959,111054
1528,17,State - MEGHALAYA,Rural,45-49,Total,48433,46129,94562
1529,17,State - MEGHALAYA,Rural,50-54,Total,35366,32313,67679
1530,17,State - MEGHALAYA,Rural,55-59,Total,23513,22308,45821
1531,17,State - MEGHALAYA,Rural,60-64,Total,20229,19673,39902
1532,17,State - MEGHALAYA,Rural,65-69,Total,14315,14468,28783
1533,17,State - MEGHALAYA,Rural,70-74,Total,9081,9718,18799
1534,17,State - MEGHALAYA,Rural,75-79,Total,4644,5211,9855
1535,17,State - MEGHALAYA,Rural,80+,Total,5623,6558,12181
1536,17,State - MEGHALAYA,Rural,Age not stated,Total,2601,2180,4781
1537,17,State - MEGHALAYA,Urban,All ages,Total,297572,297878,595450
1538,17,State - MEGHALAYA,Urban,0-6,Total,39895,38049,77944
1539,17,State - MEGHALAYA,Urban,7,Total,5830,5625,11455
1540,17,State - MEGHALAYA,Urban,8,Total,5686,5631,11317
1541,17,State - MEGHALAYA,Urban,9,Total,5842,5557,11399
1542,17,State - MEGHALAYA,Urban,10,Total,6831,6589,13420
1543,17,State - MEGHALAYA,Urban,11,Total,6708,6461,13169
1544,17,State - MEGHALAYA,Urban,12,Total,6668,6685,13353
1545,17,State - MEGHALAYA,Urban,13,Total,6636,6643,13279
1546,17,State - MEGHALAYA,Urban,14,Total,6846,7179,14025
1547,17,State - MEGHALAYA,Urban,15,Total,6843,7440,14283
1548,17,State - MEGHALAYA,Urban,16,Total,7282,7693,14975
1549,17,State - MEGHALAYA,Urban,17,Total,6815,7165,13980
1550,17,State - MEGHALAYA,Urban,18,Total,7660,7570,15230
1551,17,State - MEGHALAYA,Urban,19,Total,6978,6610,13588
1552,17,State - MEGHALAYA,Urban,20-24,Total,33768,33601,67369
1553,17,State - MEGHALAYA,Urban,25-29,Total,29712,29719,59431
1554,17,State - MEGHALAYA,Urban,30-34,Total,23752,23143,46895
1555,17,State - MEGHALAYA,Urban,35-39,Total,20430,21222,41652
1556,17,State - MEGHALAYA,Urban,40-44,Total,17282,17114,34396
1557,17,State - MEGHALAYA,Urban,45-49,Total,14610,13943,28553
1558,17,State - MEGHALAYA,Urban,50-54,Total,10544,10520,21064
1559,17,State - MEGHALAYA,Urban,55-59,Total,7179,7109,14288
1560,17,State - MEGHALAYA,Urban,60-64,Total,5192,5614,10806
1561,17,State - MEGHALAYA,Urban,65-69,Total,3167,3824,6991
1562,17,State - MEGHALAYA,Urban,70-74,Total,2080,2819,4899
1563,17,State - MEGHALAYA,Urban,75-79,Total,1204,1786,2990
1564,17,State - MEGHALAYA,Urban,80+,Total,1404,2292,3696
1565,17,State - MEGHALAYA,Urban,Age not stated,Total,728,275,1003
1566,18,State - ASSAM,Total,All ages,Total,15939443,15266133,31205576
1567,18,State - ASSAM,Total,0-6,Total,2363485,2274645,4638130
1568,18,State - ASSAM,Total,7,Total,374789,362567,737356
1569,18,State - ASSAM,Total,8,Total,374655,360231,734886
1570,18,State - ASSAM,Total,9,Total,328339,318461,646800
1571,18,State - ASSAM,Total,10,Total,395123,370837,765960
1572,18,State - ASSAM,Total,11,Total,332178,318029,650207
1573,18,State - ASSAM,Total,12,Total,383476,361395,744871
1574,18,State - ASSAM,Total,13,Total,337035,326074,663109
1575,18,State - ASSAM,Total,14,Total,341569,326011,667580
1576,18,State - ASSAM,Total,15,Total,352466,321086,673552
1577,18,State - ASSAM,Total,16,Total,333980,293515,627495
1578,18,State - ASSAM,Total,17,Total,283757,244018,527775
1579,18,State - ASSAM,Total,18,Total,358886,332016,690902
1580,18,State - ASSAM,Total,19,Total,266400,282457,548857
1581,18,State - ASSAM,Total,20-24,Total,1415580,1493825,2909405
1582,18,State - ASSAM,Total,25-29,Total,1393042,1422105,2815147
1583,18,State - ASSAM,Total,30-34,Total,1174247,1155813,2330060
1584,18,State - ASSAM,Total,35-39,Total,1153679,1106794,2260473
1585,18,State - ASSAM,Total,40-44,Total,965463,865743,1831206
1586,18,State - ASSAM,Total,45-49,Total,846081,749168,1595249
1587,18,State - ASSAM,Total,50-54,Total,642260,550103,1192363
1588,18,State - ASSAM,Total,55-59,Total,458242,398583,856825
1589,18,State - ASSAM,Total,60-64,Total,394563,381135,775698
1590,18,State - ASSAM,Total,65-69,Total,253973,249669,503642
1591,18,State - ASSAM,Total,70-74,Total,196445,188832,385277
1592,18,State - ASSAM,Total,75-79,Total,96599,87753,184352
1593,18,State - ASSAM,Total,80+,Total,113237,116338,229575
1594,18,State - ASSAM,Total,Age not stated,Total,9894,8930,18824
1595,18,State - ASSAM,Rural,All ages,Total,13678989,13128045,26807034
1596,18,State - ASSAM,Rural,0-6,Total,2131586,2055737,4187323
1597,18,State - ASSAM,Rural,7,Total,336763,326458,663221
1598,18,State - ASSAM,Rural,8,Total,337833,325265,663098
1599,18,State - ASSAM,Rural,9,Total,293048,284817,577865
1600,18,State - ASSAM,Rural,10,Total,353182,332108,685290
1601,18,State - ASSAM,Rural,11,Total,293479,281345,574824
1602,18,State - ASSAM,Rural,12,Total,341845,322447,664292
1603,18,State - ASSAM,Rural,13,Total,298094,288764,586858
1604,18,State - ASSAM,Rural,14,Total,301164,287338,588502
1605,18,State - ASSAM,Rural,15,Total,311253,282055,593308
1606,18,State - ASSAM,Rural,16,Total,293427,255417,548844
1607,18,State - ASSAM,Rural,17,Total,244607,207787,452394
1608,18,State - ASSAM,Rural,18,Total,312032,288071,600103
1609,18,State - ASSAM,Rural,19,Total,227173,242269,469442
1610,18,State - ASSAM,Rural,20-24,Total,1203111,1274492,2477603
1611,18,State - ASSAM,Rural,25-29,Total,1183063,1203447,2386510
1612,18,State - ASSAM,Rural,30-34,Total,984620,964890,1949510
1613,18,State - ASSAM,Rural,35-39,Total,962030,917721,1879751
1614,18,State - ASSAM,Rural,40-44,Total,793546,713502,1507048
1615,18,State - ASSAM,Rural,45-49,Total,693457,617507,1310964
1616,18,State - ASSAM,Rural,50-54,Total,519994,454998,974992
1617,18,State - ASSAM,Rural,55-59,Total,371541,331219,702760
1618,18,State - ASSAM,Rural,60-64,Total,327339,321702,649041
1619,18,State - ASSAM,Rural,65-69,Total,211838,210605,422443
1620,18,State - ASSAM,Rural,70-74,Total,166867,160721,327588
1621,18,State - ASSAM,Rural,75-79,Total,80838,72216,153054
1622,18,State - ASSAM,Rural,80+,Total,97407,97980,195387
1623,18,State - ASSAM,Rural,Age not stated,Total,7852,7167,15019
1624,18,State - ASSAM,Urban,All ages,Total,2260454,2138088,4398542
1625,18,State - ASSAM,Urban,0-6,Total,231899,218908,450807
1626,18,State - ASSAM,Urban,7,Total,38026,36109,74135
1627,18,State - ASSAM,Urban,8,Total,36822,34966,71788
1628,18,State - ASSAM,Urban,9,Total,35291,33644,68935
1629,18,State - ASSAM,Urban,10,Total,41941,38729,80670
1630,18,State - ASSAM,Urban,11,Total,38699,36684,75383
1631,18,State - ASSAM,Urban,12,Total,41631,38948,80579
1632,18,State - ASSAM,Urban,13,Total,38941,37310,76251
1633,18,State - ASSAM,Urban,14,Total,40405,38673,79078
1634,18,State - ASSAM,Urban,15,Total,41213,39031,80244
1635,18,State - ASSAM,Urban,16,Total,40553,38098,78651
1636,18,State - ASSAM,Urban,17,Total,39150,36231,75381
1637,18,State - ASSAM,Urban,18,Total,46854,43945,90799
1638,18,State - ASSAM,Urban,19,Total,39227,40188,79415
1639,18,State - ASSAM,Urban,20-24,Total,212469,219333,431802
1640,18,State - ASSAM,Urban,25-29,Total,209979,218658,428637
1641,18,State - ASSAM,Urban,30-34,Total,189627,190923,380550
1642,18,State - ASSAM,Urban,35-39,Total,191649,189073,380722
1643,18,State - ASSAM,Urban,40-44,Total,171917,152241,324158
1644,18,State - ASSAM,Urban,45-49,Total,152624,131661,284285
1645,18,State - ASSAM,Urban,50-54,Total,122266,95105,217371
1646,18,State - ASSAM,Urban,55-59,Total,86701,67364,154065
1647,18,State - ASSAM,Urban,60-64,Total,67224,59433,126657
1648,18,State - ASSAM,Urban,65-69,Total,42135,39064,81199
1649,18,State - ASSAM,Urban,70-74,Total,29578,28111,57689
1650,18,State - ASSAM,Urban,75-79,Total,15761,15537,31298
1651,18,State - ASSAM,Urban,80+,Total,15830,18358,34188
1652,18,State - ASSAM,Urban,Age not stated,Total,2042,1763,3805
1653,19,State - WEST BENGAL,Total,All ages,Total,46809027,44467088,91276115
1654,19,State - WEST BENGAL,Total,0-6,Total,5410396,5171070,10581466
1655,19,State - WEST BENGAL,Total,7,Total,849029,816280,1665309
1656,19,State - WEST BENGAL,Total,8,Total,882730,840173,1722903
1657,19,State - WEST BENGAL,Total,9,Total,818470,792804,1611274
1658,19,State - WEST BENGAL,Total,10,Total,1010766,953312,1964078
1659,19,State - WEST BENGAL,Total,11,Total,865049,826152,1691201
1660,19,State - WEST BENGAL,Total,12,Total,984295,924494,1908789
1661,19,State - WEST BENGAL,Total,13,Total,887191,872702,1759893
1662,19,State - WEST BENGAL,Total,14,Total,930205,902357,1832562
1663,19,State - WEST BENGAL,Total,15,Total,959715,896929,1856644
1664,19,State - WEST BENGAL,Total,16,Total,939171,848673,1787844
1665,19,State - WEST BENGAL,Total,17,Total,870750,746690,1617440
1666,19,State - WEST BENGAL,Total,18,Total,1103257,1017917,2121174
1667,19,State - WEST BENGAL,Total,19,Total,829432,845497,1674929
1668,19,State - WEST BENGAL,Total,20-24,Total,4422630,4335692,8758322
1669,19,State - WEST BENGAL,Total,25-29,Total,4044904,3953005,7997909
1670,19,State - WEST BENGAL,Total,30-34,Total,3464659,3376931,6841590
1671,19,State - WEST BENGAL,Total,35-39,Total,3523361,3489285,7012646
1672,19,State - WEST BENGAL,Total,40-44,Total,3219604,2933456,6153060
1673,19,State - WEST BENGAL,Total,45-49,Total,2814212,2521507,5335719
1674,19,State - WEST BENGAL,Total,50-54,Total,2317232,1940648,4257880
1675,19,State - WEST BENGAL,Total,55-59,Total,1746903,1521747,3268650
1676,19,State - WEST BENGAL,Total,60-64,Total,1406401,1339053,2745454
1677,19,State - WEST BENGAL,Total,65-69,Total,991280,991713,1982993
1678,19,State - WEST BENGAL,Total,70-74,Total,686881,703726,1390607
1679,19,State - WEST BENGAL,Total,75-79,Total,360216,379551,739767
1680,19,State - WEST BENGAL,Total,80+,Total,406536,477025,883561
1681,19,State - WEST BENGAL,Total,Age not stated,Total,63752,48699,112451
1682,19,State - WEST BENGAL,Rural,All ages,Total,31844945,30338168,62183113
1683,19,State - WEST BENGAL,Rural,0-6,Total,3992655,3828055,7820710
1684,19,State - WEST BENGAL,Rural,7,Total,618025,597034,1215059
1685,19,State - WEST BENGAL,Rural,8,Total,649812,621022,1270834
1686,19,State - WEST BENGAL,Rural,9,Total,595030,579953,1174983
1687,19,State - WEST BENGAL,Rural,10,Total,733978,695439,1429417
1688,19,State - WEST BENGAL,Rural,11,Total,621269,598559,1219828
1689,19,State - WEST BENGAL,Rural,12,Total,719512,680337,1399849
1690,19,State - WEST BENGAL,Rural,13,Total,648450,641374,1289824
1691,19,State - WEST BENGAL,Rural,14,Total,677819,660357,1338176
1692,19,State - WEST BENGAL,Rural,15,Total,695320,649449,1344769
1693,19,State - WEST BENGAL,Rural,16,Total,679426,605728,1285154
1694,19,State - WEST BENGAL,Rural,17,Total,619049,517485,1136534
1695,19,State - WEST BENGAL,Rural,18,Total,789137,720556,1509693
1696,19,State - WEST BENGAL,Rural,19,Total,576672,589873,1166545
1697,19,State - WEST BENGAL,Rural,20-24,Total,3062672,2980049,6042721
1698,19,State - WEST BENGAL,Rural,25-29,Total,2723495,2631501,5354996
1699,19,State - WEST BENGAL,Rural,30-34,Total,2255183,2197087,4452270
1700,19,State - WEST BENGAL,Rural,35-39,Total,2306077,2290624,4596701
1701,19,State - WEST BENGAL,Rural,40-44,Total,2100597,1924134,4024731
1702,19,State - WEST BENGAL,Rural,45-49,Total,1807534,1614943,3422477
1703,19,State - WEST BENGAL,Rural,50-54,Total,1469321,1224592,2693913
1704,19,State - WEST BENGAL,Rural,55-59,Total,1086200,962669,2048869
1705,19,State - WEST BENGAL,Rural,60-64,Total,881516,864930,1746446
1706,19,State - WEST BENGAL,Rural,65-69,Total,625865,654549,1280414
1707,19,State - WEST BENGAL,Rural,70-74,Total,421658,455273,876931
1708,19,State - WEST BENGAL,Rural,75-79,Total,217061,238972,456033
1709,19,State - WEST BENGAL,Rural,80+,Total,245245,291610,536855
1710,19,State - WEST BENGAL,Rural,Age not stated,Total,26367,22014,48381
1711,19,State - WEST BENGAL,Urban,All ages,Total,14964082,14128920,29093002
1712,19,State - WEST BENGAL,Urban,0-6,Total,1417741,1343015,2760756
1713,19,State - WEST BENGAL,Urban,7,Total,231004,219246,450250
1714,19,State - WEST BENGAL,Urban,8,Total,232918,219151,452069
1715,19,State - WEST BENGAL,Urban,9,Total,223440,212851,436291
1716,19,State - WEST BENGAL,Urban,10,Total,276788,257873,534661
1717,19,State - WEST BENGAL,Urban,11,Total,243780,227593,471373
1718,19,State - WEST BENGAL,Urban,12,Total,264783,244157,508940
1719,19,State - WEST BENGAL,Urban,13,Total,238741,231328,470069
1720,19,State - WEST BENGAL,Urban,14,Total,252386,242000,494386
1721,19,State - WEST BENGAL,Urban,15,Total,264395,247480,511875
1722,19,State - WEST BENGAL,Urban,16,Total,259745,242945,502690
1723,19,State - WEST BENGAL,Urban,17,Total,251701,229205,480906
1724,19,State - WEST BENGAL,Urban,18,Total,314120,297361,611481
1725,19,State - WEST BENGAL,Urban,19,Total,252760,255624,508384
1726,19,State - WEST BENGAL,Urban,20-24,Total,1359958,1355643,2715601
1727,19,State - WEST BENGAL,Urban,25-29,Total,1321409,1321504,2642913
1728,19,State - WEST BENGAL,Urban,30-34,Total,1209476,1179844,2389320
1729,19,State - WEST BENGAL,Urban,35-39,Total,1217284,1198661,2415945
1730,19,State - WEST BENGAL,Urban,40-44,Total,1119007,1009322,2128329
1731,19,State - WEST BENGAL,Urban,45-49,Total,1006678,906564,1913242
1732,19,State - WEST BENGAL,Urban,50-54,Total,847911,716056,1563967
1733,19,State - WEST BENGAL,Urban,55-59,Total,660703,559078,1219781
1734,19,State - WEST BENGAL,Urban,60-64,Total,524885,474123,999008
1735,19,State - WEST BENGAL,Urban,65-69,Total,365415,337164,702579
1736,19,State - WEST BENGAL,Urban,70-74,Total,265223,248453,513676
1737,19,State - WEST BENGAL,Urban,75-79,Total,143155,140579,283734
1738,19,State - WEST BENGAL,Urban,80+,Total,161291,185415,346706
1739,19,State - WEST BENGAL,Urban,Age not stated,Total,37385,26685,64070
1740,20,State - JHARKHAND,Total,All ages,Total,16930315,16057819,32988134
1741,20,State - JHARKHAND,Total,0-6,Total,2767147,2622348,5389495
1742,20,State - JHARKHAND,Total,7,Total,401517,388551,790068
1743,20,State - JHARKHAND,Total,8,Total,471739,450379,922118
1744,20,State - JHARKHAND,Total,9,Total,348610,336431,685041
1745,20,State - JHARKHAND,Total,10,Total,521422,483063,1004485
1746,20,State - JHARKHAND,Total,11,Total,356346,335816,692162
1747,20,State - JHARKHAND,Total,12,Total,486510,454181,940691
1748,20,State - JHARKHAND,Total,13,Total,364081,355848,719929
1749,20,State - JHARKHAND,Total,14,Total,384268,362861,747129
1750,20,State - JHARKHAND,Total,15,Total,408766,353636,762402
1751,20,State - JHARKHAND,Total,16,Total,362192,309714,671906
1752,20,State - JHARKHAND,Total,17,Total,278341,232394,510735
1753,20,State - JHARKHAND,Total,18,Total,414989,349269,764258
1754,20,State - JHARKHAND,Total,19,Total,250599,245368,495967
1755,20,State - JHARKHAND,Total,20-24,Total,1431263,1396359,2827622
1756,20,State - JHARKHAND,Total,25-29,Total,1342314,1310325,2652639
1757,20,State - JHARKHAND,Total,30-34,Total,1165866,1141430,2307296
1758,20,State - JHARKHAND,Total,35-39,Total,1092675,1044089,2136764
1759,20,State - JHARKHAND,Total,40-44,Total,930421,858085,1788506
1760,20,State - JHARKHAND,Total,45-49,Total,798966,735128,1534094
1761,20,State - JHARKHAND,Total,50-54,Total,620682,565499,1186181
1762,20,State - JHARKHAND,Total,55-59,Total,487604,497630,985234
1763,20,State - JHARKHAND,Total,60-64,Total,474565,482917,957482
1764,20,State - JHARKHAND,Total,65-69,Total,317852,317545,635397
1765,20,State - JHARKHAND,Total,70-74,Total,210878,196230,407108
1766,20,State - JHARKHAND,Total,75-79,Total,83542,84412,167954
1767,20,State - JHARKHAND,Total,80+,Total,94908,93829,188737
1768,20,State - JHARKHAND,Total,Age not stated,Total,62252,54482,116734
1769,20,State - JHARKHAND,Rural,All ages,Total,12776486,12278587,25055073
1770,20,State - JHARKHAND,Rural,0-6,Total,2231494,2136013,4367507
1771,20,State - JHARKHAND,Rural,7,Total,316787,310940,627727
1772,20,State - JHARKHAND,Rural,8,Total,381550,368251,749801
1773,20,State - JHARKHAND,Rural,9,Total,275203,269135,544338
1774,20,State - JHARKHAND,Rural,10,Total,418955,391418,810373
1775,20,State - JHARKHAND,Rural,11,Total,276537,263230,539767
1776,20,State - JHARKHAND,Rural,12,Total,388684,364915,753599
1777,20,State - JHARKHAND,Rural,13,Total,282063,276473,558536
1778,20,State - JHARKHAND,Rural,14,Total,295807,279110,574917
1779,20,State - JHARKHAND,Rural,15,Total,316022,269010,585032
1780,20,State - JHARKHAND,Rural,16,Total,270845,226922,497767
1781,20,State - JHARKHAND,Rural,17,Total,198094,161796,359890
1782,20,State - JHARKHAND,Rural,18,Total,307946,257457,565403
1783,20,State - JHARKHAND,Rural,19,Total,175414,175861,351275
1784,20,State - JHARKHAND,Rural,20-24,Total,1031084,1021175,2052259
1785,20,State - JHARKHAND,Rural,25-29,Total,976894,965535,1942429
1786,20,State - JHARKHAND,Rural,30-34,Total,849293,847978,1697271
1787,20,State - JHARKHAND,Rural,35-39,Total,799950,770806,1570756
1788,20,State - JHARKHAND,Rural,40-44,Total,676548,635768,1312316
1789,20,State - JHARKHAND,Rural,45-49,Total,580579,541511,1122090
1790,20,State - JHARKHAND,Rural,50-54,Total,447952,413692,861644
1791,20,State - JHARKHAND,Rural,55-59,Total,343784,376767,720551
1792,20,State - JHARKHAND,Rural,60-64,Total,359498,380411,739909
1793,20,State - JHARKHAND,Rural,65-69,Total,246596,255496,502092
1794,20,State - JHARKHAND,Rural,70-74,Total,163601,155920,319521
1795,20,State - JHARKHAND,Rural,75-79,Total,62658,65428,128086
1796,20,State - JHARKHAND,Rural,80+,Total,72523,70730,143253
1797,20,State - JHARKHAND,Rural,Age not stated,Total,30125,26839,56964
1798,20,State - JHARKHAND,Urban,All ages,Total,4153829,3779232,7933061
1799,20,State - JHARKHAND,Urban,0-6,Total,535653,486335,1021988
1800,20,State - JHARKHAND,Urban,7,Total,84730,77611,162341
1801,20,State - JHARKHAND,Urban,8,Total,90189,82128,172317
1802,20,State - JHARKHAND,Urban,9,Total,73407,67296,140703
1803,20,State - JHARKHAND,Urban,10,Total,102467,91645,194112
1804,20,State - JHARKHAND,Urban,11,Total,79809,72586,152395
1805,20,State - JHARKHAND,Urban,12,Total,97826,89266,187092
1806,20,State - JHARKHAND,Urban,13,Total,82018,79375,161393
1807,20,State - JHARKHAND,Urban,14,Total,88461,83751,172212
1808,20,State - JHARKHAND,Urban,15,Total,92744,84626,177370
1809,20,State - JHARKHAND,Urban,16,Total,91347,82792,174139
1810,20,State - JHARKHAND,Urban,17,Total,80247,70598,150845
1811,20,State - JHARKHAND,Urban,18,Total,107043,91812,198855
1812,20,State - JHARKHAND,Urban,19,Total,75185,69507,144692
1813,20,State - JHARKHAND,Urban,20-24,Total,400179,375184,775363
1814,20,State - JHARKHAND,Urban,25-29,Total,365420,344790,710210
1815,20,State - JHARKHAND,Urban,30-34,Total,316573,293452,610025
1816,20,State - JHARKHAND,Urban,35-39,Total,292725,273283,566008
1817,20,State - JHARKHAND,Urban,40-44,Total,253873,222317,476190
1818,20,State - JHARKHAND,Urban,45-49,Total,218387,193617,412004
1819,20,State - JHARKHAND,Urban,50-54,Total,172730,151807,324537
1820,20,State - JHARKHAND,Urban,55-59,Total,143820,120863,264683
1821,20,State - JHARKHAND,Urban,60-64,Total,115067,102506,217573
1822,20,State - JHARKHAND,Urban,65-69,Total,71256,62049,133305
1823,20,State - JHARKHAND,Urban,70-74,Total,47277,40310,87587
1824,20,State - JHARKHAND,Urban,75-79,Total,20884,18984,39868
1825,20,State - JHARKHAND,Urban,80+,Total,22385,23099,45484
1826,20,State - JHARKHAND,Urban,Age not stated,Total,32127,27643,59770
1827,21,State - ODISHA,Total,All ages,Total,21212136,20762082,41974218
1828,21,State - ODISHA,Total,0-6,Total,2716497,2556697,5273194
1829,21,State - ODISHA,Total,7,Total,419291,408833,828124
1830,21,State - ODISHA,Total,8,Total,433510,416854,850364
1831,21,State - ODISHA,Total,9,Total,394168,381947,776115
1832,21,State - ODISHA,Total,10,Total,468214,445392,913606
1833,21,State - ODISHA,Total,11,Total,428712,411221,839933
1834,21,State - ODISHA,Total,12,Total,467103,449696,916799
1835,21,State - ODISHA,Total,13,Total,420237,419236,839473
1836,21,State - ODISHA,Total,14,Total,419269,419545,838814
1837,21,State - ODISHA,Total,15,Total,436883,432703,869586
1838,21,State - ODISHA,Total,16,Total,388035,387017,775052
1839,21,State - ODISHA,Total,17,Total,346739,345307,692046
1840,21,State - ODISHA,Total,18,Total,460498,445918,906416
1841,21,State - ODISHA,Total,19,Total,340529,341769,682298
1842,21,State - ODISHA,Total,20-24,Total,1870939,1912588,3783527
1843,21,State - ODISHA,Total,25-29,Total,1772876,1801161,3574037
1844,21,State - ODISHA,Total,30-34,Total,1542233,1560758,3102991
1845,21,State - ODISHA,Total,35-39,Total,1528685,1522503,3051188
1846,21,State - ODISHA,Total,40-44,Total,1387920,1303554,2691474
1847,21,State - ODISHA,Total,45-49,Total,1212366,1121664,2334030
1848,21,State - ODISHA,Total,50-54,Total,957524,890288,1847812
1849,21,State - ODISHA,Total,55-59,Total,744291,739429,1483720
1850,21,State - ODISHA,Total,60-64,Total,737635,736426,1474061
1851,21,State - ODISHA,Total,65-69,Total,487849,491676,979525
1852,21,State - ODISHA,Total,70-74,Total,380635,387435,768070
1853,21,State - ODISHA,Total,75-79,Total,183294,181506,364800
1854,21,State - ODISHA,Total,80+,Total,204857,193135,397992
1855,21,State - ODISHA,Total,Age not stated,Total,61347,57824,119171
1856,21,State - ODISHA,Rural,All ages,Total,17586203,17384359,34970562
1857,21,State - ODISHA,Rural,0-6,Total,2325832,2200038,4525870
1858,21,State - ODISHA,Rural,7,Total,356969,350622,707591
1859,21,State - ODISHA,Rural,8,Total,371645,360011,731656
1860,21,State - ODISHA,Rural,9,Total,336636,329358,665994
1861,21,State - ODISHA,Rural,10,Total,399530,382754,782284
1862,21,State - ODISHA,Rural,11,Total,364263,351479,715742
1863,21,State - ODISHA,Rural,12,Total,398499,385207,783706
1864,21,State - ODISHA,Rural,13,Total,356242,357091,713333
1865,21,State - ODISHA,Rural,14,Total,354009,356322,710331
1866,21,State - ODISHA,Rural,15,Total,366479,366179,732658
1867,21,State - ODISHA,Rural,16,Total,320852,323950,644802
1868,21,State - ODISHA,Rural,17,Total,281802,285013,566815
1869,21,State - ODISHA,Rural,18,Total,375829,370555,746384
1870,21,State - ODISHA,Rural,19,Total,272027,277485,549512
1871,21,State - ODISHA,Rural,20-24,Total,1513663,1565184,3078847
1872,21,State - ODISHA,Rural,25-29,Total,1446384,1472606,2918990
1873,21,State - ODISHA,Rural,30-34,Total,1247203,1272986,2520189
1874,21,State - ODISHA,Rural,35-39,Total,1242592,1244799,2487391
1875,21,State - ODISHA,Rural,40-44,Total,1126384,1069929,2196313
1876,21,State - ODISHA,Rural,45-49,Total,982737,922862,1905599
1877,21,State - ODISHA,Rural,50-54,Total,776529,739533,1516062
1878,21,State - ODISHA,Rural,55-59,Total,607411,628219,1235630
1879,21,State - ODISHA,Rural,60-64,Total,630692,638752,1269444
1880,21,State - ODISHA,Rural,65-69,Total,421279,430391,851670
1881,21,State - ODISHA,Rural,70-74,Total,329265,337254,666519
1882,21,State - ODISHA,Rural,75-79,Total,157552,156525,314077
1883,21,State - ODISHA,Rural,80+,Total,175428,162515,337943
1884,21,State - ODISHA,Rural,Age not stated,Total,48470,46740,95210
1885,21,State - ODISHA,Urban,All ages,Total,3625933,3377723,7003656
1886,21,State - ODISHA,Urban,0-6,Total,390665,356659,747324
1887,21,State - ODISHA,Urban,7,Total,62322,58211,120533
1888,21,State - ODISHA,Urban,8,Total,61865,56843,118708
1889,21,State - ODISHA,Urban,9,Total,57532,52589,110121
1890,21,State - ODISHA,Urban,10,Total,68684,62638,131322
1891,21,State - ODISHA,Urban,11,Total,64449,59742,124191
1892,21,State - ODISHA,Urban,12,Total,68604,64489,133093
1893,21,State - ODISHA,Urban,13,Total,63995,62145,126140
1894,21,State - ODISHA,Urban,14,Total,65260,63223,128483
1895,21,State - ODISHA,Urban,15,Total,70404,66524,136928
1896,21,State - ODISHA,Urban,16,Total,67183,63067,130250
1897,21,State - ODISHA,Urban,17,Total,64937,60294,125231
1898,21,State - ODISHA,Urban,18,Total,84669,75363,160032
1899,21,State - ODISHA,Urban,19,Total,68502,64284,132786
1900,21,State - ODISHA,Urban,20-24,Total,357276,347404,704680
1901,21,State - ODISHA,Urban,25-29,Total,326492,328555,655047
1902,21,State - ODISHA,Urban,30-34,Total,295030,287772,582802
1903,21,State - ODISHA,Urban,35-39,Total,286093,277704,563797
1904,21,State - ODISHA,Urban,40-44,Total,261536,233625,495161
1905,21,State - ODISHA,Urban,45-49,Total,229629,198802,428431
1906,21,State - ODISHA,Urban,50-54,Total,180995,150755,331750
1907,21,State - ODISHA,Urban,55-59,Total,136880,111210,248090
1908,21,State - ODISHA,Urban,60-64,Total,106943,97674,204617
1909,21,State - ODISHA,Urban,65-69,Total,66570,61285,127855
1910,21,State - ODISHA,Urban,70-74,Total,51370,50181,101551
1911,21,State - ODISHA,Urban,75-79,Total,25742,24981,50723
1912,21,State - ODISHA,Urban,80+,Total,29429,30620,60049
1913,21,State - ODISHA,Urban,Age not stated,Total,12877,11084,23961
1914,22,State - CHHATTISGARH,Total,All ages,Total,12832895,12712303,25545198
1915,22,State - CHHATTISGARH,Total,0-6,Total,1859935,1801754,3661689
1916,22,State - CHHATTISGARH,Total,7,Total,273006,266429,539435
1917,22,State - CHHATTISGARH,Total,8,Total,292487,281478,573965
1918,22,State - CHHATTISGARH,Total,9,Total,265621,259113,524734
1919,22,State - CHHATTISGARH,Total,10,Total,328502,313874,642376
1920,22,State - CHHATTISGARH,Total,11,Total,290403,280204,570607
1921,22,State - CHHATTISGARH,Total,12,Total,299695,291195,590890
1922,22,State - CHHATTISGARH,Total,13,Total,267634,266666,534300
1923,22,State - CHHATTISGARH,Total,14,Total,274951,270889,545840
1924,22,State - CHHATTISGARH,Total,15,Total,279910,269780,549690
1925,22,State - CHHATTISGARH,Total,16,Total,273513,267711,541224
1926,22,State - CHHATTISGARH,Total,17,Total,241275,232412,473687
1927,22,State - CHHATTISGARH,Total,18,Total,301756,284871,586627
1928,22,State - CHHATTISGARH,Total,19,Total,222997,225617,448614
1929,22,State - CHHATTISGARH,Total,20-24,Total,1193378,1196119,2389497
1930,22,State - CHHATTISGARH,Total,25-29,Total,1049238,1008062,2057300
1931,22,State - CHHATTISGARH,Total,30-34,Total,898023,917035,1815058
1932,22,State - CHHATTISGARH,Total,35-39,Total,891265,888149,1779414
1933,22,State - CHHATTISGARH,Total,40-44,Total,796402,780151,1576553
1934,22,State - CHHATTISGARH,Total,45-49,Total,692974,641400,1334374
1935,22,State - CHHATTISGARH,Total,50-54,Total,510326,482621,992947
1936,22,State - CHHATTISGARH,Total,55-59,Total,389338,400015,789353
1937,22,State - CHHATTISGARH,Total,60-64,Total,348956,394786,743742
1938,22,State - CHHATTISGARH,Total,65-69,Total,244336,289474,533810
1939,22,State - CHHATTISGARH,Total,70-74,Total,174249,198751,373000
1940,22,State - CHHATTISGARH,Total,75-79,Total,75545,91033,166578
1941,22,State - CHHATTISGARH,Total,80+,Total,85073,101706,186779
1942,22,State - CHHATTISGARH,Total,Age not stated,Total,12107,11008,23115
1943,22,State - CHHATTISGARH,Rural,All ages,Total,9797426,9810535,19607961
1944,22,State - CHHATTISGARH,Rural,0-6,Total,1479586,1445355,2924941
1945,22,State - CHHATTISGARH,Rural,7,Total,215027,211449,426476
1946,22,State - CHHATTISGARH,Rural,8,Total,233876,227434,461310
1947,22,State - CHHATTISGARH,Rural,9,Total,212102,209295,421397
1948,22,State - CHHATTISGARH,Rural,10,Total,262420,253431,515851
1949,22,State - CHHATTISGARH,Rural,11,Total,230619,224521,455140
1950,22,State - CHHATTISGARH,Rural,12,Total,237551,233092,470643
1951,22,State - CHHATTISGARH,Rural,13,Total,209475,210672,420147
1952,22,State - CHHATTISGARH,Rural,14,Total,215009,212837,427846
1953,22,State - CHHATTISGARH,Rural,15,Total,217719,211394,429113
1954,22,State - CHHATTISGARH,Rural,16,Total,211746,209170,420916
1955,22,State - CHHATTISGARH,Rural,17,Total,183115,177796,360911
1956,22,State - CHHATTISGARH,Rural,18,Total,230617,220173,450790
1957,22,State - CHHATTISGARH,Rural,19,Total,166137,170184,336321
1958,22,State - CHHATTISGARH,Rural,20-24,Total,885162,888767,1773929
1959,22,State - CHHATTISGARH,Rural,25-29,Total,770527,737655,1508182
1960,22,State - CHHATTISGARH,Rural,30-34,Total,656456,683545,1340001
1961,22,State - CHHATTISGARH,Rural,35-39,Total,663342,666074,1329416
1962,22,State - CHHATTISGARH,Rural,40-44,Total,590214,588938,1179152
1963,22,State - CHHATTISGARH,Rural,45-49,Total,516444,481879,998323
1964,22,State - CHHATTISGARH,Rural,50-54,Total,376646,364932,741578
1965,22,State - CHHATTISGARH,Rural,55-59,Total,290945,312099,603044
1966,22,State - CHHATTISGARH,Rural,60-64,Total,273504,314817,588321
1967,22,State - CHHATTISGARH,Rural,65-69,Total,195192,234210,429402
1968,22,State - CHHATTISGARH,Rural,70-74,Total,139047,160401,299448
1969,22,State - CHHATTISGARH,Rural,75-79,Total,58945,73190,132135
1970,22,State - CHHATTISGARH,Rural,80+,Total,68761,80480,149241
1971,22,State - CHHATTISGARH,Rural,Age not stated,Total,7242,6745,13987
1972,22,State - CHHATTISGARH,Urban,All ages,Total,3035469,2901768,5937237
1973,22,State - CHHATTISGARH,Urban,0-6,Total,380349,356399,736748
1974,22,State - CHHATTISGARH,Urban,7,Total,57979,54980,112959
1975,22,State - CHHATTISGARH,Urban,8,Total,58611,54044,112655
1976,22,State - CHHATTISGARH,Urban,9,Total,53519,49818,103337
1977,22,State - CHHATTISGARH,Urban,10,Total,66082,60443,126525
1978,22,State - CHHATTISGARH,Urban,11,Total,59784,55683,115467
1979,22,State - CHHATTISGARH,Urban,12,Total,62144,58103,120247
1980,22,State - CHHATTISGARH,Urban,13,Total,58159,55994,114153
1981,22,State - CHHATTISGARH,Urban,14,Total,59942,58052,117994
1982,22,State - CHHATTISGARH,Urban,15,Total,62191,58386,120577
1983,22,State - CHHATTISGARH,Urban,16,Total,61767,58541,120308
1984,22,State - CHHATTISGARH,Urban,17,Total,58160,54616,112776
1985,22,State - CHHATTISGARH,Urban,18,Total,71139,64698,135837
1986,22,State - CHHATTISGARH,Urban,19,Total,56860,55433,112293
1987,22,State - CHHATTISGARH,Urban,20-24,Total,308216,307352,615568
1988,22,State - CHHATTISGARH,Urban,25-29,Total,278711,270407,549118
1989,22,State - CHHATTISGARH,Urban,30-34,Total,241567,233490,475057
1990,22,State - CHHATTISGARH,Urban,35-39,Total,227923,222075,449998
1991,22,State - CHHATTISGARH,Urban,40-44,Total,206188,191213,397401
1992,22,State - CHHATTISGARH,Urban,45-49,Total,176530,159521,336051
1993,22,State - CHHATTISGARH,Urban,50-54,Total,133680,117689,251369
1994,22,State - CHHATTISGARH,Urban,55-59,Total,98393,87916,186309
1995,22,State - CHHATTISGARH,Urban,60-64,Total,75452,79969,155421
1996,22,State - CHHATTISGARH,Urban,65-69,Total,49144,55264,104408
1997,22,State - CHHATTISGARH,Urban,70-74,Total,35202,38350,73552
1998,22,State - CHHATTISGARH,Urban,75-79,Total,16600,17843,34443
1999,22,State - CHHATTISGARH,Urban,80+,Total,16312,21226,37538
2000,22,State - CHHATTISGARH,Urban,Age not stated,Total,4865,4263,9128
2001,23,State - MADHYA PRADESH,Total,All ages,Total,37612306,35014503,72626809
2002,23,State - MADHYA PRADESH,Total,0-6,Total,5636172,5173223,10809395
2003,23,State - MADHYA PRADESH,Total,7,Total,833279,778329,1611608
2004,23,State - MADHYA PRADESH,Total,8,Total,930043,864149,1794192
2005,23,State - MADHYA PRADESH,Total,9,Total,784446,738100,1522546
2006,23,State - MADHYA PRADESH,Total,10,Total,1030242,950852,1981094
2007,23,State - MADHYA PRADESH,Total,11,Total,835981,783746,1619727
2008,23,State - MADHYA PRADESH,Total,12,Total,948499,871117,1819616
2009,23,State - MADHYA PRADESH,Total,13,Total,798035,753044,1551079
2010,23,State - MADHYA PRADESH,Total,14,Total,826572,766413,1592985
2011,23,State - MADHYA PRADESH,Total,15,Total,858450,754630,1613080
2012,23,State - MADHYA PRADESH,Total,16,Total,827357,724096,1551453
2013,23,State - MADHYA PRADESH,Total,17,Total,694205,598938,1293143
2014,23,State - MADHYA PRADESH,Total,18,Total,943897,797945,1741842
2015,23,State - MADHYA PRADESH,Total,19,Total,656163,591108,1247271
2016,23,State - MADHYA PRADESH,Total,20-24,Total,3554088,3173491,6727579
2017,23,State - MADHYA PRADESH,Total,25-29,Total,2988325,2799181,5787506
2018,23,State - MADHYA PRADESH,Total,30-34,Total,2650705,2564255,5214960
2019,23,State - MADHYA PRADESH,Total,35-39,Total,2493464,2368207,4861671
2020,23,State - MADHYA PRADESH,Total,40-44,Total,2193888,2020586,4214474
2021,23,State - MADHYA PRADESH,Total,45-49,Total,1838798,1684163,3522961
2022,23,State - MADHYA PRADESH,Total,50-54,Total,1446522,1247850,2694372
2023,23,State - MADHYA PRADESH,Total,55-59,Total,1030243,1027834,2058077
2024,23,State - MADHYA PRADESH,Total,60-64,Total,989463,997947,1987410
2025,23,State - MADHYA PRADESH,Total,65-69,Total,680005,747056,1427061
2026,23,State - MADHYA PRADESH,Total,70-74,Total,545246,562175,1107421
2027,23,State - MADHYA PRADESH,Total,75-79,Total,244807,278548,523355
2028,23,State - MADHYA PRADESH,Total,80+,Total,310035,358034,668069
2029,23,State - MADHYA PRADESH,Total,Age not stated,Total,43376,39486,82862
2030,23,State - MADHYA PRADESH,Rural,All ages,Total,27149388,25408016,52557404
2031,23,State - MADHYA PRADESH,Rural,0-6,Total,4329993,3995738,8325731
2032,23,State - MADHYA PRADESH,Rural,7,Total,630495,594564,1225059
2033,23,State - MADHYA PRADESH,Rural,8,Total,718948,676876,1395824
2034,23,State - MADHYA PRADESH,Rural,9,Total,595003,569518,1164521
2035,23,State - MADHYA PRADESH,Rural,10,Total,786305,737551,1523856
2036,23,State - MADHYA PRADESH,Rural,11,Total,626084,597252,1223336
2037,23,State - MADHYA PRADESH,Rural,12,Total,719800,671006,1390806
2038,23,State - MADHYA PRADESH,Rural,13,Total,593136,565230,1158366
2039,23,State - MADHYA PRADESH,Rural,14,Total,612776,571895,1184671
2040,23,State - MADHYA PRADESH,Rural,15,Total,632822,557183,1190005
2041,23,State - MADHYA PRADESH,Rural,16,Total,606419,530468,1136887
2042,23,State - MADHYA PRADESH,Rural,17,Total,490475,421306,911781
2043,23,State - MADHYA PRADESH,Rural,18,Total,680746,576010,1256756
2044,23,State - MADHYA PRADESH,Rural,19,Total,451885,412406,864291
2045,23,State - MADHYA PRADESH,Rural,20-24,Total,2481628,2197131,4678759
2046,23,State - MADHYA PRADESH,Rural,25-29,Total,2067454,1923404,3990858
2047,23,State - MADHYA PRADESH,Rural,30-34,Total,1841507,1797462,3638969
2048,23,State - MADHYA PRADESH,Rural,35-39,Total,1750469,1657138,3407607
2049,23,State - MADHYA PRADESH,Rural,40-44,Total,1527419,1409839,2937258
2050,23,State - MADHYA PRADESH,Rural,45-49,Total,1260719,1164791,2425510
2051,23,State - MADHYA PRADESH,Rural,50-54,Total,988058,859466,1847524
2052,23,State - MADHYA PRADESH,Rural,55-59,Total,704014,733099,1437113
2053,23,State - MADHYA PRADESH,Rural,60-64,Total,711867,725303,1437170
2054,23,State - MADHYA PRADESH,Rural,65-69,Total,497698,556687,1054385
2055,23,State - MADHYA PRADESH,Rural,70-74,Total,408168,418606,826774
2056,23,State - MADHYA PRADESH,Rural,75-79,Total,178514,206337,384851
2057,23,State - MADHYA PRADESH,Rural,80+,Total,232111,259315,491426
2058,23,State - MADHYA PRADESH,Rural,Age not stated,Total,24875,22435,47310
2059,23,State - MADHYA PRADESH,Urban,All ages,Total,10462918,9606487,20069405
2060,23,State - MADHYA PRADESH,Urban,0-6,Total,1306179,1177485,2483664
2061,23,State - MADHYA PRADESH,Urban,7,Total,202784,183765,386549
2062,23,State - MADHYA PRADESH,Urban,8,Total,211095,187273,398368
2063,23,State - MADHYA PRADESH,Urban,9,Total,189443,168582,358025
2064,23,State - MADHYA PRADESH,Urban,10,Total,243937,213301,457238
2065,23,State - MADHYA PRADESH,Urban,11,Total,209897,186494,396391
2066,23,State - MADHYA PRADESH,Urban,12,Total,228699,200111,428810
2067,23,State - MADHYA PRADESH,Urban,13,Total,204899,187814,392713
2068,23,State - MADHYA PRADESH,Urban,14,Total,213796,194518,408314
2069,23,State - MADHYA PRADESH,Urban,15,Total,225628,197447,423075
2070,23,State - MADHYA PRADESH,Urban,16,Total,220938,193628,414566
2071,23,State - MADHYA PRADESH,Urban,17,Total,203730,177632,381362
2072,23,State - MADHYA PRADESH,Urban,18,Total,263151,221935,485086
2073,23,State - MADHYA PRADESH,Urban,19,Total,204278,178702,382980
2074,23,State - MADHYA PRADESH,Urban,20-24,Total,1072460,976360,2048820
2075,23,State - MADHYA PRADESH,Urban,25-29,Total,920871,875777,1796648
2076,23,State - MADHYA PRADESH,Urban,30-34,Total,809198,766793,1575991
2077,23,State - MADHYA PRADESH,Urban,35-39,Total,742995,711069,1454064
2078,23,State - MADHYA PRADESH,Urban,40-44,Total,666469,610747,1277216
2079,23,State - MADHYA PRADESH,Urban,45-49,Total,578079,519372,1097451
2080,23,State - MADHYA PRADESH,Urban,50-54,Total,458464,388384,846848
2081,23,State - MADHYA PRADESH,Urban,55-59,Total,326229,294735,620964
2082,23,State - MADHYA PRADESH,Urban,60-64,Total,277596,272644,550240
2083,23,State - MADHYA PRADESH,Urban,65-69,Total,182307,190369,372676
2084,23,State - MADHYA PRADESH,Urban,70-74,Total,137078,143569,280647
2085,23,State - MADHYA PRADESH,Urban,75-79,Total,66293,72211,138504
2086,23,State - MADHYA PRADESH,Urban,80+,Total,77924,98719,176643
2087,23,State - MADHYA PRADESH,Urban,Age not stated,Total,18501,17051,35552
2088,24,State - GUJARAT,Total,All ages,Total,31491260,28948432,60439692
2089,24,State - GUJARAT,Total,0-6,Total,4115384,3661878,7777262
2090,24,State - GUJARAT,Total,7,Total,642667,563579,1206246
2091,24,State - GUJARAT,Total,8,Total,629448,548875,1178323
2092,24,State - GUJARAT,Total,9,Total,610792,523545,1134337
2093,24,State - GUJARAT,Total,10,Total,704106,607854,1311960
2094,24,State - GUJARAT,Total,11,Total,663546,573045,1236591
2095,24,State - GUJARAT,Total,12,Total,663603,581622,1245225
2096,24,State - GUJARAT,Total,13,Total,626998,553513,1180511
2097,24,State - GUJARAT,Total,14,Total,625581,549577,1175158
2098,24,State - GUJARAT,Total,15,Total,656901,565087,1221988
2099,24,State - GUJARAT,Total,16,Total,612601,535426,1148027
2100,24,State - GUJARAT,Total,17,Total,592392,508548,1100940
2101,24,State - GUJARAT,Total,18,Total,702316,595128,1297444
2102,24,State - GUJARAT,Total,19,Total,581900,515461,1097361
2103,24,State - GUJARAT,Total,20-24,Total,3046127,2734595,5780722
2104,24,State - GUJARAT,Total,25-29,Total,2767283,2511539,5278822
2105,24,State - GUJARAT,Total,30-34,Total,2467024,2303504,4770528
2106,24,State - GUJARAT,Total,35-39,Total,2258335,2082890,4341225
2107,24,State - GUJARAT,Total,40-44,Total,1993876,1871600,3865476
2108,24,State - GUJARAT,Total,45-49,Total,1711872,1602141,3314013
2109,24,State - GUJARAT,Total,50-54,Total,1409273,1287910,2697183
2110,24,State - GUJARAT,Total,55-59,Total,1038088,1016859,2054947
2111,24,State - GUJARAT,Total,60-64,Total,851259,876493,1727752
2112,24,State - GUJARAT,Total,65-69,Total,550002,620070,1170072
2113,24,State - GUJARAT,Total,70-74,Total,417522,482155,899677
2114,24,State - GUJARAT,Total,75-79,Total,196341,243655,439996
2115,24,State - GUJARAT,Total,80+,Total,230477,318585,549062
2116,24,State - GUJARAT,Total,Age not stated,Total,125546,113298,238844
2117,24,State - GUJARAT,Rural,All ages,Total,17799159,16895450,34694609
2118,24,State - GUJARAT,Rural,0-6,Total,2521455,2303448,4824903
2119,24,State - GUJARAT,Rural,7,Total,386470,351222,737692
2120,24,State - GUJARAT,Rural,8,Total,388990,350894,739884
2121,24,State - GUJARAT,Rural,9,Total,373999,333050,707049
2122,24,State - GUJARAT,Rural,10,Total,427486,384992,812478
2123,24,State - GUJARAT,Rural,11,Total,402077,360420,762497
2124,24,State - GUJARAT,Rural,12,Total,404555,368195,772750
2125,24,State - GUJARAT,Rural,13,Total,380707,345950,726657
2126,24,State - GUJARAT,Rural,14,Total,374554,338945,713499
2127,24,State - GUJARAT,Rural,15,Total,391524,349155,740679
2128,24,State - GUJARAT,Rural,16,Total,359632,325478,685110
2129,24,State - GUJARAT,Rural,17,Total,334951,301917,636868
2130,24,State - GUJARAT,Rural,18,Total,388891,354512,743403
2131,24,State - GUJARAT,Rural,19,Total,306576,293898,600474
2132,24,State - GUJARAT,Rural,20-24,Total,1613761,1515353,3129114
2133,24,State - GUJARAT,Rural,25-29,Total,1439403,1328138,2767541
2134,24,State - GUJARAT,Rural,30-34,Total,1309468,1258397,2567865
2135,24,State - GUJARAT,Rural,35-39,Total,1230816,1149061,2379877
2136,24,State - GUJARAT,Rural,40-44,Total,1096357,1052829,2149186
2137,24,State - GUJARAT,Rural,45-49,Total,938828,891708,1830536
2138,24,State - GUJARAT,Rural,50-54,Total,772574,732093,1504667
2139,24,State - GUJARAT,Rural,55-59,Total,569554,592318,1161872
2140,24,State - GUJARAT,Rural,60-64,Total,494349,528694,1023043
2141,24,State - GUJARAT,Rural,65-69,Total,323610,383659,707269
2142,24,State - GUJARAT,Rural,70-74,Total,256602,303123,559725
2143,24,State - GUJARAT,Rural,75-79,Total,113543,148461,262004
2144,24,State - GUJARAT,Rural,80+,Total,139154,193131,332285
2145,24,State - GUJARAT,Rural,Age not stated,Total,59273,56409,115682
2146,24,State - GUJARAT,Urban,All ages,Total,13692101,12052982,25745083
2147,24,State - GUJARAT,Urban,0-6,Total,1593929,1358430,2952359
2148,24,State - GUJARAT,Urban,7,Total,256197,212357,468554
2149,24,State - GUJARAT,Urban,8,Total,240458,197981,438439
2150,24,State - GUJARAT,Urban,9,Total,236793,190495,427288
2151,24,State - GUJARAT,Urban,10,Total,276620,222862,499482
2152,24,State - GUJARAT,Urban,11,Total,261469,212625,474094
2153,24,State - GUJARAT,Urban,12,Total,259048,213427,472475
2154,24,State - GUJARAT,Urban,13,Total,246291,207563,453854
2155,24,State - GUJARAT,Urban,14,Total,251027,210632,461659
2156,24,State - GUJARAT,Urban,15,Total,265377,215932,481309
2157,24,State - GUJARAT,Urban,16,Total,252969,209948,462917
2158,24,State - GUJARAT,Urban,17,Total,257441,206631,464072
2159,24,State - GUJARAT,Urban,18,Total,313425,240616,554041
2160,24,State - GUJARAT,Urban,19,Total,275324,221563,496887
2161,24,State - GUJARAT,Urban,20-24,Total,1432366,1219242,2651608
2162,24,State - GUJARAT,Urban,25-29,Total,1327880,1183401,2511281
2163,24,State - GUJARAT,Urban,30-34,Total,1157556,1045107,2202663
2164,24,State - GUJARAT,Urban,35-39,Total,1027519,933829,1961348
2165,24,State - GUJARAT,Urban,40-44,Total,897519,818771,1716290
2166,24,State - GUJARAT,Urban,45-49,Total,773044,710433,1483477
2167,24,State - GUJARAT,Urban,50-54,Total,636699,555817,1192516
2168,24,State - GUJARAT,Urban,55-59,Total,468534,424541,893075
2169,24,State - GUJARAT,Urban,60-64,Total,356910,347799,704709
2170,24,State - GUJARAT,Urban,65-69,Total,226392,236411,462803
2171,24,State - GUJARAT,Urban,70-74,Total,160920,179032,339952
2172,24,State - GUJARAT,Urban,75-79,Total,82798,95194,177992
2173,24,State - GUJARAT,Urban,80+,Total,91323,125454,216777
2174,24,State - GUJARAT,Urban,Age not stated,Total,66273,56889,123162
2175,25,State - DAMAN & DIU,Total,All ages,Total,150301,92946,243247
2176,25,State - DAMAN & DIU,Total,0-6,Total,14144,12790,26934
2177,25,State - DAMAN & DIU,Total,7,Total,1998,1772,3770
2178,25,State - DAMAN & DIU,Total,8,Total,1934,1714,3648
2179,25,State - DAMAN & DIU,Total,9,Total,1772,1540,3312
2180,25,State - DAMAN & DIU,Total,10,Total,1982,1750,3732
2181,25,State - DAMAN & DIU,Total,11,Total,1940,1657,3597
2182,25,State - DAMAN & DIU,Total,12,Total,1818,1560,3378
2183,25,State - DAMAN & DIU,Total,13,Total,1747,1542,3289
2184,25,State - DAMAN & DIU,Total,14,Total,1813,1512,3325
2185,25,State - DAMAN & DIU,Total,15,Total,2068,1482,3550
2186,25,State - DAMAN & DIU,Total,16,Total,2421,1455,3876
2187,25,State - DAMAN & DIU,Total,17,Total,3048,1463,4511
2188,25,State - DAMAN & DIU,Total,18,Total,5777,1822,7599
2189,25,State - DAMAN & DIU,Total,19,Total,4925,1853,6778
2190,25,State - DAMAN & DIU,Total,20-24,Total,27925,10659,38584
2191,25,State - DAMAN & DIU,Total,25-29,Total,22044,11137,33181
2192,25,State - DAMAN & DIU,Total,30-34,Total,15314,8717,24031
2193,25,State - DAMAN & DIU,Total,35-39,Total,12255,7295,19550
2194,25,State - DAMAN & DIU,Total,40-44,Total,8384,5217,13601
2195,25,State - DAMAN & DIU,Total,45-49,Total,5649,3969,9618
2196,25,State - DAMAN & DIU,Total,50-54,Total,3646,2964,6610
2197,25,State - DAMAN & DIU,Total,55-59,Total,2576,2480,5056
2198,25,State - DAMAN & DIU,Total,60-64,Total,1977,2331,4308
2199,25,State - DAMAN & DIU,Total,65-69,Total,1182,1571,2753
2200,25,State - DAMAN & DIU,Total,70-74,Total,841,1262,2103
2201,25,State - DAMAN & DIU,Total,75-79,Total,437,630,1067
2202,25,State - DAMAN & DIU,Total,80+,Total,436,694,1130
2203,25,State - DAMAN & DIU,Total,Age not stated,Total,248,108,356
2204,25,State - DAMAN & DIU,Rural,All ages,Total,32395,28001,60396
2205,25,State - DAMAN & DIU,Rural,0-6,Total,3849,3589,7438
2206,25,State - DAMAN & DIU,Rural,7,Total,622,554,1176
2207,25,State - DAMAN & DIU,Rural,8,Total,620,574,1194
2208,25,State - DAMAN & DIU,Rural,9,Total,583,550,1133
2209,25,State - DAMAN & DIU,Rural,10,Total,668,653,1321
2210,25,State - DAMAN & DIU,Rural,11,Total,722,608,1330
2211,25,State - DAMAN & DIU,Rural,12,Total,674,591,1265
2212,25,State - DAMAN & DIU,Rural,13,Total,620,611,1231
2213,25,State - DAMAN & DIU,Rural,14,Total,618,570,1188
2214,25,State - DAMAN & DIU,Rural,15,Total,660,562,1222
2215,25,State - DAMAN & DIU,Rural,16,Total,677,537,1214
2216,25,State - DAMAN & DIU,Rural,17,Total,704,589,1293
2217,25,State - DAMAN & DIU,Rural,18,Total,908,576,1484
2218,25,State - DAMAN & DIU,Rural,19,Total,817,625,1442
2219,25,State - DAMAN & DIU,Rural,20-24,Total,4117,2907,7024
2220,25,State - DAMAN & DIU,Rural,25-29,Total,3416,2709,6125
2221,25,State - DAMAN & DIU,Rural,30-34,Total,2823,2254,5077
2222,25,State - DAMAN & DIU,Rural,35-39,Total,2601,2080,4681
2223,25,State - DAMAN & DIU,Rural,40-44,Total,1905,1584,3489
2224,25,State - DAMAN & DIU,Rural,45-49,Total,1496,1270,2766
2225,25,State - DAMAN & DIU,Rural,50-54,Total,1047,1043,2090
2226,25,State - DAMAN & DIU,Rural,55-59,Total,740,807,1547
2227,25,State - DAMAN & DIU,Rural,60-64,Total,592,796,1388
2228,25,State - DAMAN & DIU,Rural,65-69,Total,374,496,870
2229,25,State - DAMAN & DIU,Rural,70-74,Total,275,400,675
2230,25,State - DAMAN & DIU,Rural,75-79,Total,112,202,314
2231,25,State - DAMAN & DIU,Rural,80+,Total,112,224,336
2232,25,State - DAMAN & DIU,Rural,Age not stated,Total,43,40,83
2233,25,State - DAMAN & DIU,Urban,All ages,Total,117906,64945,182851
2234,25,State - DAMAN & DIU,Urban,0-6,Total,10295,9201,19496
2235,25,State - DAMAN & DIU,Urban,7,Total,1376,1218,2594
2236,25,State - DAMAN & DIU,Urban,8,Total,1314,1140,2454
2237,25,State - DAMAN & DIU,Urban,9,Total,1189,990,2179
2238,25,State - DAMAN & DIU,Urban,10,Total,1314,1097,2411
2239,25,State - DAMAN & DIU,Urban,11,Total,1218,1049,2267
2240,25,State - DAMAN & DIU,Urban,12,Total,1144,969,2113
2241,25,State - DAMAN & DIU,Urban,13,Total,1127,931,2058
2242,25,State - DAMAN & DIU,Urban,14,Total,1195,942,2137
2243,25,State - DAMAN & DIU,Urban,15,Total,1408,920,2328
2244,25,State - DAMAN & DIU,Urban,16,Total,1744,918,2662
2245,25,State - DAMAN & DIU,Urban,17,Total,2344,874,3218
2246,25,State - DAMAN & DIU,Urban,18,Total,4869,1246,6115
2247,25,State - DAMAN & DIU,Urban,19,Total,4108,1228,5336
2248,25,State - DAMAN & DIU,Urban,20-24,Total,23808,7752,31560
2249,25,State - DAMAN & DIU,Urban,25-29,Total,18628,8428,27056
2250,25,State - DAMAN & DIU,Urban,30-34,Total,12491,6463,18954
2251,25,State - DAMAN & DIU,Urban,35-39,Total,9654,5215,14869
2252,25,State - DAMAN & DIU,Urban,40-44,Total,6479,3633,10112
2253,25,State - DAMAN & DIU,Urban,45-49,Total,4153,2699,6852
2254,25,State - DAMAN & DIU,Urban,50-54,Total,2599,1921,4520
2255,25,State - DAMAN & DIU,Urban,55-59,Total,1836,1673,3509
2256,25,State - DAMAN & DIU,Urban,60-64,Total,1385,1535,2920
2257,25,State - DAMAN & DIU,Urban,65-69,Total,808,1075,1883
2258,25,State - DAMAN & DIU,Urban,70-74,Total,566,862,1428
2259,25,State - DAMAN & DIU,Urban,75-79,Total,325,428,753
2260,25,State - DAMAN & DIU,Urban,80+,Total,324,470,794
2261,25,State - DAMAN & DIU,Urban,Age not stated,Total,205,68,273
2262,26,State - DADRA & NAGAR HAVELI,Total,All ages,Total,193760,149949,343709
2263,26,State - DADRA & NAGAR HAVELI,Total,0-6,Total,26431,24464,50895
2264,26,State - DADRA & NAGAR HAVELI,Total,7,Total,3977,3516,7493
2265,26,State - DADRA & NAGAR HAVELI,Total,8,Total,3905,3577,7482
2266,26,State - DADRA & NAGAR HAVELI,Total,9,Total,3648,3292,6940
2267,26,State - DADRA & NAGAR HAVELI,Total,10,Total,4051,3784,7835
2268,26,State - DADRA & NAGAR HAVELI,Total,11,Total,3895,3502,7397
2269,26,State - DADRA & NAGAR HAVELI,Total,12,Total,3559,3294,6853
2270,26,State - DADRA & NAGAR HAVELI,Total,13,Total,3573,3155,6728
2271,26,State - DADRA & NAGAR HAVELI,Total,14,Total,3307,2883,6190
2272,26,State - DADRA & NAGAR HAVELI,Total,15,Total,3280,2768,6048
2273,26,State - DADRA & NAGAR HAVELI,Total,16,Total,3087,2578,5665
2274,26,State - DADRA & NAGAR HAVELI,Total,17,Total,3386,2296,5682
2275,26,State - DADRA & NAGAR HAVELI,Total,18,Total,5218,2857,8075
2276,26,State - DADRA & NAGAR HAVELI,Total,19,Total,5008,2626,7634
2277,26,State - DADRA & NAGAR HAVELI,Total,20-24,Total,27595,16706,44301
2278,26,State - DADRA & NAGAR HAVELI,Total,25-29,Total,23496,16389,39885
2279,26,State - DADRA & NAGAR HAVELI,Total,30-34,Total,17957,12684,30641
2280,26,State - DADRA & NAGAR HAVELI,Total,35-39,Total,14862,10415,25277
2281,26,State - DADRA & NAGAR HAVELI,Total,40-44,Total,10554,7627,18181
2282,26,State - DADRA & NAGAR HAVELI,Total,45-49,Total,7671,6118,13789
2283,26,State - DADRA & NAGAR HAVELI,Total,50-54,Total,5215,4288,9503
2284,26,State - DADRA & NAGAR HAVELI,Total,55-59,Total,3526,3425,6951
2285,26,State - DADRA & NAGAR HAVELI,Total,60-64,Total,2794,3037,5831
2286,26,State - DADRA & NAGAR HAVELI,Total,65-69,Total,1755,1961,3716
2287,26,State - DADRA & NAGAR HAVELI,Total,70-74,Total,973,1336,2309
2288,26,State - DADRA & NAGAR HAVELI,Total,75-79,Total,394,564,958
2289,26,State - DADRA & NAGAR HAVELI,Total,80+,Total,443,635,1078
2290,26,State - DADRA & NAGAR HAVELI,Total,Age not stated,Total,200,172,372
2291,26,State - DADRA & NAGAR HAVELI,Rural,All ages,Total,98305,84809,183114
2292,26,State - DADRA & NAGAR HAVELI,Rural,0-6,Total,14467,14037,28504
2293,26,State - DADRA & NAGAR HAVELI,Rural,7,Total,2227,2063,4290
2294,26,State - DADRA & NAGAR HAVELI,Rural,8,Total,2371,2234,4605
2295,26,State - DADRA & NAGAR HAVELI,Rural,9,Total,2139,2103,4242
2296,26,State - DADRA & NAGAR HAVELI,Rural,10,Total,2539,2406,4945
2297,26,State - DADRA & NAGAR HAVELI,Rural,11,Total,2486,2303,4789
2298,26,State - DADRA & NAGAR HAVELI,Rural,12,Total,2226,2155,4381
2299,26,State - DADRA & NAGAR HAVELI,Rural,13,Total,2266,2092,4358
2300,26,State - DADRA & NAGAR HAVELI,Rural,14,Total,2047,1832,3879
2301,26,State - DADRA & NAGAR HAVELI,Rural,15,Total,1993,1793,3786
2302,26,State - DADRA & NAGAR HAVELI,Rural,16,Total,1840,1677,3517
2303,26,State - DADRA & NAGAR HAVELI,Rural,17,Total,1882,1405,3287
2304,26,State - DADRA & NAGAR HAVELI,Rural,18,Total,2609,1795,4404
2305,26,State - DADRA & NAGAR HAVELI,Rural,19,Total,2451,1568,4019
2306,26,State - DADRA & NAGAR HAVELI,Rural,20-24,Total,13066,8866,21932
2307,26,State - DADRA & NAGAR HAVELI,Rural,25-29,Total,10255,7402,17657
2308,26,State - DADRA & NAGAR HAVELI,Rural,30-34,Total,7322,5778,13100
2309,26,State - DADRA & NAGAR HAVELI,Rural,35-39,Total,6209,5229,11438
2310,26,State - DADRA & NAGAR HAVELI,Rural,40-44,Total,4938,4415,9353
2311,26,State - DADRA & NAGAR HAVELI,Rural,45-49,Total,4059,3772,7831
2312,26,State - DADRA & NAGAR HAVELI,Rural,50-54,Total,3014,2714,5728
2313,26,State - DADRA & NAGAR HAVELI,Rural,55-59,Total,2036,2175,4211
2314,26,State - DADRA & NAGAR HAVELI,Rural,60-64,Total,1690,2026,3716
2315,26,State - DADRA & NAGAR HAVELI,Rural,65-69,Total,1067,1294,2361
2316,26,State - DADRA & NAGAR HAVELI,Rural,70-74,Total,587,898,1485
2317,26,State - DADRA & NAGAR HAVELI,Rural,75-79,Total,208,351,559
2318,26,State - DADRA & NAGAR HAVELI,Rural,80+,Total,198,319,517
2319,26,State - DADRA & NAGAR HAVELI,Rural,Age not stated,Total,113,107,220
2320,26,State - DADRA & NAGAR HAVELI,Urban,All ages,Total,95455,65140,160595
2321,26,State - DADRA & NAGAR HAVELI,Urban,0-6,Total,11964,10427,22391
2322,26,State - DADRA & NAGAR HAVELI,Urban,7,Total,1750,1453,3203
2323,26,State - DADRA & NAGAR HAVELI,Urban,8,Total,1534,1343,2877
2324,26,State - DADRA & NAGAR HAVELI,Urban,9,Total,1509,1189,2698
2325,26,State - DADRA & NAGAR HAVELI,Urban,10,Total,1512,1378,2890
2326,26,State - DADRA & NAGAR HAVELI,Urban,11,Total,1409,1199,2608
2327,26,State - DADRA & NAGAR HAVELI,Urban,12,Total,1333,1139,2472
2328,26,State - DADRA & NAGAR HAVELI,Urban,13,Total,1307,1063,2370
2329,26,State - DADRA & NAGAR HAVELI,Urban,14,Total,1260,1051,2311
2330,26,State - DADRA & NAGAR HAVELI,Urban,15,Total,1287,975,2262
2331,26,State - DADRA & NAGAR HAVELI,Urban,16,Total,1247,901,2148
2332,26,State - DADRA & NAGAR HAVELI,Urban,17,Total,1504,891,2395
2333,26,State - DADRA & NAGAR HAVELI,Urban,18,Total,2609,1062,3671
2334,26,State - DADRA & NAGAR HAVELI,Urban,19,Total,2557,1058,3615
2335,26,State - DADRA & NAGAR HAVELI,Urban,20-24,Total,14529,7840,22369
2336,26,State - DADRA & NAGAR HAVELI,Urban,25-29,Total,13241,8987,22228
2337,26,State - DADRA & NAGAR HAVELI,Urban,30-34,Total,10635,6906,17541
2338,26,State - DADRA & NAGAR HAVELI,Urban,35-39,Total,8653,5186,13839
2339,26,State - DADRA & NAGAR HAVELI,Urban,40-44,Total,5616,3212,8828
2340,26,State - DADRA & NAGAR HAVELI,Urban,45-49,Total,3612,2346,5958
2341,26,State - DADRA & NAGAR HAVELI,Urban,50-54,Total,2201,1574,3775
2342,26,State - DADRA & NAGAR HAVELI,Urban,55-59,Total,1490,1250,2740
2343,26,State - DADRA & NAGAR HAVELI,Urban,60-64,Total,1104,1011,2115
2344,26,State - DADRA & NAGAR HAVELI,Urban,65-69,Total,688,667,1355
2345,26,State - DADRA & NAGAR HAVELI,Urban,70-74,Total,386,438,824
2346,26,State - DADRA & NAGAR HAVELI,Urban,75-79,Total,186,213,399
2347,26,State - DADRA & NAGAR HAVELI,Urban,80+,Total,245,316,561
2348,26,State - DADRA & NAGAR HAVELI,Urban,Age not stated,Total,87,65,152
2349,27,State - MAHARASHTRA,Total,All ages,Total,58243056,54131277,112374333
2350,27,State - MAHARASHTRA,Total,0-6,Total,7035391,6291126,13326517
2351,27,State - MAHARASHTRA,Total,7,Total,1027436,934275,1961711
2352,27,State - MAHARASHTRA,Total,8,Total,1019451,916229,1935680
2353,27,State - MAHARASHTRA,Total,9,Total,1035528,923244,1958772
2354,27,State - MAHARASHTRA,Total,10,Total,1227446,1089893,2317339
2355,27,State - MAHARASHTRA,Total,11,Total,1141531,1022179,2163710
2356,27,State - MAHARASHTRA,Total,12,Total,1111511,989718,2101229
2357,27,State - MAHARASHTRA,Total,13,Total,1086667,986070,2072737
2358,27,State - MAHARASHTRA,Total,14,Total,1095106,984414,2079520
2359,27,State - MAHARASHTRA,Total,15,Total,1128043,990737,2118780
2360,27,State - MAHARASHTRA,Total,16,Total,1117920,970447,2088367
2361,27,State - MAHARASHTRA,Total,17,Total,1073589,913506,1987095
2362,27,State - MAHARASHTRA,Total,18,Total,1296423,1080629,2377052
2363,27,State - MAHARASHTRA,Total,19,Total,1094425,961548,2055973
2364,27,State - MAHARASHTRA,Total,20-24,Total,5845114,5245852,11090966
2365,27,State - MAHARASHTRA,Total,25-29,Total,5272560,4874553,10147113
2366,27,State - MAHARASHTRA,Total,30-34,Total,4536297,4260010,8796307
2367,27,State - MAHARASHTRA,Total,35-39,Total,4209434,4037726,8247160
2368,27,State - MAHARASHTRA,Total,40-44,Total,3744825,3451264,7196089
2369,27,State - MAHARASHTRA,Total,45-49,Total,3116218,2916236,6032454
2370,27,State - MAHARASHTRA,Total,50-54,Total,2580991,2338326,4919317
2371,27,State - MAHARASHTRA,Total,55-59,Total,1974129,1911685,3885814
2372,27,State - MAHARASHTRA,Total,60-64,Total,1716639,1925841,3642480
2373,27,State - MAHARASHTRA,Total,65-69,Total,1440238,1638114,3078352
2374,27,State - MAHARASHTRA,Total,70-74,Total,1039292,1103844,2143136
2375,27,State - MAHARASHTRA,Total,75-79,Total,515431,547342,1062773
2376,27,State - MAHARASHTRA,Total,80+,Total,542109,638085,1180194
2377,27,State - MAHARASHTRA,Total,Age not stated,Total,219312,188384,407696
2378,27,State - MAHARASHTRA,Rural,All ages,Total,31539034,30017040,61556074
2379,27,State - MAHARASHTRA,Rural,0-6,Total,4067399,3621555,7688954
2380,27,State - MAHARASHTRA,Rural,7,Total,576762,528061,1104823
2381,27,State - MAHARASHTRA,Rural,8,Total,589439,533859,1123298
2382,27,State - MAHARASHTRA,Rural,9,Total,606638,544709,1151347
2383,27,State - MAHARASHTRA,Rural,10,Total,711318,636852,1348170
2384,27,State - MAHARASHTRA,Rural,11,Total,664482,598719,1263201
2385,27,State - MAHARASHTRA,Rural,12,Total,644103,579441,1223544
2386,27,State - MAHARASHTRA,Rural,13,Total,631466,577850,1209316
2387,27,State - MAHARASHTRA,Rural,14,Total,636787,575039,1211826
2388,27,State - MAHARASHTRA,Rural,15,Total,654820,576384,1231204
2389,27,State - MAHARASHTRA,Rural,16,Total,652477,563090,1215567
2390,27,State - MAHARASHTRA,Rural,17,Total,605491,510378,1115869
2391,27,State - MAHARASHTRA,Rural,18,Total,717166,601376,1318542
2392,27,State - MAHARASHTRA,Rural,19,Total,579270,519213,1098483
2393,27,State - MAHARASHTRA,Rural,20-24,Total,3018199,2746645,5764844
2394,27,State - MAHARASHTRA,Rural,25-29,Total,2589352,2435926,5025278
2395,27,State - MAHARASHTRA,Rural,30-34,Total,2218757,2176444,4395201
2396,27,State - MAHARASHTRA,Rural,35-39,Total,2111275,2112082,4223357
2397,27,State - MAHARASHTRA,Rural,40-44,Total,1924940,1838649,3763589
2398,27,State - MAHARASHTRA,Rural,45-49,Total,1607153,1559955,3167108
2399,27,State - MAHARASHTRA,Rural,50-54,Total,1344947,1274882,2619829
2400,27,State - MAHARASHTRA,Rural,55-59,Total,1038978,1078277,2117255
2401,27,State - MAHARASHTRA,Rural,60-64,Total,970755,1184588,2155343
2402,27,State - MAHARASHTRA,Rural,65-69,Total,920144,1088768,2008912
2403,27,State - MAHARASHTRA,Rural,70-74,Total,684770,726447,1411217
2404,27,State - MAHARASHTRA,Rural,75-79,Total,324175,340552,664727
2405,27,State - MAHARASHTRA,Rural,80+,Total,339248,390093,729341
2406,27,State - MAHARASHTRA,Rural,Age not stated,Total,108723,97206,205929
2407,27,State - MAHARASHTRA,Urban,All ages,Total,26704022,24114237,50818259
2408,27,State - MAHARASHTRA,Urban,0-6,Total,2967992,2669571,5637563
2409,27,State - MAHARASHTRA,Urban,7,Total,450674,406214,856888
2410,27,State - MAHARASHTRA,Urban,8,Total,430012,382370,812382
2411,27,State - MAHARASHTRA,Urban,9,Total,428890,378535,807425
2412,27,State - MAHARASHTRA,Urban,10,Total,516128,453041,969169
2413,27,State - MAHARASHTRA,Urban,11,Total,477049,423460,900509
2414,27,State - MAHARASHTRA,Urban,12,Total,467408,410277,877685
2415,27,State - MAHARASHTRA,Urban,13,Total,455201,408220,863421
2416,27,State - MAHARASHTRA,Urban,14,Total,458319,409375,867694
2417,27,State - MAHARASHTRA,Urban,15,Total,473223,414353,887576
2418,27,State - MAHARASHTRA,Urban,16,Total,465443,407357,872800
2419,27,State - MAHARASHTRA,Urban,17,Total,468098,403128,871226
2420,27,State - MAHARASHTRA,Urban,18,Total,579257,479253,1058510
2421,27,State - MAHARASHTRA,Urban,19,Total,515155,442335,957490
2422,27,State - MAHARASHTRA,Urban,20-24,Total,2826915,2499207,5326122
2423,27,State - MAHARASHTRA,Urban,25-29,Total,2683208,2438627,5121835
2424,27,State - MAHARASHTRA,Urban,30-34,Total,2317540,2083566,4401106
2425,27,State - MAHARASHTRA,Urban,35-39,Total,2098159,1925644,4023803
2426,27,State - MAHARASHTRA,Urban,40-44,Total,1819885,1612615,3432500
2427,27,State - MAHARASHTRA,Urban,45-49,Total,1509065,1356281,2865346
2428,27,State - MAHARASHTRA,Urban,50-54,Total,1236044,1063444,2299488
2429,27,State - MAHARASHTRA,Urban,55-59,Total,935151,833408,1768559
2430,27,State - MAHARASHTRA,Urban,60-64,Total,745884,741253,1487137
2431,27,State - MAHARASHTRA,Urban,65-69,Total,520094,549346,1069440
2432,27,State - MAHARASHTRA,Urban,70-74,Total,354522,377397,731919
2433,27,State - MAHARASHTRA,Urban,75-79,Total,191256,206790,398046
2434,27,State - MAHARASHTRA,Urban,80+,Total,202861,247992,450853
2435,27,State - MAHARASHTRA,Urban,Age not stated,Total,110589,91178,201767
2436,28,State - ANDHRA PRADESH,Total,All ages,Total,42442146,42138631,84580777
2437,28,State - ANDHRA PRADESH,Total,0-6,Total,4714950,4427852,9142802
2438,28,State - ANDHRA PRADESH,Total,7,Total,764908,719040,1483948
2439,28,State - ANDHRA PRADESH,Total,8,Total,766274,730609,1496883
2440,28,State - ANDHRA PRADESH,Total,9,Total,750153,715411,1465564
2441,28,State - ANDHRA PRADESH,Total,10,Total,913080,854308,1767388
2442,28,State - ANDHRA PRADESH,Total,11,Total,795307,764103,1559410
2443,28,State - ANDHRA PRADESH,Total,12,Total,859629,816378,1676007
2444,28,State - ANDHRA PRADESH,Total,13,Total,809422,776327,1585749
2445,28,State - ANDHRA PRADESH,Total,14,Total,831446,781595,1613041
2446,28,State - ANDHRA PRADESH,Total,15,Total,861559,790809,1652368
2447,28,State - ANDHRA PRADESH,Total,16,Total,824000,752131,1576131
2448,28,State - ANDHRA PRADESH,Total,17,Total,780993,685119,1466112
2449,28,State - ANDHRA PRADESH,Total,18,Total,960859,916244,1877103
2450,28,State - ANDHRA PRADESH,Total,19,Total,768896,753137,1522033
2451,28,State - ANDHRA PRADESH,Total,20-24,Total,4055697,4076397,8132094
2452,28,State - ANDHRA PRADESH,Total,25-29,Total,3809887,3989149,7799036
2453,28,State - ANDHRA PRADESH,Total,30-34,Total,3300407,3283964,6584371
2454,28,State - ANDHRA PRADESH,Total,35-39,Total,3198512,3308827,6507339
2455,28,State - ANDHRA PRADESH,Total,40-44,Total,2794398,2605075,5399473
2456,28,State - ANDHRA PRADESH,Total,45-49,Total,2374633,2282636,4657269
2457,28,State - ANDHRA PRADESH,Total,50-54,Total,1862583,1794803,3657386
2458,28,State - ANDHRA PRADESH,Total,55-59,Total,1350539,1559059,2909598
2459,28,State - ANDHRA PRADESH,Total,60-64,Total,1485764,1714073,3199837
2460,28,State - ANDHRA PRADESH,Total,65-69,Total,1034360,1133494,2167854
2461,28,State - ANDHRA PRADESH,Total,70-74,Total,752743,766615,1519358
2462,28,State - ANDHRA PRADESH,Total,75-79,Total,307474,329515,636989
2463,28,State - ANDHRA PRADESH,Total,80+,Total,325987,428216,754203
2464,28,State - ANDHRA PRADESH,Total,Age not stated,Total,387686,383745,771431
2465,28,State - ANDHRA PRADESH,Rural,All ages,Total,28243241,28118461,56361702
2466,28,State - ANDHRA PRADESH,Rural,0-6,Total,3169288,2982734,6152022
2467,28,State - ANDHRA PRADESH,Rural,7,Total,519134,489249,1008383
2468,28,State - ANDHRA PRADESH,Rural,8,Total,527460,504390,1031850
2469,28,State - ANDHRA PRADESH,Rural,9,Total,508816,487956,996772
2470,28,State - ANDHRA PRADESH,Rural,10,Total,618712,579864,1198576
2471,28,State - ANDHRA PRADESH,Rural,11,Total,531833,510562,1042395
2472,28,State - ANDHRA PRADESH,Rural,12,Total,591236,558680,1149916
2473,28,State - ANDHRA PRADESH,Rural,13,Total,552120,527710,1079830
2474,28,State - ANDHRA PRADESH,Rural,14,Total,565959,528726,1094685
2475,28,State - ANDHRA PRADESH,Rural,15,Total,578647,526347,1104994
2476,28,State - ANDHRA PRADESH,Rural,16,Total,544177,487688,1031865
2477,28,State - ANDHRA PRADESH,Rural,17,Total,510581,432256,942837
2478,28,State - ANDHRA PRADESH,Rural,18,Total,659517,610683,1270200
2479,28,State - ANDHRA PRADESH,Rural,19,Total,507071,477102,984173
2480,28,State - ANDHRA PRADESH,Rural,20-24,Total,2682670,2580607,5263277
2481,28,State - ANDHRA PRADESH,Rural,25-29,Total,2453142,2542439,4995581
2482,28,State - ANDHRA PRADESH,Rural,30-34,Total,2106915,2126704,4233619
2483,28,State - ANDHRA PRADESH,Rural,35-39,Total,2064444,2181914,4246358
2484,28,State - ANDHRA PRADESH,Rural,40-44,Total,1819821,1721080,3540901
2485,28,State - ANDHRA PRADESH,Rural,45-49,Total,1549594,1517706,3067300
2486,28,State - ANDHRA PRADESH,Rural,50-54,Total,1229218,1212242,2441460
2487,28,State - ANDHRA PRADESH,Rural,55-59,Total,878394,1096785,1975179
2488,28,State - ANDHRA PRADESH,Rural,60-64,Total,1066864,1275689,2342553
2489,28,State - ANDHRA PRADESH,Rural,65-69,Total,774178,850523,1624701
2490,28,State - ANDHRA PRADESH,Rural,70-74,Total,573247,574771,1148018
2491,28,State - ANDHRA PRADESH,Rural,75-79,Total,224296,235745,460041
2492,28,State - ANDHRA PRADESH,Rural,80+,Total,234293,298485,532778
2493,28,State - ANDHRA PRADESH,Rural,Age not stated,Total,201614,199824,401438
2494,28,State - ANDHRA PRADESH,Urban,All ages,Total,14198905,14020170,28219075
2495,28,State - ANDHRA PRADESH,Urban,0-6,Total,1545662,1445118,2990780
2496,28,State - ANDHRA PRADESH,Urban,7,Total,245774,229791,475565
2497,28,State - ANDHRA PRADESH,Urban,8,Total,238814,226219,465033
2498,28,State - ANDHRA PRADESH,Urban,9,Total,241337,227455,468792
2499,28,State - ANDHRA PRADESH,Urban,10,Total,294368,274444,568812
2500,28,State - ANDHRA PRADESH,Urban,11,Total,263474,253541,517015
2501,28,State - ANDHRA PRADESH,Urban,12,Total,268393,257698,526091
2502,28,State - ANDHRA PRADESH,Urban,13,Total,257302,248617,505919
2503,28,State - ANDHRA PRADESH,Urban,14,Total,265487,252869,518356
2504,28,State - ANDHRA PRADESH,Urban,15,Total,282912,264462,547374
2505,28,State - ANDHRA PRADESH,Urban,16,Total,279823,264443,544266
2506,28,State - ANDHRA PRADESH,Urban,17,Total,270412,252863,523275
2507,28,State - ANDHRA PRADESH,Urban,18,Total,301342,305561,606903
2508,28,State - ANDHRA PRADESH,Urban,19,Total,261825,276035,537860
2509,28,State - ANDHRA PRADESH,Urban,20-24,Total,1373027,1495790,2868817
2510,28,State - ANDHRA PRADESH,Urban,25-29,Total,1356745,1446710,2803455
2511,28,State - ANDHRA PRADESH,Urban,30-34,Total,1193492,1157260,2350752
2512,28,State - ANDHRA PRADESH,Urban,35-39,Total,1134068,1126913,2260981
2513,28,State - ANDHRA PRADESH,Urban,40-44,Total,974577,883995,1858572
2514,28,State - ANDHRA PRADESH,Urban,45-49,Total,825039,764930,1589969
2515,28,State - ANDHRA PRADESH,Urban,50-54,Total,633365,582561,1215926
2516,28,State - ANDHRA PRADESH,Urban,55-59,Total,472145,462274,934419
2517,28,State - ANDHRA PRADESH,Urban,60-64,Total,418900,438384,857284
2518,28,State - ANDHRA PRADESH,Urban,65-69,Total,260182,282971,543153
2519,28,State - ANDHRA PRADESH,Urban,70-74,Total,179496,191844,371340
2520,28,State - ANDHRA PRADESH,Urban,75-79,Total,83178,93770,176948
2521,28,State - ANDHRA PRADESH,Urban,80+,Total,91694,129731,221425
2522,28,State - ANDHRA PRADESH,Urban,Age not stated,Total,186072,183921,369993
2523,29,State - KARNATAKA,Total,All ages,Total,30966657,30128640,61095297
2524,29,State - KARNATAKA,Total,0-6,Total,3675291,3485742,7161033
2525,29,State - KARNATAKA,Total,7,Total,523831,495216,1019047
2526,29,State - KARNATAKA,Total,8,Total,540621,514496,1055117
2527,29,State - KARNATAKA,Total,9,Total,538951,514080,1053031
2528,29,State - KARNATAKA,Total,10,Total,629780,594271,1224051
2529,29,State - KARNATAKA,Total,11,Total,575938,549764,1125702
2530,29,State - KARNATAKA,Total,12,Total,596025,563819,1159844
2531,29,State - KARNATAKA,Total,13,Total,562002,529402,1091404
2532,29,State - KARNATAKA,Total,14,Total,591542,544103,1135645
2533,29,State - KARNATAKA,Total,15,Total,602212,543040,1145252
2534,29,State - KARNATAKA,Total,16,Total,592938,536857,1129795
2535,29,State - KARNATAKA,Total,17,Total,551764,496514,1048278
2536,29,State - KARNATAKA,Total,18,Total,724617,656745,1381362
2537,29,State - KARNATAKA,Total,19,Total,570517,552073,1122590
2538,29,State - KARNATAKA,Total,20-24,Total,3109586,2942972,6052558
2539,29,State - KARNATAKA,Total,25-29,Total,2879254,2892352,5771606
2540,29,State - KARNATAKA,Total,30-34,Total,2389594,2308786,4698380
2541,29,State - KARNATAKA,Total,35-39,Total,2319088,2376363,4695451
2542,29,State - KARNATAKA,Total,40-44,Total,1977768,1848944,3826712
2543,29,State - KARNATAKA,Total,45-49,Total,1804833,1714949,3519782
2544,29,State - KARNATAKA,Total,50-54,Total,1381969,1317301,2699270
2545,29,State - KARNATAKA,Total,55-59,Total,1056054,1086450,2142504
2546,29,State - KARNATAKA,Total,60-64,Total,994630,1065422,2060052
2547,29,State - KARNATAKA,Total,65-69,Total,723687,796432,1520119
2548,29,State - KARNATAKA,Total,70-74,Total,510419,550706,1061125
2549,29,State - KARNATAKA,Total,75-79,Total,249834,274592,524426
2550,29,State - KARNATAKA,Total,80+,Total,268502,356808,625310
2551,29,State - KARNATAKA,Total,Age not stated,Total,25410,20441,45851
2552,29,State - KARNATAKA,Rural,All ages,Total,18929354,18539981,37469335
2553,29,State - KARNATAKA,Rural,0-6,Total,2317069,2200576,4517645
2554,29,State - KARNATAKA,Rural,7,Total,324548,306820,631368
2555,29,State - KARNATAKA,Rural,8,Total,341778,326195,667973
2556,29,State - KARNATAKA,Rural,9,Total,343118,329010,672128
2557,29,State - KARNATAKA,Rural,10,Total,398223,378161,776384
2558,29,State - KARNATAKA,Rural,11,Total,363973,346695,710668
2559,29,State - KARNATAKA,Rural,12,Total,382923,361575,744498
2560,29,State - KARNATAKA,Rural,13,Total,359889,336785,696674
2561,29,State - KARNATAKA,Rural,14,Total,384717,349534,734251
2562,29,State - KARNATAKA,Rural,15,Total,392971,348411,741382
2563,29,State - KARNATAKA,Rural,16,Total,384180,340598,724778
2564,29,State - KARNATAKA,Rural,17,Total,346121,300432,646553
2565,29,State - KARNATAKA,Rural,18,Total,467781,409110,876891
2566,29,State - KARNATAKA,Rural,19,Total,342756,325904,668660
2567,29,State - KARNATAKA,Rural,20-24,Total,1849584,1699841,3549425
2568,29,State - KARNATAKA,Rural,25-29,Total,1645487,1638021,3283508
2569,29,State - KARNATAKA,Rural,30-34,Total,1332397,1325352,2657749
2570,29,State - KARNATAKA,Rural,35-39,Total,1337639,1433319,2770958
2571,29,State - KARNATAKA,Rural,40-44,Total,1183334,1137021,2320355
2572,29,State - KARNATAKA,Rural,45-49,Total,1103911,1061765,2165676
2573,29,State - KARNATAKA,Rural,50-54,Total,844160,821296,1665456
2574,29,State - KARNATAKA,Rural,55-59,Total,636709,686748,1323457
2575,29,State - KARNATAKA,Rural,60-64,Total,642294,709961,1352255
2576,29,State - KARNATAKA,Rural,65-69,Total,491844,547638,1039482
2577,29,State - KARNATAKA,Rural,70-74,Total,352315,383994,736309
2578,29,State - KARNATAKA,Rural,75-79,Total,166285,183775,350060
2579,29,State - KARNATAKA,Rural,80+,Total,179395,239568,418963
2580,29,State - KARNATAKA,Rural,Age not stated,Total,13953,11876,25829
2581,29,State - KARNATAKA,Urban,All ages,Total,12037303,11588659,23625962
2582,29,State - KARNATAKA,Urban,0-6,Total,1358222,1285166,2643388
2583,29,State - KARNATAKA,Urban,7,Total,199283,188396,387679
2584,29,State - KARNATAKA,Urban,8,Total,198843,188301,387144
2585,29,State - KARNATAKA,Urban,9,Total,195833,185070,380903
2586,29,State - KARNATAKA,Urban,10,Total,231557,216110,447667
2587,29,State - KARNATAKA,Urban,11,Total,211965,203069,415034
2588,29,State - KARNATAKA,Urban,12,Total,213102,202244,415346
2589,29,State - KARNATAKA,Urban,13,Total,202113,192617,394730
2590,29,State - KARNATAKA,Urban,14,Total,206825,194569,401394
2591,29,State - KARNATAKA,Urban,15,Total,209241,194629,403870
2592,29,State - KARNATAKA,Urban,16,Total,208758,196259,405017
2593,29,State - KARNATAKA,Urban,17,Total,205643,196082,401725
2594,29,State - KARNATAKA,Urban,18,Total,256836,247635,504471
2595,29,State - KARNATAKA,Urban,19,Total,227761,226169,453930
2596,29,State - KARNATAKA,Urban,20-24,Total,1260002,1243131,2503133
2597,29,State - KARNATAKA,Urban,25-29,Total,1233767,1254331,2488098
2598,29,State - KARNATAKA,Urban,30-34,Total,1057197,983434,2040631
2599,29,State - KARNATAKA,Urban,35-39,Total,981449,943044,1924493
2600,29,State - KARNATAKA,Urban,40-44,Total,794434,711923,1506357
2601,29,State - KARNATAKA,Urban,45-49,Total,700922,653184,1354106
2602,29,State - KARNATAKA,Urban,50-54,Total,537809,496005,1033814
2603,29,State - KARNATAKA,Urban,55-59,Total,419345,399702,819047
2604,29,State - KARNATAKA,Urban,60-64,Total,352336,355461,707797
2605,29,State - KARNATAKA,Urban,65-69,Total,231843,248794,480637
2606,29,State - KARNATAKA,Urban,70-74,Total,158104,166712,324816
2607,29,State - KARNATAKA,Urban,75-79,Total,83549,90817,174366
2608,29,State - KARNATAKA,Urban,80+,Total,89107,117240,206347
2609,29,State - KARNATAKA,Urban,Age not stated,Total,11457,8565,20022
2610,30,State - GOA,Total,All ages,Total,739140,719405,1458545
2611,30,State - GOA,Total,0-6,Total,74460,70151,144611
2612,30,State - GOA,Total,7,Total,11068,10297,21365
2613,30,State - GOA,Total,8,Total,10515,9746,20261
2614,30,State - GOA,Total,9,Total,10646,10288,20934
2615,30,State - GOA,Total,10,Total,12265,11499,23764
2616,30,State - GOA,Total,11,Total,11821,11000,22821
2617,30,State - GOA,Total,12,Total,11171,10163,21334
2618,30,State - GOA,Total,13,Total,11002,10456,21458
2619,30,State - GOA,Total,14,Total,11158,10454,21612
2620,30,State - GOA,Total,15,Total,11343,10516,21859
2621,30,State - GOA,Total,16,Total,11005,10036,21041
2622,30,State - GOA,Total,17,Total,10844,10193,21037
2623,30,State - GOA,Total,18,Total,13363,11513,24876
2624,30,State - GOA,Total,19,Total,13520,11542,25062
2625,30,State - GOA,Total,20-24,Total,70616,60129,130745
2626,30,State - GOA,Total,25-29,Total,67744,64882,132626
2627,30,State - GOA,Total,30-34,Total,63471,62388,125859
2628,30,State - GOA,Total,35-39,Total,63541,62757,126298
2629,30,State - GOA,Total,40-44,Total,55504,53008,108512
2630,30,State - GOA,Total,45-49,Total,47867,46869,94736
2631,30,State - GOA,Total,50-54,Total,38782,37810,76592
2632,30,State - GOA,Total,55-59,Total,32021,33532,65553
2633,30,State - GOA,Total,60-64,Total,29100,32004,61104
2634,30,State - GOA,Total,65-69,Total,19005,22014,41019
2635,30,State - GOA,Total,70-74,Total,12890,16165,29055
2636,30,State - GOA,Total,75-79,Total,7228,9308,16536
2637,30,State - GOA,Total,80+,Total,6092,9689,15781
2638,30,State - GOA,Total,Age not stated,Total,1098,996,2094
2639,30,State - GOA,Rural,All ages,Total,275436,276295,551731
2640,30,State - GOA,Rural,0-6,Total,27772,26242,54014
2641,30,State - GOA,Rural,7,Total,4093,3853,7946
2642,30,State - GOA,Rural,8,Total,3821,3647,7468
2643,30,State - GOA,Rural,9,Total,3911,3864,7775
2644,30,State - GOA,Rural,10,Total,4509,4425,8934
2645,30,State - GOA,Rural,11,Total,4289,4215,8504
2646,30,State - GOA,Rural,12,Total,4146,3786,7932
2647,30,State - GOA,Rural,13,Total,4167,3924,8091
2648,30,State - GOA,Rural,14,Total,4193,4012,8205
2649,30,State - GOA,Rural,15,Total,4133,3990,8123
2650,30,State - GOA,Rural,16,Total,4129,3783,7912
2651,30,State - GOA,Rural,17,Total,4145,3913,8058
2652,30,State - GOA,Rural,18,Total,4815,4301,9116
2653,30,State - GOA,Rural,19,Total,4778,4384,9162
2654,30,State - GOA,Rural,20-24,Total,24590,22700,47290
2655,30,State - GOA,Rural,25-29,Total,25250,24667,49917
2656,30,State - GOA,Rural,30-34,Total,24210,24054,48264
2657,30,State - GOA,Rural,35-39,Total,24268,24118,48386
2658,30,State - GOA,Rural,40-44,Total,20562,19820,40382
2659,30,State - GOA,Rural,45-49,Total,17794,17813,35607
2660,30,State - GOA,Rural,50-54,Total,14247,14609,28856
2661,30,State - GOA,Rural,55-59,Total,12044,13040,25084
2662,30,State - GOA,Rural,60-64,Total,11280,13016,24296
2663,30,State - GOA,Rural,65-69,Total,7627,9263,16890
2664,30,State - GOA,Rural,70-74,Total,5024,6809,11833
2665,30,State - GOA,Rural,75-79,Total,2742,3694,6436
2666,30,State - GOA,Rural,80+,Total,2413,3919,6332
2667,30,State - GOA,Rural,Age not stated,Total,484,434,918
2668,30,State - GOA,Urban,All ages,Total,463704,443110,906814
2669,30,State - GOA,Urban,0-6,Total,46688,43909,90597
2670,30,State - GOA,Urban,7,Total,6975,6444,13419
2671,30,State - GOA,Urban,8,Total,6694,6099,12793
2672,30,State - GOA,Urban,9,Total,6735,6424,13159
2673,30,State - GOA,Urban,10,Total,7756,7074,14830
2674,30,State - GOA,Urban,11,Total,7532,6785,14317
2675,30,State - GOA,Urban,12,Total,7025,6377,13402
2676,30,State - GOA,Urban,13,Total,6835,6532,13367
2677,30,State - GOA,Urban,14,Total,6965,6442,13407
2678,30,State - GOA,Urban,15,Total,7210,6526,13736
2679,30,State - GOA,Urban,16,Total,6876,6253,13129
2680,30,State - GOA,Urban,17,Total,6699,6280,12979
2681,30,State - GOA,Urban,18,Total,8548,7212,15760
2682,30,State - GOA,Urban,19,Total,8742,7158,15900
2683,30,State - GOA,Urban,20-24,Total,46026,37429,83455
2684,30,State - GOA,Urban,25-29,Total,42494,40215,82709
2685,30,State - GOA,Urban,30-34,Total,39261,38334,77595
2686,30,State - GOA,Urban,35-39,Total,39273,38639,77912
2687,30,State - GOA,Urban,40-44,Total,34942,33188,68130
2688,30,State - GOA,Urban,45-49,Total,30073,29056,59129
2689,30,State - GOA,Urban,50-54,Total,24535,23201,47736
2690,30,State - GOA,Urban,55-59,Total,19977,20492,40469
2691,30,State - GOA,Urban,60-64,Total,17820,18988,36808
2692,30,State - GOA,Urban,65-69,Total,11378,12751,24129
2693,30,State - GOA,Urban,70-74,Total,7866,9356,17222
2694,30,State - GOA,Urban,75-79,Total,4486,5614,10100
2695,30,State - GOA,Urban,80+,Total,3679,5770,9449
2696,30,State - GOA,Urban,Age not stated,Total,614,562,1176
2697,31,State - LAKSHADWEEP,Total,All ages,Total,33123,31350,64473
2698,31,State - LAKSHADWEEP,Total,0-6,Total,3797,3458,7255
2699,31,State - LAKSHADWEEP,Total,7,Total,566,545,1111
2700,31,State - LAKSHADWEEP,Total,8,Total,450,455,905
2701,31,State - LAKSHADWEEP,Total,9,Total,595,593,1188
2702,31,State - LAKSHADWEEP,Total,10,Total,641,678,1319
2703,31,State - LAKSHADWEEP,Total,11,Total,606,643,1249
2704,31,State - LAKSHADWEEP,Total,12,Total,537,624,1161
2705,31,State - LAKSHADWEEP,Total,13,Total,519,631,1150
2706,31,State - LAKSHADWEEP,Total,14,Total,551,568,1119
2707,31,State - LAKSHADWEEP,Total,15,Total,586,573,1159
2708,31,State - LAKSHADWEEP,Total,16,Total,530,603,1133
2709,31,State - LAKSHADWEEP,Total,17,Total,564,588,1152
2710,31,State - LAKSHADWEEP,Total,18,Total,579,561,1140
2711,31,State - LAKSHADWEEP,Total,19,Total,549,491,1040
2712,31,State - LAKSHADWEEP,Total,20-24,Total,3071,2758,5829
2713,31,State - LAKSHADWEEP,Total,25-29,Total,3135,2832,5967
2714,31,State - LAKSHADWEEP,Total,30-34,Total,2777,2660,5437
2715,31,State - LAKSHADWEEP,Total,35-39,Total,2756,2633,5389
2716,31,State - LAKSHADWEEP,Total,40-44,Total,2453,2155,4608
2717,31,State - LAKSHADWEEP,Total,45-49,Total,1975,1835,3810
2718,31,State - LAKSHADWEEP,Total,50-54,Total,1625,1441,3066
2719,31,State - LAKSHADWEEP,Total,55-59,Total,1513,1388,2901
2720,31,State - LAKSHADWEEP,Total,60-64,Total,1046,988,2034
2721,31,State - LAKSHADWEEP,Total,65-69,Total,753,660,1413
2722,31,State - LAKSHADWEEP,Total,70-74,Total,410,439,849
2723,31,State - LAKSHADWEEP,Total,75-79,Total,244,249,493
2724,31,State - LAKSHADWEEP,Total,80+,Total,221,260,481
2725,31,State - LAKSHADWEEP,Total,Age not stated,Total,74,41,115
2726,31,State - LAKSHADWEEP,Rural,All ages,Total,7243,6898,14141
2727,31,State - LAKSHADWEEP,Rural,0-6,Total,950,865,1815
2728,31,State - LAKSHADWEEP,Rural,7,Total,136,136,272
2729,31,State - LAKSHADWEEP,Rural,8,Total,114,123,237
2730,31,State - LAKSHADWEEP,Rural,9,Total,158,137,295
2731,31,State - LAKSHADWEEP,Rural,10,Total,154,158,312
2732,31,State - LAKSHADWEEP,Rural,11,Total,151,168,319
2733,31,State - LAKSHADWEEP,Rural,12,Total,119,137,256
2734,31,State - LAKSHADWEEP,Rural,13,Total,98,164,262
2735,31,State - LAKSHADWEEP,Rural,14,Total,90,150,240
2736,31,State - LAKSHADWEEP,Rural,15,Total,111,124,235
2737,31,State - LAKSHADWEEP,Rural,16,Total,81,136,217
2738,31,State - LAKSHADWEEP,Rural,17,Total,109,122,231
2739,31,State - LAKSHADWEEP,Rural,18,Total,117,130,247
2740,31,State - LAKSHADWEEP,Rural,19,Total,107,110,217
2741,31,State - LAKSHADWEEP,Rural,20-24,Total,680,600,1280
2742,31,State - LAKSHADWEEP,Rural,25-29,Total,682,623,1305
2743,31,State - LAKSHADWEEP,Rural,30-34,Total,642,593,1235
2744,31,State - LAKSHADWEEP,Rural,35-39,Total,590,526,1116
2745,31,State - LAKSHADWEEP,Rural,40-44,Total,478,438,916
2746,31,State - LAKSHADWEEP,Rural,45-49,Total,405,357,762
2747,31,State - LAKSHADWEEP,Rural,50-54,Total,368,301,669
2748,31,State - LAKSHADWEEP,Rural,55-59,Total,298,279,577
2749,31,State - LAKSHADWEEP,Rural,60-64,Total,227,198,425
2750,31,State - LAKSHADWEEP,Rural,65-69,Total,175,144,319
2751,31,State - LAKSHADWEEP,Rural,70-74,Total,75,95,170
2752,31,State - LAKSHADWEEP,Rural,75-79,Total,53,42,95
2753,31,State - LAKSHADWEEP,Rural,80+,Total,55,35,90
2754,31,State - LAKSHADWEEP,Rural,Age not stated,Total,20,7,27
2755,31,State - LAKSHADWEEP,Urban,All ages,Total,25880,24452,50332
2756,31,State - LAKSHADWEEP,Urban,0-6,Total,2847,2593,5440
2757,31,State - LAKSHADWEEP,Urban,7,Total,430,409,839
2758,31,State - LAKSHADWEEP,Urban,8,Total,336,332,668
2759,31,State - LAKSHADWEEP,Urban,9,Total,437,456,893
2760,31,State - LAKSHADWEEP,Urban,10,Total,487,520,1007
2761,31,State - LAKSHADWEEP,Urban,11,Total,455,475,930
2762,31,State - LAKSHADWEEP,Urban,12,Total,418,487,905
2763,31,State - LAKSHADWEEP,Urban,13,Total,421,467,888
2764,31,State - LAKSHADWEEP,Urban,14,Total,461,418,879
2765,31,State - LAKSHADWEEP,Urban,15,Total,475,449,924
2766,31,State - LAKSHADWEEP,Urban,16,Total,449,467,916
2767,31,State - LAKSHADWEEP,Urban,17,Total,455,466,921
2768,31,State - LAKSHADWEEP,Urban,18,Total,462,431,893
2769,31,State - LAKSHADWEEP,Urban,19,Total,442,381,823
2770,31,State - LAKSHADWEEP,Urban,20-24,Total,2391,2158,4549
2771,31,State - LAKSHADWEEP,Urban,25-29,Total,2453,2209,4662
2772,31,State - LAKSHADWEEP,Urban,30-34,Total,2135,2067,4202
2773,31,State - LAKSHADWEEP,Urban,35-39,Total,2166,2107,4273
2774,31,State - LAKSHADWEEP,Urban,40-44,Total,1975,1717,3692
2775,31,State - LAKSHADWEEP,Urban,45-49,Total,1570,1478,3048
2776,31,State - LAKSHADWEEP,Urban,50-54,Total,1257,1140,2397
2777,31,State - LAKSHADWEEP,Urban,55-59,Total,1215,1109,2324
2778,31,State - LAKSHADWEEP,Urban,60-64,Total,819,790,1609
2779,31,State - LAKSHADWEEP,Urban,65-69,Total,578,516,1094
2780,31,State - LAKSHADWEEP,Urban,70-74,Total,335,344,679
2781,31,State - LAKSHADWEEP,Urban,75-79,Total,191,207,398
2782,31,State - LAKSHADWEEP,Urban,80+,Total,166,225,391
2783,31,State - LAKSHADWEEP,Urban,Age not stated,Total,54,34,88
2784,32,State - KERALA,Total,All ages,Total,16027412,17378649,33406061
2785,32,State - KERALA,Total,0-6,Total,1768244,1704711,3472955
2786,32,State - KERALA,Total,7,Total,260663,249844,510507
2787,32,State - KERALA,Total,8,Total,257189,247863,505052
2788,32,State - KERALA,Total,9,Total,264628,255062,519690
2789,32,State - KERALA,Total,10,Total,296685,283995,580680
2790,32,State - KERALA,Total,11,Total,289140,278880,568020
2791,32,State - KERALA,Total,12,Total,276952,264832,541784
2792,32,State - KERALA,Total,13,Total,293478,285228,578706
2793,32,State - KERALA,Total,14,Total,282662,270918,553580
2794,32,State - KERALA,Total,15,Total,276123,265577,541700
2795,32,State - KERALA,Total,16,Total,261654,253505,515159
2796,32,State - KERALA,Total,17,Total,263097,254228,517325
2797,32,State - KERALA,Total,18,Total,269522,258075,527597
2798,32,State - KERALA,Total,19,Total,257903,250868,508771
2799,32,State - KERALA,Total,20-24,Total,1298826,1366983,2665809
2800,32,State - KERALA,Total,25-29,Total,1203978,1400114,2604092
2801,32,State - KERALA,Total,30-34,Total,1128217,1327284,2455501
2802,32,State - KERALA,Total,35-39,Total,1161819,1417854,2579673
2803,32,State - KERALA,Total,40-44,Total,1117424,1295074,2412498
2804,32,State - KERALA,Total,45-49,Total,1105598,1242932,2348530
2805,32,State - KERALA,Total,50-54,Total,931191,996954,1928145
2806,32,State - KERALA,Total,55-59,Total,861527,880881,1742408
2807,32,State - KERALA,Total,60-64,Total,685136,729535,1414671
2808,32,State - KERALA,Total,65-69,Total,459232,542902,1002134
2809,32,State - KERALA,Total,70-74,Total,326562,406810,733372
2810,32,State - KERALA,Total,75-79,Total,208317,293050,501367
2811,32,State - KERALA,Total,80+,Total,204348,337501,541849
2812,32,State - KERALA,Total,Age not stated,Total,17297,17189,34486
2813,32,State - KERALA,Rural,All ages,Total,8408054,9063081,17471135
2814,32,State - KERALA,Rural,0-6,Total,927888,895776,1823664
2815,32,State - KERALA,Rural,7,Total,137381,132302,269683
2816,32,State - KERALA,Rural,8,Total,135648,130816,266464
2817,32,State - KERALA,Rural,9,Total,139969,134764,274733
2818,32,State - KERALA,Rural,10,Total,157549,151068,308617
2819,32,State - KERALA,Rural,11,Total,152852,147734,300586
2820,32,State - KERALA,Rural,12,Total,147699,141597,289296
2821,32,State - KERALA,Rural,13,Total,155230,151908,307138
2822,32,State - KERALA,Rural,14,Total,149567,144134,293701
2823,32,State - KERALA,Rural,15,Total,145596,140291,285887
2824,32,State - KERALA,Rural,16,Total,137616,133506,271122
2825,32,State - KERALA,Rural,17,Total,137316,132410,269726
2826,32,State - KERALA,Rural,18,Total,140996,133994,274990
2827,32,State - KERALA,Rural,19,Total,134680,129408,264088
2828,32,State - KERALA,Rural,20-24,Total,680283,705778,1386061
2829,32,State - KERALA,Rural,25-29,Total,639039,729997,1369036
2830,32,State - KERALA,Rural,30-34,Total,592974,685286,1278260
2831,32,State - KERALA,Rural,35-39,Total,608341,736288,1344629
2832,32,State - KERALA,Rural,40-44,Total,578217,667921,1246138
2833,32,State - KERALA,Rural,45-49,Total,578437,649445,1227882
2834,32,State - KERALA,Rural,50-54,Total,484917,516245,1001162
2835,32,State - KERALA,Rural,55-59,Total,446860,456523,903383
2836,32,State - KERALA,Rural,60-64,Total,351377,373570,724947
2837,32,State - KERALA,Rural,65-69,Total,240537,284728,525265
2838,32,State - KERALA,Rural,70-74,Total,170673,211313,381986
2839,32,State - KERALA,Rural,75-79,Total,111752,154915,266667
2840,32,State - KERALA,Rural,80+,Total,115981,182706,298687
2841,32,State - KERALA,Rural,Age not stated,Total,8679,8658,17337
2842,32,State - KERALA,Urban,All ages,Total,7619358,8315568,15934926
2843,32,State - KERALA,Urban,0-6,Total,840356,808935,1649291
2844,32,State - KERALA,Urban,7,Total,123282,117542,240824
2845,32,State - KERALA,Urban,8,Total,121541,117047,238588
2846,32,State - KERALA,Urban,9,Total,124659,120298,244957
2847,32,State - KERALA,Urban,10,Total,139136,132927,272063
2848,32,State - KERALA,Urban,11,Total,136288,131146,267434
2849,32,State - KERALA,Urban,12,Total,129253,123235,252488
2850,32,State - KERALA,Urban,13,Total,138248,133320,271568
2851,32,State - KERALA,Urban,14,Total,133095,126784,259879
2852,32,State - KERALA,Urban,15,Total,130527,125286,255813
2853,32,State - KERALA,Urban,16,Total,124038,119999,244037
2854,32,State - KERALA,Urban,17,Total,125781,121818,247599
2855,32,State - KERALA,Urban,18,Total,128526,124081,252607
2856,32,State - KERALA,Urban,19,Total,123223,121460,244683
2857,32,State - KERALA,Urban,20-24,Total,618543,661205,1279748
2858,32,State - KERALA,Urban,25-29,Total,564939,670117,1235056
2859,32,State - KERALA,Urban,30-34,Total,535243,641998,1177241
2860,32,State - KERALA,Urban,35-39,Total,553478,681566,1235044
2861,32,State - KERALA,Urban,40-44,Total,539207,627153,1166360
2862,32,State - KERALA,Urban,45-49,Total,527161,593487,1120648
2863,32,State - KERALA,Urban,50-54,Total,446274,480709,926983
2864,32,State - KERALA,Urban,55-59,Total,414667,424358,839025
2865,32,State - KERALA,Urban,60-64,Total,333759,355965,689724
2866,32,State - KERALA,Urban,65-69,Total,218695,258174,476869
2867,32,State - KERALA,Urban,70-74,Total,155889,195497,351386
2868,32,State - KERALA,Urban,75-79,Total,96565,138135,234700
2869,32,State - KERALA,Urban,80+,Total,88367,154795,243162
2870,32,State - KERALA,Urban,Age not stated,Total,8618,8531,17149
2871,33,State - TAMIL NADU,Total,All ages,Total,36137975,36009055,72147030
2872,33,State - TAMIL NADU,Total,0-6,Total,3820276,3603556,7423832
2873,33,State - TAMIL NADU,Total,7,Total,585055,554812,1139867
2874,33,State - TAMIL NADU,Total,8,Total,575557,551476,1127033
2875,33,State - TAMIL NADU,Total,9,Total,584983,554241,1139224
2876,33,State - TAMIL NADU,Total,10,Total,666692,624299,1290991
2877,33,State - TAMIL NADU,Total,11,Total,629072,588086,1217158
2878,33,State - TAMIL NADU,Total,12,Total,623211,584365,1207576
2879,33,State - TAMIL NADU,Total,13,Total,635251,601385,1236636
2880,33,State - TAMIL NADU,Total,14,Total,634764,590422,1225186
2881,33,State - TAMIL NADU,Total,15,Total,664183,615611,1279794
2882,33,State - TAMIL NADU,Total,16,Total,610930,566844,1177774
2883,33,State - TAMIL NADU,Total,17,Total,623711,572969,1196680
2884,33,State - TAMIL NADU,Total,18,Total,683260,642072,1325332
2885,33,State - TAMIL NADU,Total,19,Total,647754,626458,1274212
2886,33,State - TAMIL NADU,Total,20-24,Total,3154804,3256739,6411543
2887,33,State - TAMIL NADU,Total,25-29,Total,3237374,3426372,6663746
2888,33,State - TAMIL NADU,Total,30-34,Total,2908749,2906811,5815560
2889,33,State - TAMIL NADU,Total,35-39,Total,2815205,3021251,5836456
2890,33,State - TAMIL NADU,Total,40-44,Total,2549846,2514363,5064209
2891,33,State - TAMIL NADU,Total,45-49,Total,2374915,2338141,4713056
2892,33,State - TAMIL NADU,Total,50-54,Total,1875563,1827897,3703460
2893,33,State - TAMIL NADU,Total,55-59,Total,1540924,1560218,3101142
2894,33,State - TAMIL NADU,Total,60-64,Total,1378039,1404569,2782608
2895,33,State - TAMIL NADU,Total,65-69,Total,896412,971958,1868370
2896,33,State - TAMIL NADU,Total,70-74,Total,693167,713362,1406529
2897,33,State - TAMIL NADU,Total,75-79,Total,353746,356495,710241
2898,33,State - TAMIL NADU,Total,80+,Total,339862,402148,742010
2899,33,State - TAMIL NADU,Total,Age not stated,Total,34670,32135,66805
2900,33,State - TAMIL NADU,Rural,All ages,Total,18679065,18550525,37229590
2901,33,State - TAMIL NADU,Rural,0-6,Total,2020550,1890752,3911302
2902,33,State - TAMIL NADU,Rural,7,Total,315690,298429,614119
2903,33,State - TAMIL NADU,Rural,8,Total,312939,298331,611270
2904,33,State - TAMIL NADU,Rural,9,Total,316394,297330,613724
2905,33,State - TAMIL NADU,Rural,10,Total,359065,334127,693192
2906,33,State - TAMIL NADU,Rural,11,Total,336677,311955,648632
2907,33,State - TAMIL NADU,Rural,12,Total,341181,315128,656309
2908,33,State - TAMIL NADU,Rural,13,Total,344941,322518,667459
2909,33,State - TAMIL NADU,Rural,14,Total,344302,315266,659568
2910,33,State - TAMIL NADU,Rural,15,Total,364062,331287,695349
2911,33,State - TAMIL NADU,Rural,16,Total,333404,301539,634943
2912,33,State - TAMIL NADU,Rural,17,Total,341577,303289,644866
2913,33,State - TAMIL NADU,Rural,18,Total,376212,342640,718852
2914,33,State - TAMIL NADU,Rural,19,Total,349978,329110,679088
2915,33,State - TAMIL NADU,Rural,20-24,Total,1658770,1656464,3315234
2916,33,State - TAMIL NADU,Rural,25-29,Total,1652498,1708000,3360498
2917,33,State - TAMIL NADU,Rural,30-34,Total,1419512,1405706,2825218
2918,33,State - TAMIL NADU,Rural,35-39,Total,1375375,1519260,2894635
2919,33,State - TAMIL NADU,Rural,40-44,Total,1244055,1251772,2495827
2920,33,State - TAMIL NADU,Rural,45-49,Total,1187892,1195482,2383374
2921,33,State - TAMIL NADU,Rural,50-54,Total,926233,936410,1862643
2922,33,State - TAMIL NADU,Rural,55-59,Total,765352,813158,1578510
2923,33,State - TAMIL NADU,Rural,60-64,Total,726363,757736,1484099
2924,33,State - TAMIL NADU,Rural,65-69,Total,490698,532226,1022924
2925,33,State - TAMIL NADU,Rural,70-74,Total,384159,386460,770619
2926,33,State - TAMIL NADU,Rural,75-79,Total,187116,178675,365791
2927,33,State - TAMIL NADU,Rural,80+,Total,185450,200214,385664
2928,33,State - TAMIL NADU,Rural,Age not stated,Total,18620,17261,35881
2929,33,State - TAMIL NADU,Urban,All ages,Total,17458910,17458530,34917440
2930,33,State - TAMIL NADU,Urban,0-6,Total,1799726,1712804,3512530
2931,33,State - TAMIL NADU,Urban,7,Total,269365,256383,525748
2932,33,State - TAMIL NADU,Urban,8,Total,262618,253145,515763
2933,33,State - TAMIL NADU,Urban,9,Total,268589,256911,525500
2934,33,State - TAMIL NADU,Urban,10,Total,307627,290172,597799
2935,33,State - TAMIL NADU,Urban,11,Total,292395,276131,568526
2936,33,State - TAMIL NADU,Urban,12,Total,282030,269237,551267
2937,33,State - TAMIL NADU,Urban,13,Total,290310,278867,569177
2938,33,State - TAMIL NADU,Urban,14,Total,290462,275156,565618
2939,33,State - TAMIL NADU,Urban,15,Total,300121,284324,584445
2940,33,State - TAMIL NADU,Urban,16,Total,277526,265305,542831
2941,33,State - TAMIL NADU,Urban,17,Total,282134,269680,551814
2942,33,State - TAMIL NADU,Urban,18,Total,307048,299432,606480
2943,33,State - TAMIL NADU,Urban,19,Total,297776,297348,595124
2944,33,State - TAMIL NADU,Urban,20-24,Total,1496034,1600275,3096309
2945,33,State - TAMIL NADU,Urban,25-29,Total,1584876,1718372,3303248
2946,33,State - TAMIL NADU,Urban,30-34,Total,1489237,1501105,2990342
2947,33,State - TAMIL NADU,Urban,35-39,Total,1439830,1501991,2941821
2948,33,State - TAMIL NADU,Urban,40-44,Total,1305791,1262591,2568382
2949,33,State - TAMIL NADU,Urban,45-49,Total,1187023,1142659,2329682
2950,33,State - TAMIL NADU,Urban,50-54,Total,949330,891487,1840817
2951,33,State - TAMIL NADU,Urban,55-59,Total,775572,747060,1522632
2952,33,State - TAMIL NADU,Urban,60-64,Total,651676,646833,1298509
2953,33,State - TAMIL NADU,Urban,65-69,Total,405714,439732,845446
2954,33,State - TAMIL NADU,Urban,70-74,Total,309008,326902,635910
2955,33,State - TAMIL NADU,Urban,75-79,Total,166630,177820,344450
2956,33,State - TAMIL NADU,Urban,80+,Total,154412,201934,356346
2957,33,State - TAMIL NADU,Urban,Age not stated,Total,16050,14874,30924
2958,34,State - PUDUCHERRY,Total,All ages,Total,612511,635442,1247953
2959,34,State - PUDUCHERRY,Total,0-6,Total,67527,65331,132858
2960,34,State - PUDUCHERRY,Total,7,Total,10237,9887,20124
2961,34,State - PUDUCHERRY,Total,8,Total,9990,9571,19561
2962,34,State - PUDUCHERRY,Total,9,Total,10276,9847,20123
2963,34,State - PUDUCHERRY,Total,10,Total,11433,11035,22468
2964,34,State - PUDUCHERRY,Total,11,Total,11050,10590,21640
2965,34,State - PUDUCHERRY,Total,12,Total,10292,9943,20235
2966,34,State - PUDUCHERRY,Total,13,Total,10681,10155,20836
2967,34,State - PUDUCHERRY,Total,14,Total,10480,10067,20547
2968,34,State - PUDUCHERRY,Total,15,Total,10812,10130,20942
2969,34,State - PUDUCHERRY,Total,16,Total,9985,9454,19439
2970,34,State - PUDUCHERRY,Total,17,Total,10113,9415,19528
2971,34,State - PUDUCHERRY,Total,18,Total,10731,10536,21267
2972,34,State - PUDUCHERRY,Total,19,Total,10590,10550,21140
2973,34,State - PUDUCHERRY,Total,20-24,Total,51287,57532,108819
2974,34,State - PUDUCHERRY,Total,25-29,Total,55052,63192,118244
2975,34,State - PUDUCHERRY,Total,30-34,Total,53761,57309,111070
2976,34,State - PUDUCHERRY,Total,35-39,Total,52655,54804,107459
2977,34,State - PUDUCHERRY,Total,40-44,Total,45482,44297,89779
2978,34,State - PUDUCHERRY,Total,45-49,Total,40625,38680,79305
2979,34,State - PUDUCHERRY,Total,50-54,Total,30858,30065,60923
2980,34,State - PUDUCHERRY,Total,55-59,Total,24615,25494,50109
2981,34,State - PUDUCHERRY,Total,60-64,Total,20498,23330,43828
2982,34,State - PUDUCHERRY,Total,65-69,Total,12154,15829,27983
2983,34,State - PUDUCHERRY,Total,70-74,Total,9861,12660,22521
2984,34,State - PUDUCHERRY,Total,75-79,Total,5494,7295,12789
2985,34,State - PUDUCHERRY,Total,80+,Total,5412,7903,13315
2986,34,State - PUDUCHERRY,Total,Age not stated,Total,560,541,1101
2987,34,State - PUDUCHERRY,Rural,All ages,Total,194907,200293,395200
2988,34,State - PUDUCHERRY,Rural,0-6,Total,22798,21716,44514
2989,34,State - PUDUCHERRY,Rural,7,Total,3342,3361,6703
2990,34,State - PUDUCHERRY,Rural,8,Total,3348,3188,6536
2991,34,State - PUDUCHERRY,Rural,9,Total,3432,3309,6741
2992,34,State - PUDUCHERRY,Rural,10,Total,3743,3737,7480
2993,34,State - PUDUCHERRY,Rural,11,Total,3716,3535,7251
2994,34,State - PUDUCHERRY,Rural,12,Total,3446,3334,6780
2995,34,State - PUDUCHERRY,Rural,13,Total,3574,3468,7042
2996,34,State - PUDUCHERRY,Rural,14,Total,3493,3305,6798
2997,34,State - PUDUCHERRY,Rural,15,Total,3520,3411,6931
2998,34,State - PUDUCHERRY,Rural,16,Total,3277,3115,6392
2999,34,State - PUDUCHERRY,Rural,17,Total,3343,3036,6379
3000,34,State - PUDUCHERRY,Rural,18,Total,3623,3554,7177
3001,34,State - PUDUCHERRY,Rural,19,Total,3631,3509,7140
3002,34,State - PUDUCHERRY,Rural,20-24,Total,17155,19117,36272
3003,34,State - PUDUCHERRY,Rural,25-29,Total,18442,20398,38840
3004,34,State - PUDUCHERRY,Rural,30-34,Total,16868,17246,34114
3005,34,State - PUDUCHERRY,Rural,35-39,Total,16190,16756,32946
3006,34,State - PUDUCHERRY,Rural,40-44,Total,13362,12855,26217
3007,34,State - PUDUCHERRY,Rural,45-49,Total,12218,11610,23828
3008,34,State - PUDUCHERRY,Rural,50-54,Total,8814,8648,17462
3009,34,State - PUDUCHERRY,Rural,55-59,Total,7082,7629,14711
3010,34,State - PUDUCHERRY,Rural,60-64,Total,6025,7136,13161
3011,34,State - PUDUCHERRY,Rural,65-69,Total,3751,4982,8733
3012,34,State - PUDUCHERRY,Rural,70-74,Total,3104,3889,6993
3013,34,State - PUDUCHERRY,Rural,75-79,Total,1605,1999,3604
3014,34,State - PUDUCHERRY,Rural,80+,Total,1747,2210,3957
3015,34,State - PUDUCHERRY,Rural,Age not stated,Total,258,240,498
3016,34,State - PUDUCHERRY,Urban,All ages,Total,417604,435149,852753
3017,34,State - PUDUCHERRY,Urban,0-6,Total,44729,43615,88344
3018,34,State - PUDUCHERRY,Urban,7,Total,6895,6526,13421
3019,34,State - PUDUCHERRY,Urban,8,Total,6642,6383,13025
3020,34,State - PUDUCHERRY,Urban,9,Total,6844,6538,13382
3021,34,State - PUDUCHERRY,Urban,10,Total,7690,7298,14988
3022,34,State - PUDUCHERRY,Urban,11,Total,7334,7055,14389
3023,34,State - PUDUCHERRY,Urban,12,Total,6846,6609,13455
3024,34,State - PUDUCHERRY,Urban,13,Total,7107,6687,13794
3025,34,State - PUDUCHERRY,Urban,14,Total,6987,6762,13749
3026,34,State - PUDUCHERRY,Urban,15,Total,7292,6719,14011
3027,34,State - PUDUCHERRY,Urban,16,Total,6708,6339,13047
3028,34,State - PUDUCHERRY,Urban,17,Total,6770,6379,13149
3029,34,State - PUDUCHERRY,Urban,18,Total,7108,6982,14090
3030,34,State - PUDUCHERRY,Urban,19,Total,6959,7041,14000
3031,34,State - PUDUCHERRY,Urban,20-24,Total,34132,38415,72547
3032,34,State - PUDUCHERRY,Urban,25-29,Total,36610,42794,79404
3033,34,State - PUDUCHERRY,Urban,30-34,Total,36893,40063,76956
3034,34,State - PUDUCHERRY,Urban,35-39,Total,36465,38048,74513
3035,34,State - PUDUCHERRY,Urban,40-44,Total,32120,31442,63562
3036,34,State - PUDUCHERRY,Urban,45-49,Total,28407,27070,55477
3037,34,State - PUDUCHERRY,Urban,50-54,Total,22044,21417,43461
3038,34,State - PUDUCHERRY,Urban,55-59,Total,17533,17865,35398
3039,34,State - PUDUCHERRY,Urban,60-64,Total,14473,16194,30667
3040,34,State - PUDUCHERRY,Urban,65-69,Total,8403,10847,19250
3041,34,State - PUDUCHERRY,Urban,70-74,Total,6757,8771,15528
3042,34,State - PUDUCHERRY,Urban,75-79,Total,3889,5296,9185
3043,34,State - PUDUCHERRY,Urban,80+,Total,3665,5693,9358
3044,34,State - PUDUCHERRY,Urban,Age not stated,Total,302,301,603
3045,35,State - ANDAMAN & NICOBAR ISLANDS,Total,All ages,Total,202871,177710,380581
3046,35,State - ANDAMAN & NICOBAR ISLANDS,Total,0-6,Total,20770,20108,40878
3047,35,State - ANDAMAN & NICOBAR ISLANDS,Total,7,Total,3208,3010,6218
3048,35,State - ANDAMAN & NICOBAR ISLANDS,Total,8,Total,3072,2868,5940
3049,35,State - ANDAMAN & NICOBAR ISLANDS,Total,9,Total,3103,3069,6172
3050,35,State - ANDAMAN & NICOBAR ISLANDS,Total,10,Total,3608,3443,7051
3051,35,State - ANDAMAN & NICOBAR ISLANDS,Total,11,Total,3506,3423,6929
3052,35,State - ANDAMAN & NICOBAR ISLANDS,Total,12,Total,3261,3213,6474
3053,35,State - ANDAMAN & NICOBAR ISLANDS,Total,13,Total,3367,3130,6497
3054,35,State - ANDAMAN & NICOBAR ISLANDS,Total,14,Total,3376,3140,6516
3055,35,State - ANDAMAN & NICOBAR ISLANDS,Total,15,Total,3480,3248,6728
3056,35,State - ANDAMAN & NICOBAR ISLANDS,Total,16,Total,3397,3102,6499
3057,35,State - ANDAMAN & NICOBAR ISLANDS,Total,17,Total,3400,3007,6407
3058,35,State - ANDAMAN & NICOBAR ISLANDS,Total,18,Total,3587,3283,6870
3059,35,State - ANDAMAN & NICOBAR ISLANDS,Total,19,Total,3402,3120,6522
3060,35,State - ANDAMAN & NICOBAR ISLANDS,Total,20-24,Total,19528,17587,37115
3061,35,State - ANDAMAN & NICOBAR ISLANDS,Total,25-29,Total,22230,19492,41722
3062,35,State - ANDAMAN & NICOBAR ISLANDS,Total,30-34,Total,19359,16364,35723
3063,35,State - ANDAMAN & NICOBAR ISLANDS,Total,35-39,Total,17170,15672,32842
3064,35,State - ANDAMAN & NICOBAR ISLANDS,Total,40-44,Total,14813,11922,26735
3065,35,State - ANDAMAN & NICOBAR ISLANDS,Total,45-49,Total,13270,10591,23861
3066,35,State - ANDAMAN & NICOBAR ISLANDS,Total,50-54,Total,9710,7586,17296
3067,35,State - ANDAMAN & NICOBAR ISLANDS,Total,55-59,Total,7870,5924,13794
3068,35,State - ANDAMAN & NICOBAR ISLANDS,Total,60-64,Total,5807,4569,10376
3069,35,State - ANDAMAN & NICOBAR ISLANDS,Total,65-69,Total,3430,2796,6226
3070,35,State - ANDAMAN & NICOBAR ISLANDS,Total,70-74,Total,2378,1720,4098
3071,35,State - ANDAMAN & NICOBAR ISLANDS,Total,75-79,Total,1295,956,2251
3072,35,State - ANDAMAN & NICOBAR ISLANDS,Total,80+,Total,1279,1194,2473
3073,35,State - ANDAMAN & NICOBAR ISLANDS,Total,Age not stated,Total,195,173,368
3074,35,State - ANDAMAN & NICOBAR ISLANDS,Rural,All ages,Total,126287,110806,237093
3075,35,State - ANDAMAN & NICOBAR ISLANDS,Rural,0-6,Total,13370,13045,26415
3076,35,State - ANDAMAN & NICOBAR ISLANDS,Rural,7,Total,2061,1858,3919
3077,35,State - ANDAMAN & NICOBAR ISLANDS,Rural,8,Total,1938,1785,3723
3078,35,State - ANDAMAN & NICOBAR ISLANDS,Rural,9,Total,1949,1934,3883
3079,35,State - ANDAMAN & NICOBAR ISLANDS,Rural,10,Total,2271,2165,4436
3080,35,State - ANDAMAN & NICOBAR ISLANDS,Rural,11,Total,2164,2210,4374
3081,35,State - ANDAMAN & NICOBAR ISLANDS,Rural,12,Total,2034,2062,4096
3082,35,State - ANDAMAN & NICOBAR ISLANDS,Rural,13,Total,2115,2056,4171
3083,35,State - ANDAMAN & NICOBAR ISLANDS,Rural,14,Total,2147,2002,4149
3084,35,State - ANDAMAN & NICOBAR ISLANDS,Rural,15,Total,2176,1993,4169
3085,35,State - ANDAMAN & NICOBAR ISLANDS,Rural,16,Total,2105,1905,4010
3086,35,State - ANDAMAN & NICOBAR ISLANDS,Rural,17,Total,2074,1855,3929
3087,35,State - ANDAMAN & NICOBAR ISLANDS,Rural,18,Total,2228,2054,4282
3088,35,State - ANDAMAN & NICOBAR ISLANDS,Rural,19,Total,2061,1918,3979
3089,35,State - ANDAMAN & NICOBAR ISLANDS,Rural,20-24,Total,11654,10886,22540
3090,35,State - ANDAMAN & NICOBAR ISLANDS,Rural,25-29,Total,13675,11883,25558
3091,35,State - ANDAMAN & NICOBAR ISLANDS,Rural,30-34,Total,11945,9866,21811
3092,35,State - ANDAMAN & NICOBAR ISLANDS,Rural,35-39,Total,10424,9378,19802
3093,35,State - ANDAMAN & NICOBAR ISLANDS,Rural,40-44,Total,8921,7038,15959
3094,35,State - ANDAMAN & NICOBAR ISLANDS,Rural,45-49,Total,7991,6441,14432
3095,35,State - ANDAMAN & NICOBAR ISLANDS,Rural,50-54,Total,5987,4688,10675
3096,35,State - ANDAMAN & NICOBAR ISLANDS,Rural,55-59,Total,4889,3773,8662
3097,35,State - ANDAMAN & NICOBAR ISLANDS,Rural,60-64,Total,3899,3203,7102
3098,35,State - ANDAMAN & NICOBAR ISLANDS,Rural,65-69,Total,2477,1992,4469
3099,35,State - ANDAMAN & NICOBAR ISLANDS,Rural,70-74,Total,1687,1218,2905
3100,35,State - ANDAMAN & NICOBAR ISLANDS,Rural,75-79,Total,952,654,1606
3101,35,State - ANDAMAN & NICOBAR ISLANDS,Rural,80+,Total,992,865,1857
3102,35,State - ANDAMAN & NICOBAR ISLANDS,Rural,Age not stated,Total,101,79,180
3103,35,State - ANDAMAN & NICOBAR ISLANDS,Urban,All ages,Total,76584,66904,143488
3104,35,State - ANDAMAN & NICOBAR ISLANDS,Urban,0-6,Total,7400,7063,14463
3105,35,State - ANDAMAN & NICOBAR ISLANDS,Urban,7,Total,1147,1152,2299
3106,35,State - ANDAMAN & NICOBAR ISLANDS,Urban,8,Total,1134,1083,2217
3107,35,State - ANDAMAN & NICOBAR ISLANDS,Urban,9,Total,1154,1135,2289
3108,35,State - ANDAMAN & NICOBAR ISLANDS,Urban,10,Total,1337,1278,2615
3109,35,State - ANDAMAN & NICOBAR ISLANDS,Urban,11,Total,1342,1213,2555
3110,35,State - ANDAMAN & NICOBAR ISLANDS,Urban,12,Total,1227,1151,2378
3111,35,State - ANDAMAN & NICOBAR ISLANDS,Urban,13,Total,1252,1074,2326
3112,35,State - ANDAMAN & NICOBAR ISLANDS,Urban,14,Total,1229,1138,2367
3113,35,State - ANDAMAN & NICOBAR ISLANDS,Urban,15,Total,1304,1255,2559
3114,35,State - ANDAMAN & NICOBAR ISLANDS,Urban,16,Total,1292,1197,2489
3115,35,State - ANDAMAN & NICOBAR ISLANDS,Urban,17,Total,1326,1152,2478
3116,35,State - ANDAMAN & NICOBAR ISLANDS,Urban,18,Total,1359,1229,2588
3117,35,State - ANDAMAN & NICOBAR ISLANDS,Urban,19,Total,1341,1202,2543
3118,35,State - ANDAMAN & NICOBAR ISLANDS,Urban,20-24,Total,7874,6701,14575
3119,35,State - ANDAMAN & NICOBAR ISLANDS,Urban,25-29,Total,8555,7609,16164
3120,35,State - ANDAMAN & NICOBAR ISLANDS,Urban,30-34,Total,7414,6498,13912
3121,35,State - ANDAMAN & NICOBAR ISLANDS,Urban,35-39,Total,6746,6294,13040
3122,35,State - ANDAMAN & NICOBAR ISLANDS,Urban,40-44,Total,5892,4884,10776
3123,35,State - ANDAMAN & NICOBAR ISLANDS,Urban,45-49,Total,5279,4150,9429
3124,35,State - ANDAMAN & NICOBAR ISLANDS,Urban,50-54,Total,3723,2898,6621
3125,35,State - ANDAMAN & NICOBAR ISLANDS,Urban,55-59,Total,2981,2151,5132
3126,35,State - ANDAMAN & NICOBAR ISLANDS,Urban,60-64,Total,1908,1366,3274
3127,35,State - ANDAMAN & NICOBAR ISLANDS,Urban,65-69,Total,953,804,1757
3128,35,State - ANDAMAN & NICOBAR ISLANDS,Urban,70-74,Total,691,502,1193
3129,35,State - ANDAMAN & NICOBAR ISLANDS,Urban,75-79,Total,343,302,645
3130,35,State - ANDAMAN & NICOBAR ISLANDS,Urban,80+,Total,287,329,616
3131,35,State - ANDAMAN & NICOBAR ISLANDS,Urban,Age not stated,Total,94,94,188
3132,0,INDIA,Total,All ages,Illiterate,188506636,258709529,447216165
3133,0,INDIA,Total,0-6,Illiterate,85752254,78762999,164515253
3134,0,INDIA,Total,7,Illiterate,3388683,3359531,6748214
3135,0,INDIA,Total,8,Illiterate,2013742,2117672,4131414
3136,0,INDIA,Total,9,Illiterate,1198339,1293565,2491904
3137,0,INDIA,Total,10,Illiterate,1661124,1793381,3454505
3138,0,INDIA,Total,11,Illiterate,929328,1059145,1988473
3139,0,INDIA,Total,12,Illiterate,1087320,1304209,2391529
3140,0,INDIA,Total,13,Illiterate,790923,1019553,1810476
3141,0,INDIA,Total,14,Illiterate,920460,1180325,2100785
3142,0,INDIA,Total,15,Illiterate,1176626,1423331,2599957
3143,0,INDIA,Total,16,Illiterate,1110878,1401609,2512487
3144,0,INDIA,Total,17,Illiterate,880041,1158414,2038455
3145,0,INDIA,Total,18,Illiterate,1532188,2195787,3727975
3146,0,INDIA,Total,19,Illiterate,935454,1643220,2578674
3147,0,INDIA,Total,20-24,Illiterate,6467026,12212466,18679492
3148,0,INDIA,Total,25-29,Illiterate,7562339,15072101,22634440
3149,0,INDIA,Total,30-34,Illiterate,8030750,16298810,24329560
3150,0,INDIA,Total,35-39,Illiterate,9338968,18524159,27863127
3151,0,INDIA,Total,40-44,Illiterate,9655032,17151840,26806872
3152,0,INDIA,Total,45-49,Illiterate,9015516,16062247,25077763
3153,0,INDIA,Total,50-54,Illiterate,7801013,13021195,20822208
3154,0,INDIA,Total,55-59,Illiterate,5705728,11976353,17682081
3155,0,INDIA,Total,60-64,Illiterate,7024725,12964714,19989439
3156,0,INDIA,Total,65-69,Illiterate,5145133,9684474,14829607
3157,0,INDIA,Total,70-74,Illiterate,4369752,7198872,11568624
3158,0,INDIA,Total,75-79,Illiterate,1890685,3470507,5361192
3159,0,INDIA,Total,80+,Illiterate,2456492,4433955,6890447
3160,0,INDIA,Total,Age not stated,Illiterate,666117,925095,1591212
3161,0,INDIA,Rural,All ages,Illiterate,146419684,204535333,350955017
3162,0,INDIA,Rural,0-6,Illiterate,63084449,58238416,121322865
3163,0,INDIA,Rural,7,Illiterate,2642438,2652818,5295256
3164,0,INDIA,Rural,8,Illiterate,1613098,1726252,3339350
3165,0,INDIA,Rural,9,Illiterate,932962,1034038,1967000
3166,0,INDIA,Rural,10,Illiterate,1299553,1445468,2745021
3167,0,INDIA,Rural,11,Illiterate,710896,842741,1553637
3168,0,INDIA,Rural,12,Illiterate,847445,1067023,1914468
3169,0,INDIA,Rural,13,Illiterate,604308,822354,1426662
3170,0,INDIA,Rural,14,Illiterate,704596,953256,1657852
3171,0,INDIA,Rural,15,Illiterate,915000,1159111,2074111
3172,0,INDIA,Rural,16,Illiterate,854089,1139537,1993626
3173,0,INDIA,Rural,17,Illiterate,654330,929697,1584027
3174,0,INDIA,Rural,18,Illiterate,1166342,1817804,2984146
3175,0,INDIA,Rural,19,Illiterate,691050,1350082,2041132
3176,0,INDIA,Rural,20-24,Illiterate,4963696,10113829,15077525
3177,0,INDIA,Rural,25-29,Illiterate,5987783,12453366,18441149
3178,0,INDIA,Rural,30-34,Illiterate,6464972,13478048,19943020
3179,0,INDIA,Rural,35-39,Illiterate,7558902,15121108,22680010
3180,0,INDIA,Rural,40-44,Illiterate,7868267,13921319,21789586
3181,0,INDIA,Rural,45-49,Illiterate,7370966,12940097,20311063
3182,0,INDIA,Rural,50-54,Illiterate,6445133,10462697,16907830
3183,0,INDIA,Rural,55-59,Illiterate,4739716,9746203,14485919
3184,0,INDIA,Rural,60-64,Illiterate,5952423,10565428,16517851
3185,0,INDIA,Rural,65-69,Illiterate,4418883,7913667,12332550
3186,0,INDIA,Rural,70-74,Illiterate,3758529,5784666,9543195
3187,0,INDIA,Rural,75-79,Illiterate,1609876,2743508,4353384
3188,0,INDIA,Rural,80+,Illiterate,2071534,3417606,5489140
3189,0,INDIA,Rural,Age not stated,Illiterate,488448,695194,1183642
3190,0,INDIA,Urban,All ages,Illiterate,42086952,54174196,96261148
3191,0,INDIA,Urban,0-6,Illiterate,22667805,20524583,43192388
3192,0,INDIA,Urban,7,Illiterate,746245,706713,1452958
3193,0,INDIA,Urban,8,Illiterate,400644,391420,792064
3194,0,INDIA,Urban,9,Illiterate,265377,259527,524904
3195,0,INDIA,Urban,10,Illiterate,361571,347913,709484
3196,0,INDIA,Urban,11,Illiterate,218432,216404,434836
3197,0,INDIA,Urban,12,Illiterate,239875,237186,477061
3198,0,INDIA,Urban,13,Illiterate,186615,197199,383814
3199,0,INDIA,Urban,14,Illiterate,215864,227069,442933
3200,0,INDIA,Urban,15,Illiterate,261626,264220,525846
3201,0,INDIA,Urban,16,Illiterate,256789,262072,518861
3202,0,INDIA,Urban,17,Illiterate,225711,228717,454428
3203,0,INDIA,Urban,18,Illiterate,365846,377983,743829
3204,0,INDIA,Urban,19,Illiterate,244404,293138,537542
3205,0,INDIA,Urban,20-24,Illiterate,1503330,2098637,3601967
3206,0,INDIA,Urban,25-29,Illiterate,1574556,2618735,4193291
3207,0,INDIA,Urban,30-34,Illiterate,1565778,2820762,4386540
3208,0,INDIA,Urban,35-39,Illiterate,1780066,3403051,5183117
3209,0,INDIA,Urban,40-44,Illiterate,1786765,3230521,5017286
3210,0,INDIA,Urban,45-49,Illiterate,1644550,3122150,4766700
3211,0,INDIA,Urban,50-54,Illiterate,1355880,2558498,3914378
3212,0,INDIA,Urban,55-59,Illiterate,966012,2230150,3196162
3213,0,INDIA,Urban,60-64,Illiterate,1072302,2399286,3471588
3214,0,INDIA,Urban,65-69,Illiterate,726250,1770807,2497057
3215,0,INDIA,Urban,70-74,Illiterate,611223,1414206,2025429
3216,0,INDIA,Urban,75-79,Illiterate,280809,726999,1007808
3217,0,INDIA,Urban,80+,Illiterate,384958,1016349,1401307
3218,0,INDIA,Urban,Age not stated,Illiterate,177669,229901,407570
3219,1,State - JAMMU & KASHMIR,Total,All ages,Illiterate,2375991,3098078,5474069
3220,1,State - JAMMU & KASHMIR,Total,0-6,Illiterate,1084355,934550,2018905
3221,1,State - JAMMU & KASHMIR,Total,7,Illiterate,45646,45715,91361
3222,1,State - JAMMU & KASHMIR,Total,8,Illiterate,28675,31087,59762
3223,1,State - JAMMU & KASHMIR,Total,9,Illiterate,18136,20617,38753
3224,1,State - JAMMU & KASHMIR,Total,10,Illiterate,24445,27667,52112
3225,1,State - JAMMU & KASHMIR,Total,11,Illiterate,15096,19044,34140
3226,1,State - JAMMU & KASHMIR,Total,12,Illiterate,12876,19126,32002
3227,1,State - JAMMU & KASHMIR,Total,13,Illiterate,9823,15936,25759
3228,1,State - JAMMU & KASHMIR,Total,14,Illiterate,9706,17074,26780
3229,1,State - JAMMU & KASHMIR,Total,15,Illiterate,11447,21089,32536
3230,1,State - JAMMU & KASHMIR,Total,16,Illiterate,10834,21730,32564
3231,1,State - JAMMU & KASHMIR,Total,17,Illiterate,8943,17805,26748
3232,1,State - JAMMU & KASHMIR,Total,18,Illiterate,14734,30190,44924
3233,1,State - JAMMU & KASHMIR,Total,19,Illiterate,9453,21077,30530
3234,1,State - JAMMU & KASHMIR,Total,20-24,Illiterate,74478,162292,236770
3235,1,State - JAMMU & KASHMIR,Total,25-29,Illiterate,91443,197100,288543
3236,1,State - JAMMU & KASHMIR,Total,30-34,Illiterate,99864,206465,306329
3237,1,State - JAMMU & KASHMIR,Total,35-39,Illiterate,111560,222794,334354
3238,1,State - JAMMU & KASHMIR,Total,40-44,Illiterate,121203,208019,329222
3239,1,State - JAMMU & KASHMIR,Total,45-49,Illiterate,110010,192274,302284
3240,1,State - JAMMU & KASHMIR,Total,50-54,Illiterate,103650,154989,258639
3241,1,State - JAMMU & KASHMIR,Total,55-59,Illiterate,69481,129052,198533
3242,1,State - JAMMU & KASHMIR,Total,60-64,Illiterate,91666,124161,215827
3243,1,State - JAMMU & KASHMIR,Total,65-69,Illiterate,56652,87008,143660
3244,1,State - JAMMU & KASHMIR,Total,70-74,Illiterate,65465,77621,143086
3245,1,State - JAMMU & KASHMIR,Total,75-79,Illiterate,28154,37459,65613
3246,1,State - JAMMU & KASHMIR,Total,80+,Illiterate,45534,53587,99121
3247,1,State - JAMMU & KASHMIR,Total,Age not stated,Illiterate,2662,2550,5212
3248,1,State - JAMMU & KASHMIR,Rural,All ages,Illiterate,1882728,2477382,4360110
3249,1,State - JAMMU & KASHMIR,Rural,0-6,Illiterate,854141,738867,1593008
3250,1,State - JAMMU & KASHMIR,Rural,7,Illiterate,37793,38232,76025
3251,1,State - JAMMU & KASHMIR,Rural,8,Illiterate,23949,26360,50309
3252,1,State - JAMMU & KASHMIR,Rural,9,Illiterate,14797,17450,32247
3253,1,State - JAMMU & KASHMIR,Rural,10,Illiterate,20001,23349,43350
3254,1,State - JAMMU & KASHMIR,Rural,11,Illiterate,12356,16223,28579
3255,1,State - JAMMU & KASHMIR,Rural,12,Illiterate,10469,16510,26979
3256,1,State - JAMMU & KASHMIR,Rural,13,Illiterate,7983,13802,21785
3257,1,State - JAMMU & KASHMIR,Rural,14,Illiterate,7740,14672,22412
3258,1,State - JAMMU & KASHMIR,Rural,15,Illiterate,9120,18392,27512
3259,1,State - JAMMU & KASHMIR,Rural,16,Illiterate,8689,18962,27651
3260,1,State - JAMMU & KASHMIR,Rural,17,Illiterate,7027,15353,22380
3261,1,State - JAMMU & KASHMIR,Rural,18,Illiterate,11790,26297,38087
3262,1,State - JAMMU & KASHMIR,Rural,19,Illiterate,7386,18076,25462
3263,1,State - JAMMU & KASHMIR,Rural,20-24,Illiterate,59389,138034,197423
3264,1,State - JAMMU & KASHMIR,Rural,25-29,Illiterate,72743,163407,236150
3265,1,State - JAMMU & KASHMIR,Rural,30-34,Illiterate,79317,168448,247765
3266,1,State - JAMMU & KASHMIR,Rural,35-39,Illiterate,86738,177352,264090
3267,1,State - JAMMU & KASHMIR,Rural,40-44,Illiterate,94929,165246,260175
3268,1,State - JAMMU & KASHMIR,Rural,45-49,Illiterate,86146,151365,237511
3269,1,State - JAMMU & KASHMIR,Rural,50-54,Illiterate,82496,122245,204741
3270,1,State - JAMMU & KASHMIR,Rural,55-59,Illiterate,54480,98900,153380
3271,1,State - JAMMU & KASHMIR,Rural,60-64,Illiterate,73350,95688,169038
3272,1,State - JAMMU & KASHMIR,Rural,65-69,Illiterate,44806,65239,110045
3273,1,State - JAMMU & KASHMIR,Rural,70-74,Illiterate,52813,58280,111093
3274,1,State - JAMMU & KASHMIR,Rural,75-79,Illiterate,22280,27496,49776
3275,1,State - JAMMU & KASHMIR,Rural,80+,Illiterate,37929,41135,79064
3276,1,State - JAMMU & KASHMIR,Rural,Age not stated,Illiterate,2071,2002,4073
3277,1,State - JAMMU & KASHMIR,Urban,All ages,Illiterate,493263,620696,1113959
3278,1,State - JAMMU & KASHMIR,Urban,0-6,Illiterate,230214,195683,425897
3279,1,State - JAMMU & KASHMIR,Urban,7,Illiterate,7853,7483,15336
3280,1,State - JAMMU & KASHMIR,Urban,8,Illiterate,4726,4727,9453
3281,1,State - JAMMU & KASHMIR,Urban,9,Illiterate,3339,3167,6506
3282,1,State - JAMMU & KASHMIR,Urban,10,Illiterate,4444,4318,8762
3283,1,State - JAMMU & KASHMIR,Urban,11,Illiterate,2740,2821,5561
3284,1,State - JAMMU & KASHMIR,Urban,12,Illiterate,2407,2616,5023
3285,1,State - JAMMU & KASHMIR,Urban,13,Illiterate,1840,2134,3974
3286,1,State - JAMMU & KASHMIR,Urban,14,Illiterate,1966,2402,4368
3287,1,State - JAMMU & KASHMIR,Urban,15,Illiterate,2327,2697,5024
3288,1,State - JAMMU & KASHMIR,Urban,16,Illiterate,2145,2768,4913
3289,1,State - JAMMU & KASHMIR,Urban,17,Illiterate,1916,2452,4368
3290,1,State - JAMMU & KASHMIR,Urban,18,Illiterate,2944,3893,6837
3291,1,State - JAMMU & KASHMIR,Urban,19,Illiterate,2067,3001,5068
3292,1,State - JAMMU & KASHMIR,Urban,20-24,Illiterate,15089,24258,39347
3293,1,State - JAMMU & KASHMIR,Urban,25-29,Illiterate,18700,33693,52393
3294,1,State - JAMMU & KASHMIR,Urban,30-34,Illiterate,20547,38017,58564
3295,1,State - JAMMU & KASHMIR,Urban,35-39,Illiterate,24822,45442,70264
3296,1,State - JAMMU & KASHMIR,Urban,40-44,Illiterate,26274,42773,69047
3297,1,State - JAMMU & KASHMIR,Urban,45-49,Illiterate,23864,40909,64773
3298,1,State - JAMMU & KASHMIR,Urban,50-54,Illiterate,21154,32744,53898
3299,1,State - JAMMU & KASHMIR,Urban,55-59,Illiterate,15001,30152,45153
3300,1,State - JAMMU & KASHMIR,Urban,60-64,Illiterate,18316,28473,46789
3301,1,State - JAMMU & KASHMIR,Urban,65-69,Illiterate,11846,21769,33615
3302,1,State - JAMMU & KASHMIR,Urban,70-74,Illiterate,12652,19341,31993
3303,1,State - JAMMU & KASHMIR,Urban,75-79,Illiterate,5874,9963,15837
3304,1,State - JAMMU & KASHMIR,Urban,80+,Illiterate,7605,12452,20057
3305,1,State - JAMMU & KASHMIR,Urban,Age not stated,Illiterate,591,548,1139
3306,2,State - HIMACHAL PRADESH,Total,All ages,Illiterate,729283,1095583,1824866
3307,2,State - HIMACHAL PRADESH,Total,0-6,Illiterate,407459,370439,777898
3308,2,State - HIMACHAL PRADESH,Total,7,Illiterate,10007,9478,19485
3309,2,State - HIMACHAL PRADESH,Total,8,Illiterate,2983,3157,6140
3310,2,State - HIMACHAL PRADESH,Total,9,Illiterate,2289,2274,4563
3311,2,State - HIMACHAL PRADESH,Total,10,Illiterate,3127,3048,6175
3312,2,State - HIMACHAL PRADESH,Total,11,Illiterate,1781,1877,3658
3313,2,State - HIMACHAL PRADESH,Total,12,Illiterate,1278,1472,2750
3314,2,State - HIMACHAL PRADESH,Total,13,Illiterate,1143,1365,2508
3315,2,State - HIMACHAL PRADESH,Total,14,Illiterate,1239,1430,2669
3316,2,State - HIMACHAL PRADESH,Total,15,Illiterate,1550,1714,3264
3317,2,State - HIMACHAL PRADESH,Total,16,Illiterate,1495,1537,3032
3318,2,State - HIMACHAL PRADESH,Total,17,Illiterate,1386,1483,2869
3319,2,State - HIMACHAL PRADESH,Total,18,Illiterate,2212,2301,4513
3320,2,State - HIMACHAL PRADESH,Total,19,Illiterate,1759,2114,3873
3321,2,State - HIMACHAL PRADESH,Total,20-24,Illiterate,11258,17271,28529
3322,2,State - HIMACHAL PRADESH,Total,25-29,Illiterate,13333,26688,40021
3323,2,State - HIMACHAL PRADESH,Total,30-34,Illiterate,15364,36431,51795
3324,2,State - HIMACHAL PRADESH,Total,35-39,Illiterate,19713,52693,72406
3325,2,State - HIMACHAL PRADESH,Total,40-44,Illiterate,23893,66245,90138
3326,2,State - HIMACHAL PRADESH,Total,45-49,Illiterate,27313,72310,99623
3327,2,State - HIMACHAL PRADESH,Total,50-54,Illiterate,26490,72807,99297
3328,2,State - HIMACHAL PRADESH,Total,55-59,Illiterate,23733,67815,91548
3329,2,State - HIMACHAL PRADESH,Total,60-64,Illiterate,29883,77260,107143
3330,2,State - HIMACHAL PRADESH,Total,65-69,Illiterate,24623,59933,84556
3331,2,State - HIMACHAL PRADESH,Total,70-74,Illiterate,26159,56341,82500
3332,2,State - HIMACHAL PRADESH,Total,75-79,Illiterate,17460,33350,50810
3333,2,State - HIMACHAL PRADESH,Total,80+,Illiterate,29017,51142,80159
3334,2,State - HIMACHAL PRADESH,Total,Age not stated,Illiterate,1336,1608,2944
3335,2,State - HIMACHAL PRADESH,Rural,All ages,Illiterate,672524,1031790,1704314
3336,2,State - HIMACHAL PRADESH,Rural,0-6,Illiterate,372854,339968,712822
3337,2,State - HIMACHAL PRADESH,Rural,7,Illiterate,9081,8617,17698
3338,2,State - HIMACHAL PRADESH,Rural,8,Illiterate,2682,2858,5540
3339,2,State - HIMACHAL PRADESH,Rural,9,Illiterate,2039,2054,4093
3340,2,State - HIMACHAL PRADESH,Rural,10,Illiterate,2771,2753,5524
3341,2,State - HIMACHAL PRADESH,Rural,11,Illiterate,1571,1682,3253
3342,2,State - HIMACHAL PRADESH,Rural,12,Illiterate,1099,1315,2414
3343,2,State - HIMACHAL PRADESH,Rural,13,Illiterate,992,1215,2207
3344,2,State - HIMACHAL PRADESH,Rural,14,Illiterate,1085,1278,2363
3345,2,State - HIMACHAL PRADESH,Rural,15,Illiterate,1325,1515,2840
3346,2,State - HIMACHAL PRADESH,Rural,16,Illiterate,1248,1373,2621
3347,2,State - HIMACHAL PRADESH,Rural,17,Illiterate,1173,1365,2538
3348,2,State - HIMACHAL PRADESH,Rural,18,Illiterate,1790,2080,3870
3349,2,State - HIMACHAL PRADESH,Rural,19,Illiterate,1416,1918,3334
3350,2,State - HIMACHAL PRADESH,Rural,20-24,Illiterate,9331,15554,24885
3351,2,State - HIMACHAL PRADESH,Rural,25-29,Illiterate,11407,24497,35904
3352,2,State - HIMACHAL PRADESH,Rural,30-34,Illiterate,13550,34028,47578
3353,2,State - HIMACHAL PRADESH,Rural,35-39,Illiterate,17684,49826,67510
3354,2,State - HIMACHAL PRADESH,Rural,40-44,Illiterate,21940,63294,85234
3355,2,State - HIMACHAL PRADESH,Rural,45-49,Illiterate,25491,69342,94833
3356,2,State - HIMACHAL PRADESH,Rural,50-54,Illiterate,25000,70204,95204
3357,2,State - HIMACHAL PRADESH,Rural,55-59,Illiterate,22614,65484,88098
3358,2,State - HIMACHAL PRADESH,Rural,60-64,Illiterate,28787,74690,103477
3359,2,State - HIMACHAL PRADESH,Rural,65-69,Illiterate,23846,57907,81753
3360,2,State - HIMACHAL PRADESH,Rural,70-74,Illiterate,25348,54273,79621
3361,2,State - HIMACHAL PRADESH,Rural,75-79,Illiterate,16935,31984,48919
3362,2,State - HIMACHAL PRADESH,Rural,80+,Illiterate,28192,49164,77356
3363,2,State - HIMACHAL PRADESH,Rural,Age not stated,Illiterate,1273,1552,2825
3364,2,State - HIMACHAL PRADESH,Urban,All ages,Illiterate,56759,63793,120552
3365,2,State - HIMACHAL PRADESH,Urban,0-6,Illiterate,34605,30471,65076
3366,2,State - HIMACHAL PRADESH,Urban,7,Illiterate,926,861,1787
3367,2,State - HIMACHAL PRADESH,Urban,8,Illiterate,301,299,600
3368,2,State - HIMACHAL PRADESH,Urban,9,Illiterate,250,220,470
3369,2,State - HIMACHAL PRADESH,Urban,10,Illiterate,356,295,651
3370,2,State - HIMACHAL PRADESH,Urban,11,Illiterate,210,195,405
3371,2,State - HIMACHAL PRADESH,Urban,12,Illiterate,179,157,336
3372,2,State - HIMACHAL PRADESH,Urban,13,Illiterate,151,150,301
3373,2,State - HIMACHAL PRADESH,Urban,14,Illiterate,154,152,306
3374,2,State - HIMACHAL PRADESH,Urban,15,Illiterate,225,199,424
3375,2,State - HIMACHAL PRADESH,Urban,16,Illiterate,247,164,411
3376,2,State - HIMACHAL PRADESH,Urban,17,Illiterate,213,118,331
3377,2,State - HIMACHAL PRADESH,Urban,18,Illiterate,422,221,643
3378,2,State - HIMACHAL PRADESH,Urban,19,Illiterate,343,196,539
3379,2,State - HIMACHAL PRADESH,Urban,20-24,Illiterate,1927,1717,3644
3380,2,State - HIMACHAL PRADESH,Urban,25-29,Illiterate,1926,2191,4117
3381,2,State - HIMACHAL PRADESH,Urban,30-34,Illiterate,1814,2403,4217
3382,2,State - HIMACHAL PRADESH,Urban,35-39,Illiterate,2029,2867,4896
3383,2,State - HIMACHAL PRADESH,Urban,40-44,Illiterate,1953,2951,4904
3384,2,State - HIMACHAL PRADESH,Urban,45-49,Illiterate,1822,2968,4790
3385,2,State - HIMACHAL PRADESH,Urban,50-54,Illiterate,1490,2603,4093
3386,2,State - HIMACHAL PRADESH,Urban,55-59,Illiterate,1119,2331,3450
3387,2,State - HIMACHAL PRADESH,Urban,60-64,Illiterate,1096,2570,3666
3388,2,State - HIMACHAL PRADESH,Urban,65-69,Illiterate,777,2026,2803
3389,2,State - HIMACHAL PRADESH,Urban,70-74,Illiterate,811,2068,2879
3390,2,State - HIMACHAL PRADESH,Urban,75-79,Illiterate,525,1366,1891
3391,2,State - HIMACHAL PRADESH,Urban,80+,Illiterate,825,1978,2803
3392,2,State - HIMACHAL PRADESH,Urban,Age not stated,Illiterate,63,56,119
3393,3,State - PUNJAB,Total,All ages,Illiterate,4203409,4832792,9036201
3394,3,State - PUNJAB,Total,0-6,Illiterate,1665994,1410225,3076219
3395,3,State - PUNJAB,Total,7,Illiterate,57896,50517,108413
3396,3,State - PUNJAB,Total,8,Illiterate,30352,26633,56985
3397,3,State - PUNJAB,Total,9,Illiterate,20650,18205,38855
3398,3,State - PUNJAB,Total,10,Illiterate,25701,22353,48054
3399,3,State - PUNJAB,Total,11,Illiterate,16704,14798,31502
3400,3,State - PUNJAB,Total,12,Illiterate,18591,16539,35130
3401,3,State - PUNJAB,Total,13,Illiterate,16436,15525,31961
3402,3,State - PUNJAB,Total,14,Illiterate,18874,17279,36153
3403,3,State - PUNJAB,Total,15,Illiterate,25232,21361,46593
3404,3,State - PUNJAB,Total,16,Illiterate,24869,21107,45976
3405,3,State - PUNJAB,Total,17,Illiterate,22766,18268,41034
3406,3,State - PUNJAB,Total,18,Illiterate,35720,28115,63835
3407,3,State - PUNJAB,Total,19,Illiterate,24513,21741,46254
3408,3,State - PUNJAB,Total,20-24,Illiterate,157025,172443,329468
3409,3,State - PUNJAB,Total,25-29,Illiterate,170004,225047,395051
3410,3,State - PUNJAB,Total,30-34,Illiterate,186023,268759,454782
3411,3,State - PUNJAB,Total,35-39,Illiterate,218607,315240,533847
3412,3,State - PUNJAB,Total,40-44,Illiterate,229473,325984,555457
3413,3,State - PUNJAB,Total,45-49,Illiterate,218686,313625,532311
3414,3,State - PUNJAB,Total,50-54,Illiterate,195681,259947,455628
3415,3,State - PUNJAB,Total,55-59,Illiterate,133327,234012,367339
3416,3,State - PUNJAB,Total,60-64,Illiterate,187337,323574,510911
3417,3,State - PUNJAB,Total,65-69,Illiterate,166420,244111,410531
3418,3,State - PUNJAB,Total,70-74,Illiterate,145177,183788,328965
3419,3,State - PUNJAB,Total,75-79,Illiterate,70230,98887,169117
3420,3,State - PUNJAB,Total,80+,Illiterate,114766,157536,272302
3421,3,State - PUNJAB,Total,Age not stated,Illiterate,6355,7173,13528
3422,3,State - PUNJAB,Rural,All ages,Illiterate,2934669,3411866,6346535
3423,3,State - PUNJAB,Rural,0-6,Illiterate,1055297,890205,1945502
3424,3,State - PUNJAB,Rural,7,Illiterate,37752,32584,70336
3425,3,State - PUNJAB,Rural,8,Illiterate,19141,16496,35637
3426,3,State - PUNJAB,Rural,9,Illiterate,12699,11014,23713
3427,3,State - PUNJAB,Rural,10,Illiterate,15266,13507,28773
3428,3,State - PUNJAB,Rural,11,Illiterate,10222,9053,19275
3429,3,State - PUNJAB,Rural,12,Illiterate,11241,10277,21518
3430,3,State - PUNJAB,Rural,13,Illiterate,10231,9928,20159
3431,3,State - PUNJAB,Rural,14,Illiterate,12082,11371,23453
3432,3,State - PUNJAB,Rural,15,Illiterate,15854,14163,30017
3433,3,State - PUNJAB,Rural,16,Illiterate,15977,14200,30177
3434,3,State - PUNJAB,Rural,17,Illiterate,14738,12299,27037
3435,3,State - PUNJAB,Rural,18,Illiterate,22604,18951,41555
3436,3,State - PUNJAB,Rural,19,Illiterate,15802,14392,30194
3437,3,State - PUNJAB,Rural,20-24,Illiterate,103744,117174,220918
3438,3,State - PUNJAB,Rural,25-29,Illiterate,114914,154711,269625
3439,3,State - PUNJAB,Rural,30-34,Illiterate,131677,191832,323509
3440,3,State - PUNJAB,Rural,35-39,Illiterate,158173,228677,386850
3441,3,State - PUNJAB,Rural,40-44,Illiterate,169949,240832,410781
3442,3,State - PUNJAB,Rural,45-49,Illiterate,162919,232638,395557
3443,3,State - PUNJAB,Rural,50-54,Illiterate,149040,194156,343196
3444,3,State - PUNJAB,Rural,55-59,Illiterate,103387,178281,281668
3445,3,State - PUNJAB,Rural,60-64,Illiterate,151757,256442,408199
3446,3,State - PUNJAB,Rural,65-69,Illiterate,139910,193196,333106
3447,3,State - PUNJAB,Rural,70-74,Illiterate,120897,141705,262602
3448,3,State - PUNJAB,Rural,75-79,Illiterate,58706,76055,134761
3449,3,State - PUNJAB,Rural,80+,Illiterate,95943,122256,218199
3450,3,State - PUNJAB,Rural,Age not stated,Illiterate,4747,5471,10218
3451,3,State - PUNJAB,Urban,All ages,Illiterate,1268740,1420926,2689666
3452,3,State - PUNJAB,Urban,0-6,Illiterate,610697,520020,1130717
3453,3,State - PUNJAB,Urban,7,Illiterate,20144,17933,38077
3454,3,State - PUNJAB,Urban,8,Illiterate,11211,10137,21348
3455,3,State - PUNJAB,Urban,9,Illiterate,7951,7191,15142
3456,3,State - PUNJAB,Urban,10,Illiterate,10435,8846,19281
3457,3,State - PUNJAB,Urban,11,Illiterate,6482,5745,12227
3458,3,State - PUNJAB,Urban,12,Illiterate,7350,6262,13612
3459,3,State - PUNJAB,Urban,13,Illiterate,6205,5597,11802
3460,3,State - PUNJAB,Urban,14,Illiterate,6792,5908,12700
3461,3,State - PUNJAB,Urban,15,Illiterate,9378,7198,16576
3462,3,State - PUNJAB,Urban,16,Illiterate,8892,6907,15799
3463,3,State - PUNJAB,Urban,17,Illiterate,8028,5969,13997
3464,3,State - PUNJAB,Urban,18,Illiterate,13116,9164,22280
3465,3,State - PUNJAB,Urban,19,Illiterate,8711,7349,16060
3466,3,State - PUNJAB,Urban,20-24,Illiterate,53281,55269,108550
3467,3,State - PUNJAB,Urban,25-29,Illiterate,55090,70336,125426
3468,3,State - PUNJAB,Urban,30-34,Illiterate,54346,76927,131273
3469,3,State - PUNJAB,Urban,35-39,Illiterate,60434,86563,146997
3470,3,State - PUNJAB,Urban,40-44,Illiterate,59524,85152,144676
3471,3,State - PUNJAB,Urban,45-49,Illiterate,55767,80987,136754
3472,3,State - PUNJAB,Urban,50-54,Illiterate,46641,65791,112432
3473,3,State - PUNJAB,Urban,55-59,Illiterate,29940,55731,85671
3474,3,State - PUNJAB,Urban,60-64,Illiterate,35580,67132,102712
3475,3,State - PUNJAB,Urban,65-69,Illiterate,26510,50915,77425
3476,3,State - PUNJAB,Urban,70-74,Illiterate,24280,42083,66363
3477,3,State - PUNJAB,Urban,75-79,Illiterate,11524,22832,34356
3478,3,State - PUNJAB,Urban,80+,Illiterate,18823,35280,54103
3479,3,State - PUNJAB,Urban,Age not stated,Illiterate,1608,1702,3310
3480,4,State - CHANDIGARH,Total,All ages,Illiterate,115317,134695,250012
3481,4,State - CHANDIGARH,Total,0-6,Illiterate,63536,55898,119434
3482,4,State - CHANDIGARH,Total,7,Illiterate,1649,1523,3172
3483,4,State - CHANDIGARH,Total,8,Illiterate,738,657,1395
3484,4,State - CHANDIGARH,Total,9,Illiterate,692,705,1397
3485,4,State - CHANDIGARH,Total,10,Illiterate,794,771,1565
3486,4,State - CHANDIGARH,Total,11,Illiterate,465,484,949
3487,4,State - CHANDIGARH,Total,12,Illiterate,447,437,884
3488,4,State - CHANDIGARH,Total,13,Illiterate,382,422,804
3489,4,State - CHANDIGARH,Total,14,Illiterate,413,423,836
3490,4,State - CHANDIGARH,Total,15,Illiterate,629,559,1188
3491,4,State - CHANDIGARH,Total,16,Illiterate,660,549,1209
3492,4,State - CHANDIGARH,Total,17,Illiterate,653,492,1145
3493,4,State - CHANDIGARH,Total,18,Illiterate,1166,745,1911
3494,4,State - CHANDIGARH,Total,19,Illiterate,841,630,1471
3495,4,State - CHANDIGARH,Total,20-24,Illiterate,4812,5616,10428
3496,4,State - CHANDIGARH,Total,25-29,Illiterate,5184,8173,13357
3497,4,State - CHANDIGARH,Total,30-34,Illiterate,5102,8953,14055
3498,4,State - CHANDIGARH,Total,35-39,Illiterate,6078,10024,16102
3499,4,State - CHANDIGARH,Total,40-44,Illiterate,5215,8880,14095
3500,4,State - CHANDIGARH,Total,45-49,Illiterate,4778,7644,12422
3501,4,State - CHANDIGARH,Total,50-54,Illiterate,3430,5503,8933
3502,4,State - CHANDIGARH,Total,55-59,Illiterate,2150,4007,6157
3503,4,State - CHANDIGARH,Total,60-64,Illiterate,2162,4235,6397
3504,4,State - CHANDIGARH,Total,65-69,Illiterate,1244,2572,3816
3505,4,State - CHANDIGARH,Total,70-74,Illiterate,991,1950,2941
3506,4,State - CHANDIGARH,Total,75-79,Illiterate,397,1073,1470
3507,4,State - CHANDIGARH,Total,80+,Illiterate,673,1719,2392
3508,4,State - CHANDIGARH,Total,Age not stated,Illiterate,36,51,87
3509,4,State - CHANDIGARH,Rural,All ages,Illiterate,4398,4632,9030
3510,4,State - CHANDIGARH,Rural,0-6,Illiterate,2282,1988,4270
3511,4,State - CHANDIGARH,Rural,7,Illiterate,81,60,141
3512,4,State - CHANDIGARH,Rural,8,Illiterate,29,27,56
3513,4,State - CHANDIGARH,Rural,9,Illiterate,25,28,53
3514,4,State - CHANDIGARH,Rural,10,Illiterate,30,34,64
3515,4,State - CHANDIGARH,Rural,11,Illiterate,17,23,40
3516,4,State - CHANDIGARH,Rural,12,Illiterate,15,17,32
3517,4,State - CHANDIGARH,Rural,13,Illiterate,13,14,27
3518,4,State - CHANDIGARH,Rural,14,Illiterate,13,21,34
3519,4,State - CHANDIGARH,Rural,15,Illiterate,24,22,46
3520,4,State - CHANDIGARH,Rural,16,Illiterate,34,21,55
3521,4,State - CHANDIGARH,Rural,17,Illiterate,26,16,42
3522,4,State - CHANDIGARH,Rural,18,Illiterate,63,23,86
3523,4,State - CHANDIGARH,Rural,19,Illiterate,42,31,73
3524,4,State - CHANDIGARH,Rural,20-24,Illiterate,262,237,499
3525,4,State - CHANDIGARH,Rural,25-29,Illiterate,279,365,644
3526,4,State - CHANDIGARH,Rural,30-34,Illiterate,236,357,593
3527,4,State - CHANDIGARH,Rural,35-39,Illiterate,244,306,550
3528,4,State - CHANDIGARH,Rural,40-44,Illiterate,168,244,412
3529,4,State - CHANDIGARH,Rural,45-49,Illiterate,139,176,315
3530,4,State - CHANDIGARH,Rural,50-54,Illiterate,94,144,238
3531,4,State - CHANDIGARH,Rural,55-59,Illiterate,52,121,173
3532,4,State - CHANDIGARH,Rural,60-64,Illiterate,91,139,230
3533,4,State - CHANDIGARH,Rural,65-69,Illiterate,53,86,139
3534,4,State - CHANDIGARH,Rural,70-74,Illiterate,37,63,100
3535,4,State - CHANDIGARH,Rural,75-79,Illiterate,17,27,44
3536,4,State - CHANDIGARH,Rural,80+,Illiterate,31,41,72
3537,4,State - CHANDIGARH,Rural,Age not stated,Illiterate,1,1,2
3538,4,State - CHANDIGARH,Urban,All ages,Illiterate,110919,130063,240982
3539,4,State - CHANDIGARH,Urban,0-6,Illiterate,61254,53910,115164
3540,4,State - CHANDIGARH,Urban,7,Illiterate,1568,1463,3031
3541,4,State - CHANDIGARH,Urban,8,Illiterate,709,630,1339
3542,4,State - CHANDIGARH,Urban,9,Illiterate,667,677,1344
3543,4,State - CHANDIGARH,Urban,10,Illiterate,764,737,1501
3544,4,State - CHANDIGARH,Urban,11,Illiterate,448,461,909
3545,4,State - CHANDIGARH,Urban,12,Illiterate,432,420,852
3546,4,State - CHANDIGARH,Urban,13,Illiterate,369,408,777
3547,4,State - CHANDIGARH,Urban,14,Illiterate,400,402,802
3548,4,State - CHANDIGARH,Urban,15,Illiterate,605,537,1142
3549,4,State - CHANDIGARH,Urban,16,Illiterate,626,528,1154
3550,4,State - CHANDIGARH,Urban,17,Illiterate,627,476,1103
3551,4,State - CHANDIGARH,Urban,18,Illiterate,1103,722,1825
3552,4,State - CHANDIGARH,Urban,19,Illiterate,799,599,1398
3553,4,State - CHANDIGARH,Urban,20-24,Illiterate,4550,5379,9929
3554,4,State - CHANDIGARH,Urban,25-29,Illiterate,4905,7808,12713
3555,4,State - CHANDIGARH,Urban,30-34,Illiterate,4866,8596,13462
3556,4,State - CHANDIGARH,Urban,35-39,Illiterate,5834,9718,15552
3557,4,State - CHANDIGARH,Urban,40-44,Illiterate,5047,8636,13683
3558,4,State - CHANDIGARH,Urban,45-49,Illiterate,4639,7468,12107
3559,4,State - CHANDIGARH,Urban,50-54,Illiterate,3336,5359,8695
3560,4,State - CHANDIGARH,Urban,55-59,Illiterate,2098,3886,5984
3561,4,State - CHANDIGARH,Urban,60-64,Illiterate,2071,4096,6167
3562,4,State - CHANDIGARH,Urban,65-69,Illiterate,1191,2486,3677
3563,4,State - CHANDIGARH,Urban,70-74,Illiterate,954,1887,2841
3564,4,State - CHANDIGARH,Urban,75-79,Illiterate,380,1046,1426
3565,4,State - CHANDIGARH,Urban,80+,Illiterate,642,1678,2320
3566,4,State - CHANDIGARH,Urban,Age not stated,Illiterate,35,50,85
3567,5,State - UTTARAKHAND,Total,All ages,Illiterate,1274065,1931274,3205339
3568,5,State - UTTARAKHAND,Total,0-6,Illiterate,717199,638615,1355814
3569,5,State - UTTARAKHAND,Total,7,Illiterate,23217,22131,45348
3570,5,State - UTTARAKHAND,Total,8,Illiterate,10834,10555,21389
3571,5,State - UTTARAKHAND,Total,9,Illiterate,7591,7282,14873
3572,5,State - UTTARAKHAND,Total,10,Illiterate,10748,10347,21095
3573,5,State - UTTARAKHAND,Total,11,Illiterate,5683,5688,11371
3574,5,State - UTTARAKHAND,Total,12,Illiterate,4730,5303,10033
3575,5,State - UTTARAKHAND,Total,13,Illiterate,3726,4652,8378
3576,5,State - UTTARAKHAND,Total,14,Illiterate,4461,5421,9882
3577,5,State - UTTARAKHAND,Total,15,Illiterate,5465,7009,12474
3578,5,State - UTTARAKHAND,Total,16,Illiterate,5685,7206,12891
3579,5,State - UTTARAKHAND,Total,17,Illiterate,4960,6420,11380
3580,5,State - UTTARAKHAND,Total,18,Illiterate,8635,10678,19313
3581,5,State - UTTARAKHAND,Total,19,Illiterate,5693,8056,13749
3582,5,State - UTTARAKHAND,Total,20-24,Illiterate,33899,63294,97193
3583,5,State - UTTARAKHAND,Total,25-29,Illiterate,37249,84676,121925
3584,5,State - UTTARAKHAND,Total,30-34,Illiterate,39795,102333,142128
3585,5,State - UTTARAKHAND,Total,35-39,Illiterate,48165,125242,173407
3586,5,State - UTTARAKHAND,Total,40-44,Illiterate,48079,124896,172975
3587,5,State - UTTARAKHAND,Total,45-49,Illiterate,44651,120204,164855
3588,5,State - UTTARAKHAND,Total,50-54,Illiterate,38305,107175,145480
3589,5,State - UTTARAKHAND,Total,55-59,Illiterate,29172,102857,132029
3590,5,State - UTTARAKHAND,Total,60-64,Illiterate,44524,118983,163507
3591,5,State - UTTARAKHAND,Total,65-69,Illiterate,30194,82481,112675
3592,5,State - UTTARAKHAND,Total,70-74,Illiterate,26478,66219,92697
3593,5,State - UTTARAKHAND,Total,75-79,Illiterate,13554,35599,49153
3594,5,State - UTTARAKHAND,Total,80+,Illiterate,19483,45441,64924
3595,5,State - UTTARAKHAND,Total,Age not stated,Illiterate,1890,2511,4401
3596,5,State - UTTARAKHAND,Rural,All ages,Illiterate,922871,1500033,2422904
3597,5,State - UTTARAKHAND,Rural,0-6,Illiterate,521792,468984,990776
3598,5,State - UTTARAKHAND,Rural,7,Illiterate,17066,16269,33335
3599,5,State - UTTARAKHAND,Rural,8,Illiterate,7572,7545,15117
3600,5,State - UTTARAKHAND,Rural,9,Illiterate,5179,5127,10306
3601,5,State - UTTARAKHAND,Rural,10,Illiterate,7302,7103,14405
3602,5,State - UTTARAKHAND,Rural,11,Illiterate,3657,3869,7526
3603,5,State - UTTARAKHAND,Rural,12,Illiterate,2823,3521,6344
3604,5,State - UTTARAKHAND,Rural,13,Illiterate,2143,3082,5225
3605,5,State - UTTARAKHAND,Rural,14,Illiterate,2612,3593,6205
3606,5,State - UTTARAKHAND,Rural,15,Illiterate,3179,4715,7894
3607,5,State - UTTARAKHAND,Rural,16,Illiterate,3313,4918,8231
3608,5,State - UTTARAKHAND,Rural,17,Illiterate,2810,4383,7193
3609,5,State - UTTARAKHAND,Rural,18,Illiterate,4999,7523,12522
3610,5,State - UTTARAKHAND,Rural,19,Illiterate,3267,5688,8955
3611,5,State - UTTARAKHAND,Rural,20-24,Illiterate,20472,45903,66375
3612,5,State - UTTARAKHAND,Rural,25-29,Illiterate,23925,62850,86775
3613,5,State - UTTARAKHAND,Rural,30-34,Illiterate,26715,78927,105642
3614,5,State - UTTARAKHAND,Rural,35-39,Illiterate,33244,97934,131178
3615,5,State - UTTARAKHAND,Rural,40-44,Illiterate,34107,99553,133660
3616,5,State - UTTARAKHAND,Rural,45-49,Illiterate,32181,96492,128673
3617,5,State - UTTARAKHAND,Rural,50-54,Illiterate,28615,88510,117125
3618,5,State - UTTARAKHAND,Rural,55-59,Illiterate,22531,85964,108495
3619,5,State - UTTARAKHAND,Rural,60-64,Illiterate,36275,101259,137534
3620,5,State - UTTARAKHAND,Rural,65-69,Illiterate,25114,70443,95557
3621,5,State - UTTARAKHAND,Rural,70-74,Illiterate,22345,56548,78893
3622,5,State - UTTARAKHAND,Rural,75-79,Illiterate,11723,30285,42008
3623,5,State - UTTARAKHAND,Rural,80+,Illiterate,16655,37267,53922
3624,5,State - UTTARAKHAND,Rural,Age not stated,Illiterate,1255,1778,3033
3625,5,State - UTTARAKHAND,Urban,All ages,Illiterate,351194,431241,782435
3626,5,State - UTTARAKHAND,Urban,0-6,Illiterate,195407,169631,365038
3627,5,State - UTTARAKHAND,Urban,7,Illiterate,6151,5862,12013
3628,5,State - UTTARAKHAND,Urban,8,Illiterate,3262,3010,6272
3629,5,State - UTTARAKHAND,Urban,9,Illiterate,2412,2155,4567
3630,5,State - UTTARAKHAND,Urban,10,Illiterate,3446,3244,6690
3631,5,State - UTTARAKHAND,Urban,11,Illiterate,2026,1819,3845
3632,5,State - UTTARAKHAND,Urban,12,Illiterate,1907,1782,3689
3633,5,State - UTTARAKHAND,Urban,13,Illiterate,1583,1570,3153
3634,5,State - UTTARAKHAND,Urban,14,Illiterate,1849,1828,3677
3635,5,State - UTTARAKHAND,Urban,15,Illiterate,2286,2294,4580
3636,5,State - UTTARAKHAND,Urban,16,Illiterate,2372,2288,4660
3637,5,State - UTTARAKHAND,Urban,17,Illiterate,2150,2037,4187
3638,5,State - UTTARAKHAND,Urban,18,Illiterate,3636,3155,6791
3639,5,State - UTTARAKHAND,Urban,19,Illiterate,2426,2368,4794
3640,5,State - UTTARAKHAND,Urban,20-24,Illiterate,13427,17391,30818
3641,5,State - UTTARAKHAND,Urban,25-29,Illiterate,13324,21826,35150
3642,5,State - UTTARAKHAND,Urban,30-34,Illiterate,13080,23406,36486
3643,5,State - UTTARAKHAND,Urban,35-39,Illiterate,14921,27308,42229
3644,5,State - UTTARAKHAND,Urban,40-44,Illiterate,13972,25343,39315
3645,5,State - UTTARAKHAND,Urban,45-49,Illiterate,12470,23712,36182
3646,5,State - UTTARAKHAND,Urban,50-54,Illiterate,9690,18665,28355
3647,5,State - UTTARAKHAND,Urban,55-59,Illiterate,6641,16893,23534
3648,5,State - UTTARAKHAND,Urban,60-64,Illiterate,8249,17724,25973
3649,5,State - UTTARAKHAND,Urban,65-69,Illiterate,5080,12038,17118
3650,5,State - UTTARAKHAND,Urban,70-74,Illiterate,4133,9671,13804
3651,5,State - UTTARAKHAND,Urban,75-79,Illiterate,1831,5314,7145
3652,5,State - UTTARAKHAND,Urban,80+,Illiterate,2828,8174,11002
3653,5,State - UTTARAKHAND,Urban,Age not stated,Illiterate,635,733,1368
3654,6,State - HARYANA,Total,All ages,Illiterate,3700667,5051807,8752474
3655,6,State - HARYANA,Total,0-6,Illiterate,1843109,1537612,3380721
3656,6,State - HARYANA,Total,7,Illiterate,54114,50094,104208
3657,6,State - HARYANA,Total,8,Illiterate,28600,29400,58000
3658,6,State - HARYANA,Total,9,Illiterate,18326,19521,37847
3659,6,State - HARYANA,Total,10,Illiterate,24191,26140,50331
3660,6,State - HARYANA,Total,11,Illiterate,13954,16513,30467
3661,6,State - HARYANA,Total,12,Illiterate,15079,19145,34224
3662,6,State - HARYANA,Total,13,Illiterate,12135,16683,28818
3663,6,State - HARYANA,Total,14,Illiterate,14109,19616,33725
3664,6,State - HARYANA,Total,15,Illiterate,17869,22284,40153
3665,6,State - HARYANA,Total,16,Illiterate,17862,22878,40740
3666,6,State - HARYANA,Total,17,Illiterate,15650,19869,35519
3667,6,State - HARYANA,Total,18,Illiterate,25963,33414,59377
3668,6,State - HARYANA,Total,19,Illiterate,16840,25882,42722
3669,6,State - HARYANA,Total,20-24,Illiterate,111624,196704,308328
3670,6,State - HARYANA,Total,25-29,Illiterate,121597,236621,358218
3671,6,State - HARYANA,Total,30-34,Illiterate,128697,283441,412138
3672,6,State - HARYANA,Total,35-39,Illiterate,154747,357193,511940
3673,6,State - HARYANA,Total,40-44,Illiterate,172689,373675,546364
3674,6,State - HARYANA,Total,45-49,Illiterate,158702,340729,499431
3675,6,State - HARYANA,Total,50-54,Illiterate,137487,279134,416621
3676,6,State - HARYANA,Total,55-59,Illiterate,98511,248879,347390
3677,6,State - HARYANA,Total,60-64,Illiterate,155916,321791,477707
3678,6,State - HARYANA,Total,65-69,Illiterate,107047,193746,300793
3679,6,State - HARYANA,Total,70-74,Illiterate,95377,152516,247893
3680,6,State - HARYANA,Total,75-79,Illiterate,53054,82353,135407
3681,6,State - HARYANA,Total,80+,Illiterate,82416,119764,202180
3682,6,State - HARYANA,Total,Age not stated,Illiterate,5002,6210,11212
3683,6,State - HARYANA,Rural,All ages,Illiterate,2633907,3717010,6350917
3684,6,State - HARYANA,Rural,0-6,Illiterate,1245090,1040022,2285112
3685,6,State - HARYANA,Rural,7,Illiterate,36275,33974,70249
3686,6,State - HARYANA,Rural,8,Illiterate,18716,20016,38732
3687,6,State - HARYANA,Rural,9,Illiterate,11599,13036,24635
3688,6,State - HARYANA,Rural,10,Illiterate,15222,17651,32873
3689,6,State - HARYANA,Rural,11,Illiterate,8710,11409,20119
3690,6,State - HARYANA,Rural,12,Illiterate,9417,13560,22977
3691,6,State - HARYANA,Rural,13,Illiterate,7621,11968,19589
3692,6,State - HARYANA,Rural,14,Illiterate,9105,14274,23379
3693,6,State - HARYANA,Rural,15,Illiterate,11313,16292,27605
3694,6,State - HARYANA,Rural,16,Illiterate,11629,16877,28506
3695,6,State - HARYANA,Rural,17,Illiterate,9970,14714,24684
3696,6,State - HARYANA,Rural,18,Illiterate,16912,24782,41694
3697,6,State - HARYANA,Rural,19,Illiterate,10773,19098,29871
3698,6,State - HARYANA,Rural,20-24,Illiterate,74424,143144,217568
3699,6,State - HARYANA,Rural,25-29,Illiterate,82768,170002,252770
3700,6,State - HARYANA,Rural,30-34,Illiterate,90725,210425,301150
3701,6,State - HARYANA,Rural,35-39,Illiterate,111676,269900,381576
3702,6,State - HARYANA,Rural,40-44,Illiterate,129780,289163,418943
3703,6,State - HARYANA,Rural,45-49,Illiterate,120572,262141,382713
3704,6,State - HARYANA,Rural,50-54,Illiterate,106682,215741,322423
3705,6,State - HARYANA,Rural,55-59,Illiterate,77818,194695,272513
3706,6,State - HARYANA,Rural,60-64,Illiterate,128585,258600,387185
3707,6,State - HARYANA,Rural,65-69,Illiterate,89476,154236,243712
3708,6,State - HARYANA,Rural,70-74,Illiterate,80106,119871,199977
3709,6,State - HARYANA,Rural,75-79,Illiterate,45291,64392,109683
3710,6,State - HARYANA,Rural,80+,Illiterate,70128,92558,162686
3711,6,State - HARYANA,Rural,Age not stated,Illiterate,3524,4469,7993
3712,6,State - HARYANA,Urban,All ages,Illiterate,1066760,1334797,2401557
3713,6,State - HARYANA,Urban,0-6,Illiterate,598019,497590,1095609
3714,6,State - HARYANA,Urban,7,Illiterate,17839,16120,33959
3715,6,State - HARYANA,Urban,8,Illiterate,9884,9384,19268
3716,6,State - HARYANA,Urban,9,Illiterate,6727,6485,13212
3717,6,State - HARYANA,Urban,10,Illiterate,8969,8489,17458
3718,6,State - HARYANA,Urban,11,Illiterate,5244,5104,10348
3719,6,State - HARYANA,Urban,12,Illiterate,5662,5585,11247
3720,6,State - HARYANA,Urban,13,Illiterate,4514,4715,9229
3721,6,State - HARYANA,Urban,14,Illiterate,5004,5342,10346
3722,6,State - HARYANA,Urban,15,Illiterate,6556,5992,12548
3723,6,State - HARYANA,Urban,16,Illiterate,6233,6001,12234
3724,6,State - HARYANA,Urban,17,Illiterate,5680,5155,10835
3725,6,State - HARYANA,Urban,18,Illiterate,9051,8632,17683
3726,6,State - HARYANA,Urban,19,Illiterate,6067,6784,12851
3727,6,State - HARYANA,Urban,20-24,Illiterate,37200,53560,90760
3728,6,State - HARYANA,Urban,25-29,Illiterate,38829,66619,105448
3729,6,State - HARYANA,Urban,30-34,Illiterate,37972,73016,110988
3730,6,State - HARYANA,Urban,35-39,Illiterate,43071,87293,130364
3731,6,State - HARYANA,Urban,40-44,Illiterate,42909,84512,127421
3732,6,State - HARYANA,Urban,45-49,Illiterate,38130,78588,116718
3733,6,State - HARYANA,Urban,50-54,Illiterate,30805,63393,94198
3734,6,State - HARYANA,Urban,55-59,Illiterate,20693,54184,74877
3735,6,State - HARYANA,Urban,60-64,Illiterate,27331,63191,90522
3736,6,State - HARYANA,Urban,65-69,Illiterate,17571,39510,57081
3737,6,State - HARYANA,Urban,70-74,Illiterate,15271,32645,47916
3738,6,State - HARYANA,Urban,75-79,Illiterate,7763,17961,25724
3739,6,State - HARYANA,Urban,80+,Illiterate,12288,27206,39494
3740,6,State - HARYANA,Urban,Age not stated,Illiterate,1478,1741,3219
3741,7,State - NCT OF DELHI,Total,All ages,Illiterate,1792470,2257704,4050174
3742,7,State - NCT OF DELHI,Total,0-6,Illiterate,1075440,937014,2012454
3743,7,State - NCT OF DELHI,Total,7,Illiterate,32432,28707,61139
3744,7,State - NCT OF DELHI,Total,8,Illiterate,13845,12378,26223
3745,7,State - NCT OF DELHI,Total,9,Illiterate,9693,8867,18560
3746,7,State - NCT OF DELHI,Total,10,Illiterate,13003,11689,24692
3747,7,State - NCT OF DELHI,Total,11,Illiterate,6945,6464,13409
3748,7,State - NCT OF DELHI,Total,12,Illiterate,6794,6322,13116
3749,7,State - NCT OF DELHI,Total,13,Illiterate,5292,5431,10723
3750,7,State - NCT OF DELHI,Total,14,Illiterate,6086,6271,12357
3751,7,State - NCT OF DELHI,Total,15,Illiterate,8500,7684,16184
3752,7,State - NCT OF DELHI,Total,16,Illiterate,8581,7572,16153
3753,7,State - NCT OF DELHI,Total,17,Illiterate,7958,6908,14866
3754,7,State - NCT OF DELHI,Total,18,Illiterate,14673,11968,26641
3755,7,State - NCT OF DELHI,Total,19,Illiterate,8973,8869,17842
3756,7,State - NCT OF DELHI,Total,20-24,Illiterate,60344,82481,142825
3757,7,State - NCT OF DELHI,Total,25-29,Illiterate,64269,114162,178431
3758,7,State - NCT OF DELHI,Total,30-34,Illiterate,63846,131620,195466
3759,7,State - NCT OF DELHI,Total,35-39,Illiterate,73023,155945,228968
3760,7,State - NCT OF DELHI,Total,40-44,Illiterate,71456,146047,217503
3761,7,State - NCT OF DELHI,Total,45-49,Illiterate,62862,126972,189834
3762,7,State - NCT OF DELHI,Total,50-54,Illiterate,46567,95390,141957
3763,7,State - NCT OF DELHI,Total,55-59,Illiterate,30553,80476,111029
3764,7,State - NCT OF DELHI,Total,60-64,Illiterate,40586,101800,142386
3765,7,State - NCT OF DELHI,Total,65-69,Illiterate,22430,57031,79461
3766,7,State - NCT OF DELHI,Total,70-74,Illiterate,16797,43849,60646
3767,7,State - NCT OF DELHI,Total,75-79,Illiterate,7752,22387,30139
3768,7,State - NCT OF DELHI,Total,80+,Illiterate,11583,30952,42535
3769,7,State - NCT OF DELHI,Total,Age not stated,Illiterate,2187,2448,4635
3770,7,State - NCT OF DELHI,Rural,All ages,Illiterate,51994,70448,122442
3771,7,State - NCT OF DELHI,Rural,0-6,Illiterate,31259,25457,56716
3772,7,State - NCT OF DELHI,Rural,7,Illiterate,898,745,1643
3773,7,State - NCT OF DELHI,Rural,8,Illiterate,382,337,719
3774,7,State - NCT OF DELHI,Rural,9,Illiterate,277,230,507
3775,7,State - NCT OF DELHI,Rural,10,Illiterate,383,355,738
3776,7,State - NCT OF DELHI,Rural,11,Illiterate,186,202,388
3777,7,State - NCT OF DELHI,Rural,12,Illiterate,179,209,388
3778,7,State - NCT OF DELHI,Rural,13,Illiterate,127,141,268
3779,7,State - NCT OF DELHI,Rural,14,Illiterate,161,195,356
3780,7,State - NCT OF DELHI,Rural,15,Illiterate,226,269,495
3781,7,State - NCT OF DELHI,Rural,16,Illiterate,226,230,456
3782,7,State - NCT OF DELHI,Rural,17,Illiterate,232,211,443
3783,7,State - NCT OF DELHI,Rural,18,Illiterate,409,425,834
3784,7,State - NCT OF DELHI,Rural,19,Illiterate,234,304,538
3785,7,State - NCT OF DELHI,Rural,20-24,Illiterate,1527,2588,4115
3786,7,State - NCT OF DELHI,Rural,25-29,Illiterate,1604,3348,4952
3787,7,State - NCT OF DELHI,Rural,30-34,Illiterate,1604,4059,5663
3788,7,State - NCT OF DELHI,Rural,35-39,Illiterate,1934,4954,6888
3789,7,State - NCT OF DELHI,Rural,40-44,Illiterate,2196,4997,7193
3790,7,State - NCT OF DELHI,Rural,45-49,Illiterate,1822,4219,6041
3791,7,State - NCT OF DELHI,Rural,50-54,Illiterate,1312,3458,4770
3792,7,State - NCT OF DELHI,Rural,55-59,Illiterate,867,2942,3809
3793,7,State - NCT OF DELHI,Rural,60-64,Illiterate,1275,4157,5432
3794,7,State - NCT OF DELHI,Rural,65-69,Illiterate,750,2310,3060
3795,7,State - NCT OF DELHI,Rural,70-74,Illiterate,650,1779,2429
3796,7,State - NCT OF DELHI,Rural,75-79,Illiterate,376,936,1312
3797,7,State - NCT OF DELHI,Rural,80+,Illiterate,807,1307,2114
3798,7,State - NCT OF DELHI,Rural,Age not stated,Illiterate,91,84,175
3799,7,State - NCT OF DELHI,Urban,All ages,Illiterate,1740476,2187256,3927732
3800,7,State - NCT OF DELHI,Urban,0-6,Illiterate,1044181,911557,1955738
3801,7,State - NCT OF DELHI,Urban,7,Illiterate,31534,27962,59496
3802,7,State - NCT OF DELHI,Urban,8,Illiterate,13463,12041,25504
3803,7,State - NCT OF DELHI,Urban,9,Illiterate,9416,8637,18053
3804,7,State - NCT OF DELHI,Urban,10,Illiterate,12620,11334,23954
3805,7,State - NCT OF DELHI,Urban,11,Illiterate,6759,6262,13021
3806,7,State - NCT OF DELHI,Urban,12,Illiterate,6615,6113,12728
3807,7,State - NCT OF DELHI,Urban,13,Illiterate,5165,5290,10455
3808,7,State - NCT OF DELHI,Urban,14,Illiterate,5925,6076,12001
3809,7,State - NCT OF DELHI,Urban,15,Illiterate,8274,7415,15689
3810,7,State - NCT OF DELHI,Urban,16,Illiterate,8355,7342,15697
3811,7,State - NCT OF DELHI,Urban,17,Illiterate,7726,6697,14423
3812,7,State - NCT OF DELHI,Urban,18,Illiterate,14264,11543,25807
3813,7,State - NCT OF DELHI,Urban,19,Illiterate,8739,8565,17304
3814,7,State - NCT OF DELHI,Urban,20-24,Illiterate,58817,79893,138710
3815,7,State - NCT OF DELHI,Urban,25-29,Illiterate,62665,110814,173479
3816,7,State - NCT OF DELHI,Urban,30-34,Illiterate,62242,127561,189803
3817,7,State - NCT OF DELHI,Urban,35-39,Illiterate,71089,150991,222080
3818,7,State - NCT OF DELHI,Urban,40-44,Illiterate,69260,141050,210310
3819,7,State - NCT OF DELHI,Urban,45-49,Illiterate,61040,122753,183793
3820,7,State - NCT OF DELHI,Urban,50-54,Illiterate,45255,91932,137187
3821,7,State - NCT OF DELHI,Urban,55-59,Illiterate,29686,77534,107220
3822,7,State - NCT OF DELHI,Urban,60-64,Illiterate,39311,97643,136954
3823,7,State - NCT OF DELHI,Urban,65-69,Illiterate,21680,54721,76401
3824,7,State - NCT OF DELHI,Urban,70-74,Illiterate,16147,42070,58217
3825,7,State - NCT OF DELHI,Urban,75-79,Illiterate,7376,21451,28827
3826,7,State - NCT OF DELHI,Urban,80+,Illiterate,10776,29645,40421
3827,7,State - NCT OF DELHI,Urban,Age not stated,Illiterate,2096,2364,4460
3828,8,State - RAJASTHAN,Total,All ages,Illiterate,11862585,18410570,30273155
3829,8,State - RAJASTHAN,Total,0-6,Illiterate,5639176,5010328,10649504
3830,8,State - RAJASTHAN,Total,7,Illiterate,221803,238913,460716
3831,8,State - RAJASTHAN,Total,8,Illiterate,131326,169901,301227
3832,8,State - RAJASTHAN,Total,9,Illiterate,67923,96907,164830
3833,8,State - RAJASTHAN,Total,10,Illiterate,99137,150735,249872
3834,8,State - RAJASTHAN,Total,11,Illiterate,50187,88051,138238
3835,8,State - RAJASTHAN,Total,12,Illiterate,64001,125709,189710
3836,8,State - RAJASTHAN,Total,13,Illiterate,45740,102522,148262
3837,8,State - RAJASTHAN,Total,14,Illiterate,49330,112511,161841
3838,8,State - RAJASTHAN,Total,15,Illiterate,63517,133860,197377
3839,8,State - RAJASTHAN,Total,16,Illiterate,59600,134177,193777
3840,8,State - RAJASTHAN,Total,17,Illiterate,42996,104965,147961
3841,8,State - RAJASTHAN,Total,18,Illiterate,82869,220078,302947
3842,8,State - RAJASTHAN,Total,19,Illiterate,43391,146060,189451
3843,8,State - RAJASTHAN,Total,20-24,Illiterate,359330,1118943,1478273
3844,8,State - RAJASTHAN,Total,25-29,Illiterate,410620,1253542,1664162
3845,8,State - RAJASTHAN,Total,30-34,Illiterate,459975,1353734,1813709
3846,8,State - RAJASTHAN,Total,35-39,Illiterate,536668,1391886,1928554
3847,8,State - RAJASTHAN,Total,40-44,Illiterate,594410,1271936,1866346
3848,8,State - RAJASTHAN,Total,45-49,Illiterate,565221,1139997,1705218
3849,8,State - RAJASTHAN,Total,50-54,Illiterate,533298,893242,1426540
3850,8,State - RAJASTHAN,Total,55-59,Illiterate,376173,765748,1141921
3851,8,State - RAJASTHAN,Total,60-64,Illiterate,435178,739213,1174391
3852,8,State - RAJASTHAN,Total,65-69,Illiterate,307468,576521,883989
3853,8,State - RAJASTHAN,Total,70-74,Illiterate,296348,468771,765119
3854,8,State - RAJASTHAN,Total,75-79,Illiterate,125960,232231,358191
3855,8,State - RAJASTHAN,Total,80+,Illiterate,158803,298093,456896
3856,8,State - RAJASTHAN,Total,Age not stated,Illiterate,42137,71996,114133
3857,8,State - RAJASTHAN,Rural,All ages,Illiterate,9737158,15291408,25028566
3858,8,State - RAJASTHAN,Rural,0-6,Illiterate,4446599,3968284,8414883
3859,8,State - RAJASTHAN,Rural,7,Illiterate,179076,196855,375931
3860,8,State - RAJASTHAN,Rural,8,Illiterate,106434,142825,249259
3861,8,State - RAJASTHAN,Rural,9,Illiterate,52846,80209,133055
3862,8,State - RAJASTHAN,Rural,10,Illiterate,77340,126245,203585
3863,8,State - RAJASTHAN,Rural,11,Illiterate,37955,73286,111241
3864,8,State - RAJASTHAN,Rural,12,Illiterate,48905,106855,155760
3865,8,State - RAJASTHAN,Rural,13,Illiterate,34300,86317,120617
3866,8,State - RAJASTHAN,Rural,14,Illiterate,37268,95179,132447
3867,8,State - RAJASTHAN,Rural,15,Illiterate,48052,113009,161061
3868,8,State - RAJASTHAN,Rural,16,Illiterate,45242,114267,159509
3869,8,State - RAJASTHAN,Rural,17,Illiterate,31354,88282,119636
3870,8,State - RAJASTHAN,Rural,18,Illiterate,62882,189768,252650
3871,8,State - RAJASTHAN,Rural,19,Illiterate,32097,125351,157448
3872,8,State - RAJASTHAN,Rural,20-24,Illiterate,283359,961015,1244374
3873,8,State - RAJASTHAN,Rural,25-29,Illiterate,337349,1072816,1410165
3874,8,State - RAJASTHAN,Rural,30-34,Illiterate,386658,1154072,1540730
3875,8,State - RAJASTHAN,Rural,35-39,Illiterate,456634,1175510,1632144
3876,8,State - RAJASTHAN,Rural,40-44,Illiterate,513986,1071056,1585042
3877,8,State - RAJASTHAN,Rural,45-49,Illiterate,493627,956095,1449722
3878,8,State - RAJASTHAN,Rural,50-54,Illiterate,470047,747359,1217406
3879,8,State - RAJASTHAN,Rural,55-59,Illiterate,334733,645702,980435
3880,8,State - RAJASTHAN,Rural,60-64,Illiterate,389716,624073,1013789
3881,8,State - RAJASTHAN,Rural,65-69,Illiterate,276436,487550,763986
3882,8,State - RAJASTHAN,Rural,70-74,Illiterate,266345,392817,659162
3883,8,State - RAJASTHAN,Rural,75-79,Illiterate,112624,193198,305822
3884,8,State - RAJASTHAN,Rural,80+,Illiterate,139377,241584,380961
3885,8,State - RAJASTHAN,Rural,Age not stated,Illiterate,35917,61829,97746
3886,8,State - RAJASTHAN,Urban,All ages,Illiterate,2125427,3119162,5244589
3887,8,State - RAJASTHAN,Urban,0-6,Illiterate,1192577,1042044,2234621
3888,8,State - RAJASTHAN,Urban,7,Illiterate,42727,42058,84785
3889,8,State - RAJASTHAN,Urban,8,Illiterate,24892,27076,51968
3890,8,State - RAJASTHAN,Urban,9,Illiterate,15077,16698,31775
3891,8,State - RAJASTHAN,Urban,10,Illiterate,21797,24490,46287
3892,8,State - RAJASTHAN,Urban,11,Illiterate,12232,14765,26997
3893,8,State - RAJASTHAN,Urban,12,Illiterate,15096,18854,33950
3894,8,State - RAJASTHAN,Urban,13,Illiterate,11440,16205,27645
3895,8,State - RAJASTHAN,Urban,14,Illiterate,12062,17332,29394
3896,8,State - RAJASTHAN,Urban,15,Illiterate,15465,20851,36316
3897,8,State - RAJASTHAN,Urban,16,Illiterate,14358,19910,34268
3898,8,State - RAJASTHAN,Urban,17,Illiterate,11642,16683,28325
3899,8,State - RAJASTHAN,Urban,18,Illiterate,19987,30310,50297
3900,8,State - RAJASTHAN,Urban,19,Illiterate,11294,20709,32003
3901,8,State - RAJASTHAN,Urban,20-24,Illiterate,75971,157928,233899
3902,8,State - RAJASTHAN,Urban,25-29,Illiterate,73271,180726,253997
3903,8,State - RAJASTHAN,Urban,30-34,Illiterate,73317,199662,272979
3904,8,State - RAJASTHAN,Urban,35-39,Illiterate,80034,216376,296410
3905,8,State - RAJASTHAN,Urban,40-44,Illiterate,80424,200880,281304
3906,8,State - RAJASTHAN,Urban,45-49,Illiterate,71594,183902,255496
3907,8,State - RAJASTHAN,Urban,50-54,Illiterate,63251,145883,209134
3908,8,State - RAJASTHAN,Urban,55-59,Illiterate,41440,120046,161486
3909,8,State - RAJASTHAN,Urban,60-64,Illiterate,45462,115140,160602
3910,8,State - RAJASTHAN,Urban,65-69,Illiterate,31032,88971,120003
3911,8,State - RAJASTHAN,Urban,70-74,Illiterate,30003,75954,105957
3912,8,State - RAJASTHAN,Urban,75-79,Illiterate,13336,39033,52369
3913,8,State - RAJASTHAN,Urban,80+,Illiterate,19426,56509,75935
3914,8,State - RAJASTHAN,Urban,Age not stated,Illiterate,6220,10167,16387
3915,9,State - UTTAR PRADESH,Total,All ages,Illiterate,36245546,49169240,85414786
3916,9,State - UTTAR PRADESH,Total,0-6,Illiterate,16185581,14605750,30791331
3917,9,State - UTTAR PRADESH,Total,7,Illiterate,725690,719625,1445315
3918,9,State - UTTAR PRADESH,Total,8,Illiterate,527798,542328,1070126
3919,9,State - UTTAR PRADESH,Total,9,Illiterate,316578,332627,649205
3920,9,State - UTTAR PRADESH,Total,10,Illiterate,468574,484310,952884
3921,9,State - UTTAR PRADESH,Total,11,Illiterate,260240,283266,543506
3922,9,State - UTTAR PRADESH,Total,12,Illiterate,297942,336254,634196
3923,9,State - UTTAR PRADESH,Total,13,Illiterate,212818,261322,474140
3924,9,State - UTTAR PRADESH,Total,14,Illiterate,259613,322383,581996
3925,9,State - UTTAR PRADESH,Total,15,Illiterate,321769,379099,700868
3926,9,State - UTTAR PRADESH,Total,16,Illiterate,302979,384579,687558
3927,9,State - UTTAR PRADESH,Total,17,Illiterate,230927,305609,536536
3928,9,State - UTTAR PRADESH,Total,18,Illiterate,407326,542907,950233
3929,9,State - UTTAR PRADESH,Total,19,Illiterate,230475,363253,593728
3930,9,State - UTTAR PRADESH,Total,20-24,Illiterate,1409787,2605442,4015229
3931,9,State - UTTAR PRADESH,Total,25-29,Illiterate,1451516,3155047,4606563
3932,9,State - UTTAR PRADESH,Total,30-34,Illiterate,1524785,3467556,4992341
3933,9,State - UTTAR PRADESH,Total,35-39,Illiterate,1741651,3663740,5405391
3934,9,State - UTTAR PRADESH,Total,40-44,Illiterate,1657418,3073943,4731361
3935,9,State - UTTAR PRADESH,Total,45-49,Illiterate,1394811,2738641,4133452
3936,9,State - UTTAR PRADESH,Total,50-54,Illiterate,1244378,2090550,3334928
3937,9,State - UTTAR PRADESH,Total,55-59,Illiterate,919781,2132368,3052149
3938,9,State - UTTAR PRADESH,Total,60-64,Illiterate,1338395,2181862,3520257
3939,9,State - UTTAR PRADESH,Total,65-69,Illiterate,925447,1538789,2464236
3940,9,State - UTTAR PRADESH,Total,70-74,Illiterate,812415,1093113,1905528
3941,9,State - UTTAR PRADESH,Total,75-79,Illiterate,324568,509902,834470
3942,9,State - UTTAR PRADESH,Total,80+,Illiterate,484323,686345,1170668
3943,9,State - UTTAR PRADESH,Total,Age not stated,Illiterate,267961,368630,636591
3944,9,State - UTTAR PRADESH,Rural,All ages,Illiterate,29199307,40833291,70032598
3945,9,State - UTTAR PRADESH,Rural,0-6,Illiterate,13135595,11904988,25040583
3946,9,State - UTTAR PRADESH,Rural,7,Illiterate,575936,575771,1151707
3947,9,State - UTTAR PRADESH,Rural,8,Illiterate,409046,427455,836501
3948,9,State - UTTAR PRADESH,Rural,9,Illiterate,235152,254461,489613
3949,9,State - UTTAR PRADESH,Rural,10,Illiterate,351273,373947,725220
3950,9,State - UTTAR PRADESH,Rural,11,Illiterate,185758,212437,398195
3951,9,State - UTTAR PRADESH,Rural,12,Illiterate,210627,254692,465319
3952,9,State - UTTAR PRADESH,Rural,13,Illiterate,146840,195691,342531
3953,9,State - UTTAR PRADESH,Rural,14,Illiterate,179261,241428,420689
3954,9,State - UTTAR PRADESH,Rural,15,Illiterate,231767,291830,523597
3955,9,State - UTTAR PRADESH,Rural,16,Illiterate,211659,293741,505400
3956,9,State - UTTAR PRADESH,Rural,17,Illiterate,156469,233374,389843
3957,9,State - UTTAR PRADESH,Rural,18,Illiterate,286564,431146,717710
3958,9,State - UTTAR PRADESH,Rural,19,Illiterate,156081,288250,444331
3959,9,State - UTTAR PRADESH,Rural,20-24,Illiterate,1011779,2154824,3166603
3960,9,State - UTTAR PRADESH,Rural,25-29,Illiterate,1121161,2675463,3796624
3961,9,State - UTTAR PRADESH,Rural,30-34,Illiterate,1225505,2971018,4196523
3962,9,State - UTTAR PRADESH,Rural,35-39,Illiterate,1418928,3111762,4530690
3963,9,State - UTTAR PRADESH,Rural,40-44,Illiterate,1353672,2586626,3940298
3964,9,State - UTTAR PRADESH,Rural,45-49,Illiterate,1141908,2298612,3440520
3965,9,State - UTTAR PRADESH,Rural,50-54,Illiterate,1038698,1753616,2792314
3966,9,State - UTTAR PRADESH,Rural,55-59,Illiterate,778009,1822975,2600984
3967,9,State - UTTAR PRADESH,Rural,60-64,Illiterate,1167531,1882464,3049995
3968,9,State - UTTAR PRADESH,Rural,65-69,Illiterate,822866,1340440,2163306
3969,9,State - UTTAR PRADESH,Rural,70-74,Illiterate,727785,944109,1671894
3970,9,State - UTTAR PRADESH,Rural,75-79,Illiterate,290032,440749,730781
3971,9,State - UTTAR PRADESH,Rural,80+,Illiterate,427162,581889,1009051
3972,9,State - UTTAR PRADESH,Rural,Age not stated,Illiterate,202243,289533,491776
3973,9,State - UTTAR PRADESH,Urban,All ages,Illiterate,7046239,8335949,15382188
3974,9,State - UTTAR PRADESH,Urban,0-6,Illiterate,3049986,2700762,5750748
3975,9,State - UTTAR PRADESH,Urban,7,Illiterate,149754,143854,293608
3976,9,State - UTTAR PRADESH,Urban,8,Illiterate,118752,114873,233625
3977,9,State - UTTAR PRADESH,Urban,9,Illiterate,81426,78166,159592
3978,9,State - UTTAR PRADESH,Urban,10,Illiterate,117301,110363,227664
3979,9,State - UTTAR PRADESH,Urban,11,Illiterate,74482,70829,145311
3980,9,State - UTTAR PRADESH,Urban,12,Illiterate,87315,81562,168877
3981,9,State - UTTAR PRADESH,Urban,13,Illiterate,65978,65631,131609
3982,9,State - UTTAR PRADESH,Urban,14,Illiterate,80352,80955,161307
3983,9,State - UTTAR PRADESH,Urban,15,Illiterate,90002,87269,177271
3984,9,State - UTTAR PRADESH,Urban,16,Illiterate,91320,90838,182158
3985,9,State - UTTAR PRADESH,Urban,17,Illiterate,74458,72235,146693
3986,9,State - UTTAR PRADESH,Urban,18,Illiterate,120762,111761,232523
3987,9,State - UTTAR PRADESH,Urban,19,Illiterate,74394,75003,149397
3988,9,State - UTTAR PRADESH,Urban,20-24,Illiterate,398008,450618,848626
3989,9,State - UTTAR PRADESH,Urban,25-29,Illiterate,330355,479584,809939
3990,9,State - UTTAR PRADESH,Urban,30-34,Illiterate,299280,496538,795818
3991,9,State - UTTAR PRADESH,Urban,35-39,Illiterate,322723,551978,874701
3992,9,State - UTTAR PRADESH,Urban,40-44,Illiterate,303746,487317,791063
3993,9,State - UTTAR PRADESH,Urban,45-49,Illiterate,252903,440029,692932
3994,9,State - UTTAR PRADESH,Urban,50-54,Illiterate,205680,336934,542614
3995,9,State - UTTAR PRADESH,Urban,55-59,Illiterate,141772,309393,451165
3996,9,State - UTTAR PRADESH,Urban,60-64,Illiterate,170864,299398,470262
3997,9,State - UTTAR PRADESH,Urban,65-69,Illiterate,102581,198349,300930
3998,9,State - UTTAR PRADESH,Urban,70-74,Illiterate,84630,149004,233634
3999,9,State - UTTAR PRADESH,Urban,75-79,Illiterate,34536,69153,103689
4000,9,State - UTTAR PRADESH,Urban,80+,Illiterate,57161,104456,161617
4001,9,State - UTTAR PRADESH,Urban,Age not stated,Illiterate,65718,79097,144815
4002,10,State - BIHAR,Total,All ages,Illiterate,22670134,28924765,51594899
4003,10,State - BIHAR,Total,0-6,Illiterate,9887239,9246725,19133964
4004,10,State - BIHAR,Total,7,Illiterate,491296,513735,1005031
4005,10,State - BIHAR,Total,8,Illiterate,397464,437761,835225
4006,10,State - BIHAR,Total,9,Illiterate,225574,256086,481660
4007,10,State - BIHAR,Total,10,Illiterate,348151,389761,737912
4008,10,State - BIHAR,Total,11,Illiterate,176833,206449,383282
4009,10,State - BIHAR,Total,12,Illiterate,229297,276765,506062
4010,10,State - BIHAR,Total,13,Illiterate,140611,180111,320722
4011,10,State - BIHAR,Total,14,Illiterate,168787,206606,375393
4012,10,State - BIHAR,Total,15,Illiterate,220928,236764,457692
4013,10,State - BIHAR,Total,16,Illiterate,200069,215357,415426
4014,10,State - BIHAR,Total,17,Illiterate,133321,152092,285413
4015,10,State - BIHAR,Total,18,Illiterate,267942,325589,593531
4016,10,State - BIHAR,Total,19,Illiterate,140293,241821,382114
4017,10,State - BIHAR,Total,20-24,Illiterate,979683,1746112,2725795
4018,10,State - BIHAR,Total,25-29,Illiterate,1071700,2013722,3085422
4019,10,State - BIHAR,Total,30-34,Illiterate,1099413,2007990,3107403
4020,10,State - BIHAR,Total,35-39,Illiterate,1134401,1936389,3070790
4021,10,State - BIHAR,Total,40-44,Illiterate,1044660,1588699,2633359
4022,10,State - BIHAR,Total,45-49,Illiterate,882493,1458624,2341117
4023,10,State - BIHAR,Total,50-54,Illiterate,786208,1100658,1886866
4024,10,State - BIHAR,Total,55-59,Illiterate,550956,1135750,1686706
4025,10,State - BIHAR,Total,60-64,Illiterate,747044,1165325,1912369
4026,10,State - BIHAR,Total,65-69,Illiterate,530410,813877,1344287
4027,10,State - BIHAR,Total,70-74,Illiterate,410352,505184,915536
4028,10,State - BIHAR,Total,75-79,Illiterate,143830,212083,355913
4029,10,State - BIHAR,Total,80+,Illiterate,180367,256762,437129
4030,10,State - BIHAR,Total,Age not stated,Illiterate,80812,97968,178780
4031,10,State - BIHAR,Rural,All ages,Illiterate,20832020,26697264,47529284
4032,10,State - BIHAR,Rural,0-6,Illiterate,8971671,8412030,17383701
4033,10,State - BIHAR,Rural,7,Illiterate,451002,473411,924413
4034,10,State - BIHAR,Rural,8,Illiterate,366289,406228,772517
4035,10,State - BIHAR,Rural,9,Illiterate,207546,237610,445156
4036,10,State - BIHAR,Rural,10,Illiterate,319494,361862,681356
4037,10,State - BIHAR,Rural,11,Illiterate,162211,191546,353757
4038,10,State - BIHAR,Rural,12,Illiterate,209888,257532,467420
4039,10,State - BIHAR,Rural,13,Illiterate,128601,167657,296258
4040,10,State - BIHAR,Rural,14,Illiterate,153672,191680,345352
4041,10,State - BIHAR,Rural,15,Illiterate,202424,220193,422617
4042,10,State - BIHAR,Rural,16,Illiterate,182260,199523,381783
4043,10,State - BIHAR,Rural,17,Illiterate,120644,140398,261042
4044,10,State - BIHAR,Rural,18,Illiterate,243472,302267,545739
4045,10,State - BIHAR,Rural,19,Illiterate,127623,226405,354028
4046,10,State - BIHAR,Rural,20-24,Illiterate,899008,1635760,2534768
4047,10,State - BIHAR,Rural,25-29,Illiterate,993748,1885424,2879172
4048,10,State - BIHAR,Rural,30-34,Illiterate,1022621,1879135,2901756
4049,10,State - BIHAR,Rural,35-39,Illiterate,1057044,1803924,2860968
4050,10,State - BIHAR,Rural,40-44,Illiterate,971759,1473427,2445186
4051,10,State - BIHAR,Rural,45-49,Illiterate,822993,1350480,2173473
4052,10,State - BIHAR,Rural,50-54,Illiterate,734593,1013600,1748193
4053,10,State - BIHAR,Rural,55-59,Illiterate,516581,1052798,1569379
4054,10,State - BIHAR,Rural,60-64,Illiterate,701857,1077871,1779728
4055,10,State - BIHAR,Rural,65-69,Illiterate,500398,754576,1254974
4056,10,State - BIHAR,Rural,70-74,Illiterate,386372,464228,850600
4057,10,State - BIHAR,Rural,75-79,Illiterate,135410,194870,330280
4058,10,State - BIHAR,Rural,80+,Illiterate,168949,233410,402359
4059,10,State - BIHAR,Rural,Age not stated,Illiterate,73890,89419,163309
4060,10,State - BIHAR,Urban,All ages,Illiterate,1838114,2227501,4065615
4061,10,State - BIHAR,Urban,0-6,Illiterate,915568,834695,1750263
4062,10,State - BIHAR,Urban,7,Illiterate,40294,40324,80618
4063,10,State - BIHAR,Urban,8,Illiterate,31175,31533,62708
4064,10,State - BIHAR,Urban,9,Illiterate,18028,18476,36504
4065,10,State - BIHAR,Urban,10,Illiterate,28657,27899,56556
4066,10,State - BIHAR,Urban,11,Illiterate,14622,14903,29525
4067,10,State - BIHAR,Urban,12,Illiterate,19409,19233,38642
4068,10,State - BIHAR,Urban,13,Illiterate,12010,12454,24464
4069,10,State - BIHAR,Urban,14,Illiterate,15115,14926,30041
4070,10,State - BIHAR,Urban,15,Illiterate,18504,16571,35075
4071,10,State - BIHAR,Urban,16,Illiterate,17809,15834,33643
4072,10,State - BIHAR,Urban,17,Illiterate,12677,11694,24371
4073,10,State - BIHAR,Urban,18,Illiterate,24470,23322,47792
4074,10,State - BIHAR,Urban,19,Illiterate,12670,15416,28086
4075,10,State - BIHAR,Urban,20-24,Illiterate,80675,110352,191027
4076,10,State - BIHAR,Urban,25-29,Illiterate,77952,128298,206250
4077,10,State - BIHAR,Urban,30-34,Illiterate,76792,128855,205647
4078,10,State - BIHAR,Urban,35-39,Illiterate,77357,132465,209822
4079,10,State - BIHAR,Urban,40-44,Illiterate,72901,115272,188173
4080,10,State - BIHAR,Urban,45-49,Illiterate,59500,108144,167644
4081,10,State - BIHAR,Urban,50-54,Illiterate,51615,87058,138673
4082,10,State - BIHAR,Urban,55-59,Illiterate,34375,82952,117327
4083,10,State - BIHAR,Urban,60-64,Illiterate,45187,87454,132641
4084,10,State - BIHAR,Urban,65-69,Illiterate,30012,59301,89313
4085,10,State - BIHAR,Urban,70-74,Illiterate,23980,40956,64936
4086,10,State - BIHAR,Urban,75-79,Illiterate,8420,17213,25633
4087,10,State - BIHAR,Urban,80+,Illiterate,11418,23352,34770
4088,10,State - BIHAR,Urban,Age not stated,Illiterate,6922,8549,15471
4089,11,State - SIKKIM,Total,All ages,Illiterate,71801,93824,165625
4090,11,State - SIKKIM,Total,0-6,Illiterate,32761,31350,64111
4091,11,State - SIKKIM,Total,7,Illiterate,1304,1260,2564
4092,11,State - SIKKIM,Total,8,Illiterate,599,548,1147
4093,11,State - SIKKIM,Total,9,Illiterate,604,574,1178
4094,11,State - SIKKIM,Total,10,Illiterate,551,558,1109
4095,11,State - SIKKIM,Total,11,Illiterate,347,316,663
4096,11,State - SIKKIM,Total,12,Illiterate,236,238,474
4097,11,State - SIKKIM,Total,13,Illiterate,234,236,470
4098,11,State - SIKKIM,Total,14,Illiterate,232,265,497
4099,11,State - SIKKIM,Total,15,Illiterate,292,333,625
4100,11,State - SIKKIM,Total,16,Illiterate,282,327,609
4101,11,State - SIKKIM,Total,17,Illiterate,290,320,610
4102,11,State - SIKKIM,Total,18,Illiterate,393,398,791
4103,11,State - SIKKIM,Total,19,Illiterate,302,359,661
4104,11,State - SIKKIM,Total,20-24,Illiterate,1910,2573,4483
4105,11,State - SIKKIM,Total,25-29,Illiterate,2349,3820,6169
4106,11,State - SIKKIM,Total,30-34,Illiterate,2305,4425,6730
4107,11,State - SIKKIM,Total,35-39,Illiterate,2535,5589,8124
4108,11,State - SIKKIM,Total,40-44,Illiterate,2948,6602,9550
4109,11,State - SIKKIM,Total,45-49,Illiterate,3430,6963,10393
4110,11,State - SIKKIM,Total,50-54,Illiterate,3817,6623,10440
4111,11,State - SIKKIM,Total,55-59,Illiterate,3202,5285,8487
4112,11,State - SIKKIM,Total,60-64,Illiterate,3096,4689,7785
4113,11,State - SIKKIM,Total,65-69,Illiterate,2494,3837,6331
4114,11,State - SIKKIM,Total,70-74,Illiterate,2248,2768,5016
4115,11,State - SIKKIM,Total,75-79,Illiterate,1466,1708,3174
4116,11,State - SIKKIM,Total,80+,Illiterate,1428,1704,3132
4117,11,State - SIKKIM,Total,Age not stated,Illiterate,146,156,302
4118,11,State - SIKKIM,Rural,All ages,Illiterate,58552,76517,135069
4119,11,State - SIKKIM,Rural,0-6,Illiterate,25061,24157,49218
4120,11,State - SIKKIM,Rural,7,Illiterate,1076,1023,2099
4121,11,State - SIKKIM,Rural,8,Illiterate,511,459,970
4122,11,State - SIKKIM,Rural,9,Illiterate,503,458,961
4123,11,State - SIKKIM,Rural,10,Illiterate,446,435,881
4124,11,State - SIKKIM,Rural,11,Illiterate,281,253,534
4125,11,State - SIKKIM,Rural,12,Illiterate,186,172,358
4126,11,State - SIKKIM,Rural,13,Illiterate,189,153,342
4127,11,State - SIKKIM,Rural,14,Illiterate,197,171,368
4128,11,State - SIKKIM,Rural,15,Illiterate,232,212,444
4129,11,State - SIKKIM,Rural,16,Illiterate,224,208,432
4130,11,State - SIKKIM,Rural,17,Illiterate,238,200,438
4131,11,State - SIKKIM,Rural,18,Illiterate,311,278,589
4132,11,State - SIKKIM,Rural,19,Illiterate,233,271,504
4133,11,State - SIKKIM,Rural,20-24,Illiterate,1507,2035,3542
4134,11,State - SIKKIM,Rural,25-29,Illiterate,1951,3094,5045
4135,11,State - SIKKIM,Rural,30-34,Illiterate,1936,3612,5548
4136,11,State - SIKKIM,Rural,35-39,Illiterate,2107,4662,6769
4137,11,State - SIKKIM,Rural,40-44,Illiterate,2437,5663,8100
4138,11,State - SIKKIM,Rural,45-49,Illiterate,2924,5956,8880
4139,11,State - SIKKIM,Rural,50-54,Illiterate,3363,5756,9119
4140,11,State - SIKKIM,Rural,55-59,Illiterate,2862,4542,7404
4141,11,State - SIKKIM,Rural,60-64,Illiterate,2763,4061,6824
4142,11,State - SIKKIM,Rural,65-69,Illiterate,2237,3325,5562
4143,11,State - SIKKIM,Rural,70-74,Illiterate,2060,2367,4427
4144,11,State - SIKKIM,Rural,75-79,Illiterate,1308,1450,2758
4145,11,State - SIKKIM,Rural,80+,Illiterate,1280,1408,2688
4146,11,State - SIKKIM,Rural,Age not stated,Illiterate,129,136,265
4147,11,State - SIKKIM,Urban,All ages,Illiterate,13249,17307,30556
4148,11,State - SIKKIM,Urban,0-6,Illiterate,7700,7193,14893
4149,11,State - SIKKIM,Urban,7,Illiterate,228,237,465
4150,11,State - SIKKIM,Urban,8,Illiterate,88,89,177
4151,11,State - SIKKIM,Urban,9,Illiterate,101,116,217
4152,11,State - SIKKIM,Urban,10,Illiterate,105,123,228
4153,11,State - SIKKIM,Urban,11,Illiterate,66,63,129
4154,11,State - SIKKIM,Urban,12,Illiterate,50,66,116
4155,11,State - SIKKIM,Urban,13,Illiterate,45,83,128
4156,11,State - SIKKIM,Urban,14,Illiterate,35,94,129
4157,11,State - SIKKIM,Urban,15,Illiterate,60,121,181
4158,11,State - SIKKIM,Urban,16,Illiterate,58,119,177
4159,11,State - SIKKIM,Urban,17,Illiterate,52,120,172
4160,11,State - SIKKIM,Urban,18,Illiterate,82,120,202
4161,11,State - SIKKIM,Urban,19,Illiterate,69,88,157
4162,11,State - SIKKIM,Urban,20-24,Illiterate,403,538,941
4163,11,State - SIKKIM,Urban,25-29,Illiterate,398,726,1124
4164,11,State - SIKKIM,Urban,30-34,Illiterate,369,813,1182
4165,11,State - SIKKIM,Urban,35-39,Illiterate,428,927,1355
4166,11,State - SIKKIM,Urban,40-44,Illiterate,511,939,1450
4167,11,State - SIKKIM,Urban,45-49,Illiterate,506,1007,1513
4168,11,State - SIKKIM,Urban,50-54,Illiterate,454,867,1321
4169,11,State - SIKKIM,Urban,55-59,Illiterate,340,743,1083
4170,11,State - SIKKIM,Urban,60-64,Illiterate,333,628,961
4171,11,State - SIKKIM,Urban,65-69,Illiterate,257,512,769
4172,11,State - SIKKIM,Urban,70-74,Illiterate,188,401,589
4173,11,State - SIKKIM,Urban,75-79,Illiterate,158,258,416
4174,11,State - SIKKIM,Urban,80+,Illiterate,148,296,444
4175,11,State - SIKKIM,Urban,Age not stated,Illiterate,17,20,37
4176,12,State - ARUNACHAL PRADESH,Total,All ages,Illiterate,274044,343678,617722
4177,12,State - ARUNACHAL PRADESH,Total,0-6,Illiterate,107624,104564,212188
4178,12,State - ARUNACHAL PRADESH,Total,7,Illiterate,7496,7844,15340
4179,12,State - ARUNACHAL PRADESH,Total,8,Illiterate,5695,6299,11994
4180,12,State - ARUNACHAL PRADESH,Total,9,Illiterate,4029,4355,8384
4181,12,State - ARUNACHAL PRADESH,Total,10,Illiterate,4573,4992,9565
4182,12,State - ARUNACHAL PRADESH,Total,11,Illiterate,3010,3503,6513
4183,12,State - ARUNACHAL PRADESH,Total,12,Illiterate,2849,3604,6453
4184,12,State - ARUNACHAL PRADESH,Total,13,Illiterate,1991,2657,4648
4185,12,State - ARUNACHAL PRADESH,Total,14,Illiterate,1979,2697,4676
4186,12,State - ARUNACHAL PRADESH,Total,15,Illiterate,2329,2991,5320
4187,12,State - ARUNACHAL PRADESH,Total,16,Illiterate,1903,2634,4537
4188,12,State - ARUNACHAL PRADESH,Total,17,Illiterate,1741,2363,4104
4189,12,State - ARUNACHAL PRADESH,Total,18,Illiterate,2456,3608,6064
4190,12,State - ARUNACHAL PRADESH,Total,19,Illiterate,1913,3038,4951
4191,12,State - ARUNACHAL PRADESH,Total,20-24,Illiterate,11537,19043,30580
4192,12,State - ARUNACHAL PRADESH,Total,25-29,Illiterate,13019,23144,36163
4193,12,State - ARUNACHAL PRADESH,Total,30-34,Illiterate,12488,22506,34994
4194,12,State - ARUNACHAL PRADESH,Total,35-39,Illiterate,13757,25295,39052
4195,12,State - ARUNACHAL PRADESH,Total,40-44,Illiterate,14176,22822,36998
4196,12,State - ARUNACHAL PRADESH,Total,45-49,Illiterate,13459,20605,34064
4197,12,State - ARUNACHAL PRADESH,Total,50-54,Illiterate,12575,15950,28525
4198,12,State - ARUNACHAL PRADESH,Total,55-59,Illiterate,9399,11316,20715
4199,12,State - ARUNACHAL PRADESH,Total,60-64,Illiterate,9295,10886,20181
4200,12,State - ARUNACHAL PRADESH,Total,65-69,Illiterate,5452,6629,12081
4201,12,State - ARUNACHAL PRADESH,Total,70-74,Illiterate,4300,4749,9049
4202,12,State - ARUNACHAL PRADESH,Total,75-79,Illiterate,2100,2291,4391
4203,12,State - ARUNACHAL PRADESH,Total,80+,Illiterate,2636,2984,5620
4204,12,State - ARUNACHAL PRADESH,Total,Age not stated,Illiterate,263,309,572
4205,12,State - ARUNACHAL PRADESH,Rural,All ages,Illiterate,236621,293835,530456
4206,12,State - ARUNACHAL PRADESH,Rural,0-6,Illiterate,87241,85048,172289
4207,12,State - ARUNACHAL PRADESH,Rural,7,Illiterate,6591,6826,13417
4208,12,State - ARUNACHAL PRADESH,Rural,8,Illiterate,5138,5596,10734
4209,12,State - ARUNACHAL PRADESH,Rural,9,Illiterate,3610,3865,7475
4210,12,State - ARUNACHAL PRADESH,Rural,10,Illiterate,4078,4410,8488
4211,12,State - ARUNACHAL PRADESH,Rural,11,Illiterate,2699,3058,5757
4212,12,State - ARUNACHAL PRADESH,Rural,12,Illiterate,2586,3178,5764
4213,12,State - ARUNACHAL PRADESH,Rural,13,Illiterate,1783,2281,4064
4214,12,State - ARUNACHAL PRADESH,Rural,14,Illiterate,1765,2263,4028
4215,12,State - ARUNACHAL PRADESH,Rural,15,Illiterate,2091,2508,4599
4216,12,State - ARUNACHAL PRADESH,Rural,16,Illiterate,1683,2193,3876
4217,12,State - ARUNACHAL PRADESH,Rural,17,Illiterate,1560,1996,3556
4218,12,State - ARUNACHAL PRADESH,Rural,18,Illiterate,2176,3110,5286
4219,12,State - ARUNACHAL PRADESH,Rural,19,Illiterate,1686,2606,4292
4220,12,State - ARUNACHAL PRADESH,Rural,20-24,Illiterate,10239,16531,26770
4221,12,State - ARUNACHAL PRADESH,Rural,25-29,Illiterate,11542,20022,31564
4222,12,State - ARUNACHAL PRADESH,Rural,30-34,Illiterate,11113,19335,30448
4223,12,State - ARUNACHAL PRADESH,Rural,35-39,Illiterate,12065,21616,33681
4224,12,State - ARUNACHAL PRADESH,Rural,40-44,Illiterate,12575,19665,32240
4225,12,State - ARUNACHAL PRADESH,Rural,45-49,Illiterate,12007,17931,29938
4226,12,State - ARUNACHAL PRADESH,Rural,50-54,Illiterate,11383,14129,25512
4227,12,State - ARUNACHAL PRADESH,Rural,55-59,Illiterate,8603,10192,18795
4228,12,State - ARUNACHAL PRADESH,Rural,60-64,Illiterate,8569,9892,18461
4229,12,State - ARUNACHAL PRADESH,Rural,65-69,Illiterate,5104,6120,11224
4230,12,State - ARUNACHAL PRADESH,Rural,70-74,Illiterate,4068,4350,8418
4231,12,State - ARUNACHAL PRADESH,Rural,75-79,Illiterate,1986,2125,4111
4232,12,State - ARUNACHAL PRADESH,Rural,80+,Illiterate,2468,2726,5194
4233,12,State - ARUNACHAL PRADESH,Rural,Age not stated,Illiterate,212,263,475
4234,12,State - ARUNACHAL PRADESH,Urban,All ages,Illiterate,37423,49843,87266
4235,12,State - ARUNACHAL PRADESH,Urban,0-6,Illiterate,20383,19516,39899
4236,12,State - ARUNACHAL PRADESH,Urban,7,Illiterate,905,1018,1923
4237,12,State - ARUNACHAL PRADESH,Urban,8,Illiterate,557,703,1260
4238,12,State - ARUNACHAL PRADESH,Urban,9,Illiterate,419,490,909
4239,12,State - ARUNACHAL PRADESH,Urban,10,Illiterate,495,582,1077
4240,12,State - ARUNACHAL PRADESH,Urban,11,Illiterate,311,445,756
4241,12,State - ARUNACHAL PRADESH,Urban,12,Illiterate,263,426,689
4242,12,State - ARUNACHAL PRADESH,Urban,13,Illiterate,208,376,584
4243,12,State - ARUNACHAL PRADESH,Urban,14,Illiterate,214,434,648
4244,12,State - ARUNACHAL PRADESH,Urban,15,Illiterate,238,483,721
4245,12,State - ARUNACHAL PRADESH,Urban,16,Illiterate,220,441,661
4246,12,State - ARUNACHAL PRADESH,Urban,17,Illiterate,181,367,548
4247,12,State - ARUNACHAL PRADESH,Urban,18,Illiterate,280,498,778
4248,12,State - ARUNACHAL PRADESH,Urban,19,Illiterate,227,432,659
4249,12,State - ARUNACHAL PRADESH,Urban,20-24,Illiterate,1298,2512,3810
4250,12,State - ARUNACHAL PRADESH,Urban,25-29,Illiterate,1477,3122,4599
4251,12,State - ARUNACHAL PRADESH,Urban,30-34,Illiterate,1375,3171,4546
4252,12,State - ARUNACHAL PRADESH,Urban,35-39,Illiterate,1692,3679,5371
4253,12,State - ARUNACHAL PRADESH,Urban,40-44,Illiterate,1601,3157,4758
4254,12,State - ARUNACHAL PRADESH,Urban,45-49,Illiterate,1452,2674,4126
4255,12,State - ARUNACHAL PRADESH,Urban,50-54,Illiterate,1192,1821,3013
4256,12,State - ARUNACHAL PRADESH,Urban,55-59,Illiterate,796,1124,1920
4257,12,State - ARUNACHAL PRADESH,Urban,60-64,Illiterate,726,994,1720
4258,12,State - ARUNACHAL PRADESH,Urban,65-69,Illiterate,348,509,857
4259,12,State - ARUNACHAL PRADESH,Urban,70-74,Illiterate,232,399,631
4260,12,State - ARUNACHAL PRADESH,Urban,75-79,Illiterate,114,166,280
4261,12,State - ARUNACHAL PRADESH,Urban,80+,Illiterate,168,258,426
4262,12,State - ARUNACHAL PRADESH,Urban,Age not stated,Illiterate,51,46,97
4263,13,State - NAGALAND,Total,All ages,Illiterate,300692,335376,636068
4264,13,State - NAGALAND,Total,0-6,Illiterate,149785,141286,291071
4265,13,State - NAGALAND,Total,7,Illiterate,9662,8944,18606
4266,13,State - NAGALAND,Total,8,Illiterate,5696,5484,11180
4267,13,State - NAGALAND,Total,9,Illiterate,4697,4551,9248
4268,13,State - NAGALAND,Total,10,Illiterate,4918,4759,9677
4269,13,State - NAGALAND,Total,11,Illiterate,3347,3202,6549
4270,13,State - NAGALAND,Total,12,Illiterate,2866,2882,5748
4271,13,State - NAGALAND,Total,13,Illiterate,2409,2370,4779
4272,13,State - NAGALAND,Total,14,Illiterate,2385,2232,4617
4273,13,State - NAGALAND,Total,15,Illiterate,2632,2679,5311
4274,13,State - NAGALAND,Total,16,Illiterate,2435,2457,4892
4275,13,State - NAGALAND,Total,17,Illiterate,2130,2181,4311
4276,13,State - NAGALAND,Total,18,Illiterate,2826,2887,5713
4277,13,State - NAGALAND,Total,19,Illiterate,2144,2378,4522
4278,13,State - NAGALAND,Total,20-24,Illiterate,12005,14413,26418
4279,13,State - NAGALAND,Total,25-29,Illiterate,10879,14981,25860
4280,13,State - NAGALAND,Total,30-34,Illiterate,10264,14825,25089
4281,13,State - NAGALAND,Total,35-39,Illiterate,10169,16299,26468
4282,13,State - NAGALAND,Total,40-44,Illiterate,10817,16444,27261
4283,13,State - NAGALAND,Total,45-49,Illiterate,9947,15181,25128
4284,13,State - NAGALAND,Total,50-54,Illiterate,9332,13353,22685
4285,13,State - NAGALAND,Total,55-59,Illiterate,6594,9931,16525
4286,13,State - NAGALAND,Total,60-64,Illiterate,6695,9816,16511
4287,13,State - NAGALAND,Total,65-69,Illiterate,4668,7131,11799
4288,13,State - NAGALAND,Total,70-74,Illiterate,4355,5976,10331
4289,13,State - NAGALAND,Total,75-79,Illiterate,2739,3649,6388
4290,13,State - NAGALAND,Total,80+,Illiterate,4075,4847,8922
4291,13,State - NAGALAND,Total,Age not stated,Illiterate,221,238,459
4292,13,State - NAGALAND,Rural,All ages,Illiterate,241451,269422,510873
4293,13,State - NAGALAND,Rural,0-6,Illiterate,112483,104999,217482
4294,13,State - NAGALAND,Rural,7,Illiterate,7989,7381,15370
4295,13,State - NAGALAND,Rural,8,Illiterate,4868,4718,9586
4296,13,State - NAGALAND,Rural,9,Illiterate,4029,3907,7936
4297,13,State - NAGALAND,Rural,10,Illiterate,4281,4072,8353
4298,13,State - NAGALAND,Rural,11,Illiterate,2921,2747,5668
4299,13,State - NAGALAND,Rural,12,Illiterate,2518,2503,5021
4300,13,State - NAGALAND,Rural,13,Illiterate,2090,2026,4116
4301,13,State - NAGALAND,Rural,14,Illiterate,2063,1892,3955
4302,13,State - NAGALAND,Rural,15,Illiterate,2253,2292,4545
4303,13,State - NAGALAND,Rural,16,Illiterate,2083,2110,4193
4304,13,State - NAGALAND,Rural,17,Illiterate,1797,1865,3662
4305,13,State - NAGALAND,Rural,18,Illiterate,2409,2481,4890
4306,13,State - NAGALAND,Rural,19,Illiterate,1832,2017,3849
4307,13,State - NAGALAND,Rural,20-24,Illiterate,10181,12125,22306
4308,13,State - NAGALAND,Rural,25-29,Illiterate,8932,12344,21276
4309,13,State - NAGALAND,Rural,30-34,Illiterate,8377,12208,20585
4310,13,State - NAGALAND,Rural,35-39,Illiterate,8292,13472,21764
4311,13,State - NAGALAND,Rural,40-44,Illiterate,9104,13841,22945
4312,13,State - NAGALAND,Rural,45-49,Illiterate,8457,12862,21319
4313,13,State - NAGALAND,Rural,50-54,Illiterate,8094,11550,19644
4314,13,State - NAGALAND,Rural,55-59,Illiterate,5812,8600,14412
4315,13,State - NAGALAND,Rural,60-64,Illiterate,5976,8595,14571
4316,13,State - NAGALAND,Rural,65-69,Illiterate,4197,6189,10386
4317,13,State - NAGALAND,Rural,70-74,Illiterate,4002,5240,9242
4318,13,State - NAGALAND,Rural,75-79,Illiterate,2518,3156,5674
4319,13,State - NAGALAND,Rural,80+,Illiterate,3687,4013,7700
4320,13,State - NAGALAND,Rural,Age not stated,Illiterate,206,217,423
4321,13,State - NAGALAND,Urban,All ages,Illiterate,59241,65954,125195
4322,13,State - NAGALAND,Urban,0-6,Illiterate,37302,36287,73589
4323,13,State - NAGALAND,Urban,7,Illiterate,1673,1563,3236
4324,13,State - NAGALAND,Urban,8,Illiterate,828,766,1594
4325,13,State - NAGALAND,Urban,9,Illiterate,668,644,1312
4326,13,State - NAGALAND,Urban,10,Illiterate,637,687,1324
4327,13,State - NAGALAND,Urban,11,Illiterate,426,455,881
4328,13,State - NAGALAND,Urban,12,Illiterate,348,379,727
4329,13,State - NAGALAND,Urban,13,Illiterate,319,344,663
4330,13,State - NAGALAND,Urban,14,Illiterate,322,340,662
4331,13,State - NAGALAND,Urban,15,Illiterate,379,387,766
4332,13,State - NAGALAND,Urban,16,Illiterate,352,347,699
4333,13,State - NAGALAND,Urban,17,Illiterate,333,316,649
4334,13,State - NAGALAND,Urban,18,Illiterate,417,406,823
4335,13,State - NAGALAND,Urban,19,Illiterate,312,361,673
4336,13,State - NAGALAND,Urban,20-24,Illiterate,1824,2288,4112
4337,13,State - NAGALAND,Urban,25-29,Illiterate,1947,2637,4584
4338,13,State - NAGALAND,Urban,30-34,Illiterate,1887,2617,4504
4339,13,State - NAGALAND,Urban,35-39,Illiterate,1877,2827,4704
4340,13,State - NAGALAND,Urban,40-44,Illiterate,1713,2603,4316
4341,13,State - NAGALAND,Urban,45-49,Illiterate,1490,2319,3809
4342,13,State - NAGALAND,Urban,50-54,Illiterate,1238,1803,3041
4343,13,State - NAGALAND,Urban,55-59,Illiterate,782,1331,2113
4344,13,State - NAGALAND,Urban,60-64,Illiterate,719,1221,1940
4345,13,State - NAGALAND,Urban,65-69,Illiterate,471,942,1413
4346,13,State - NAGALAND,Urban,70-74,Illiterate,353,736,1089
4347,13,State - NAGALAND,Urban,75-79,Illiterate,221,493,714
4348,13,State - NAGALAND,Urban,80+,Illiterate,388,834,1222
4349,13,State - NAGALAND,Urban,Age not stated,Illiterate,15,21,36
4350,14,State - MANIPUR,Total,All ages,Illiterate,398728,548590,947318
4351,14,State - MANIPUR,Total,0-6,Illiterate,194484,180873,375357
4352,14,State - MANIPUR,Total,7,Illiterate,10986,11071,22057
4353,14,State - MANIPUR,Total,8,Illiterate,7685,7804,15489
4354,14,State - MANIPUR,Total,9,Illiterate,5549,5614,11163
4355,14,State - MANIPUR,Total,10,Illiterate,6070,6163,12233
4356,14,State - MANIPUR,Total,11,Illiterate,4137,4111,8248
4357,14,State - MANIPUR,Total,12,Illiterate,3606,3959,7565
4358,14,State - MANIPUR,Total,13,Illiterate,2721,3045,5766
4359,14,State - MANIPUR,Total,14,Illiterate,2526,3030,5556
4360,14,State - MANIPUR,Total,15,Illiterate,2656,3194,5850
4361,14,State - MANIPUR,Total,16,Illiterate,2415,3101,5516
4362,14,State - MANIPUR,Total,17,Illiterate,2173,3035,5208
4363,14,State - MANIPUR,Total,18,Illiterate,3310,4548,7858
4364,14,State - MANIPUR,Total,19,Illiterate,2427,3603,6030
4365,14,State - MANIPUR,Total,20-24,Illiterate,14659,23726,38385
4366,14,State - MANIPUR,Total,25-29,Illiterate,14948,28017,42965
4367,14,State - MANIPUR,Total,30-34,Illiterate,13669,26461,40130
4368,14,State - MANIPUR,Total,35-39,Illiterate,14125,30413,44538
4369,14,State - MANIPUR,Total,40-44,Illiterate,14649,32073,46722
4370,14,State - MANIPUR,Total,45-49,Illiterate,14438,32913,47351
4371,14,State - MANIPUR,Total,50-54,Illiterate,13947,30442,44389
4372,14,State - MANIPUR,Total,55-59,Illiterate,11194,25242,36436
4373,14,State - MANIPUR,Total,60-64,Illiterate,10700,23297,33997
4374,14,State - MANIPUR,Total,65-69,Illiterate,7455,17344,24799
4375,14,State - MANIPUR,Total,70-74,Illiterate,6626,14220,20846
4376,14,State - MANIPUR,Total,75-79,Illiterate,4479,9070,13549
4377,14,State - MANIPUR,Total,80+,Illiterate,6146,10952,17098
4378,14,State - MANIPUR,Total,Age not stated,Illiterate,948,1269,2217
4379,14,State - MANIPUR,Rural,All ages,Illiterate,316750,422031,738781
4380,14,State - MANIPUR,Rural,0-6,Illiterate,142443,131503,273946
4381,14,State - MANIPUR,Rural,7,Illiterate,8799,8836,17635
4382,14,State - MANIPUR,Rural,8,Illiterate,6368,6417,12785
4383,14,State - MANIPUR,Rural,9,Illiterate,4615,4666,9281
4384,14,State - MANIPUR,Rural,10,Illiterate,5090,5168,10258
4385,14,State - MANIPUR,Rural,11,Illiterate,3564,3465,7029
4386,14,State - MANIPUR,Rural,12,Illiterate,3168,3403,6571
4387,14,State - MANIPUR,Rural,13,Illiterate,2405,2626,5031
4388,14,State - MANIPUR,Rural,14,Illiterate,2244,2648,4892
4389,14,State - MANIPUR,Rural,15,Illiterate,2350,2746,5096
4390,14,State - MANIPUR,Rural,16,Illiterate,2190,2737,4927
4391,14,State - MANIPUR,Rural,17,Illiterate,1984,2658,4642
4392,14,State - MANIPUR,Rural,18,Illiterate,2997,3919,6916
4393,14,State - MANIPUR,Rural,19,Illiterate,2193,3205,5398
4394,14,State - MANIPUR,Rural,20-24,Illiterate,13289,20687,33976
4395,14,State - MANIPUR,Rural,25-29,Illiterate,13250,23803,37053
4396,14,State - MANIPUR,Rural,30-34,Illiterate,12035,22110,34145
4397,14,State - MANIPUR,Rural,35-39,Illiterate,12224,24898,37122
4398,14,State - MANIPUR,Rural,40-44,Illiterate,12656,25954,38610
4399,14,State - MANIPUR,Rural,45-49,Illiterate,12391,26095,38486
4400,14,State - MANIPUR,Rural,50-54,Illiterate,11990,23414,35404
4401,14,State - MANIPUR,Rural,55-59,Illiterate,9494,19046,28540
4402,14,State - MANIPUR,Rural,60-64,Illiterate,9026,16938,25964
4403,14,State - MANIPUR,Rural,65-69,Illiterate,6097,12076,18173
4404,14,State - MANIPUR,Rural,70-74,Illiterate,5170,9563,14733
4405,14,State - MANIPUR,Rural,75-79,Illiterate,3432,5820,9252
4406,14,State - MANIPUR,Rural,80+,Illiterate,4534,6641,11175
4407,14,State - MANIPUR,Rural,Age not stated,Illiterate,752,989,1741
4408,14,State - MANIPUR,Urban,All ages,Illiterate,81978,126559,208537
4409,14,State - MANIPUR,Urban,0-6,Illiterate,52041,49370,101411
4410,14,State - MANIPUR,Urban,7,Illiterate,2187,2235,4422
4411,14,State - MANIPUR,Urban,8,Illiterate,1317,1387,2704
4412,14,State - MANIPUR,Urban,9,Illiterate,934,948,1882
4413,14,State - MANIPUR,Urban,10,Illiterate,980,995,1975
4414,14,State - MANIPUR,Urban,11,Illiterate,573,646,1219
4415,14,State - MANIPUR,Urban,12,Illiterate,438,556,994
4416,14,State - MANIPUR,Urban,13,Illiterate,316,419,735
4417,14,State - MANIPUR,Urban,14,Illiterate,282,382,664
4418,14,State - MANIPUR,Urban,15,Illiterate,306,448,754
4419,14,State - MANIPUR,Urban,16,Illiterate,225,364,589
4420,14,State - MANIPUR,Urban,17,Illiterate,189,377,566
4421,14,State - MANIPUR,Urban,18,Illiterate,313,629,942
4422,14,State - MANIPUR,Urban,19,Illiterate,234,398,632
4423,14,State - MANIPUR,Urban,20-24,Illiterate,1370,3039,4409
4424,14,State - MANIPUR,Urban,25-29,Illiterate,1698,4214,5912
4425,14,State - MANIPUR,Urban,30-34,Illiterate,1634,4351,5985
4426,14,State - MANIPUR,Urban,35-39,Illiterate,1901,5515,7416
4427,14,State - MANIPUR,Urban,40-44,Illiterate,1993,6119,8112
4428,14,State - MANIPUR,Urban,45-49,Illiterate,2047,6818,8865
4429,14,State - MANIPUR,Urban,50-54,Illiterate,1957,7028,8985
4430,14,State - MANIPUR,Urban,55-59,Illiterate,1700,6196,7896
4431,14,State - MANIPUR,Urban,60-64,Illiterate,1674,6359,8033
4432,14,State - MANIPUR,Urban,65-69,Illiterate,1358,5268,6626
4433,14,State - MANIPUR,Urban,70-74,Illiterate,1456,4657,6113
4434,14,State - MANIPUR,Urban,75-79,Illiterate,1047,3250,4297
4435,14,State - MANIPUR,Urban,80+,Illiterate,1612,4311,5923
4436,14,State - MANIPUR,Urban,Age not stated,Illiterate,196,280,476
4437,15,State - MIZORAM,Total,All ages,Illiterate,116810,132221,249031
4438,15,State - MIZORAM,Total,0-6,Illiterate,85561,82970,168531
4439,15,State - MIZORAM,Total,7,Illiterate,2469,2576,5045
4440,15,State - MIZORAM,Total,8,Illiterate,1244,1378,2622
4441,15,State - MIZORAM,Total,9,Illiterate,869,941,1810
4442,15,State - MIZORAM,Total,10,Illiterate,970,1109,2079
4443,15,State - MIZORAM,Total,11,Illiterate,619,773,1392
4444,15,State - MIZORAM,Total,12,Illiterate,480,680,1160
4445,15,State - MIZORAM,Total,13,Illiterate,435,603,1038
4446,15,State - MIZORAM,Total,14,Illiterate,390,599,989
4447,15,State - MIZORAM,Total,15,Illiterate,447,670,1117
4448,15,State - MIZORAM,Total,16,Illiterate,439,613,1052
4449,15,State - MIZORAM,Total,17,Illiterate,433,644,1077
4450,15,State - MIZORAM,Total,18,Illiterate,549,894,1443
4451,15,State - MIZORAM,Total,19,Illiterate,527,979,1506
4452,15,State - MIZORAM,Total,20-24,Illiterate,3040,5425,8465
4453,15,State - MIZORAM,Total,25-29,Illiterate,2856,4834,7690
4454,15,State - MIZORAM,Total,30-34,Illiterate,2402,3831,6233
4455,15,State - MIZORAM,Total,35-39,Illiterate,2230,3508,5738
4456,15,State - MIZORAM,Total,40-44,Illiterate,2081,3388,5469
4457,15,State - MIZORAM,Total,45-49,Illiterate,1936,3094,5030
4458,15,State - MIZORAM,Total,50-54,Illiterate,1965,2997,4962
4459,15,State - MIZORAM,Total,55-59,Illiterate,1399,2150,3549
4460,15,State - MIZORAM,Total,60-64,Illiterate,1196,1965,3161
4461,15,State - MIZORAM,Total,65-69,Illiterate,793,1529,2322
4462,15,State - MIZORAM,Total,70-74,Illiterate,599,1401,2000
4463,15,State - MIZORAM,Total,75-79,Illiterate,370,1109,1479
4464,15,State - MIZORAM,Total,80+,Illiterate,465,1513,1978
4465,15,State - MIZORAM,Total,Age not stated,Illiterate,46,48,94
4466,15,State - MIZORAM,Rural,All ages,Illiterate,73735,88366,162101
4467,15,State - MIZORAM,Rural,0-6,Illiterate,47489,45895,93384
4468,15,State - MIZORAM,Rural,7,Illiterate,1833,1960,3793
4469,15,State - MIZORAM,Rural,8,Illiterate,1040,1197,2237
4470,15,State - MIZORAM,Rural,9,Illiterate,755,841,1596
4471,15,State - MIZORAM,Rural,10,Illiterate,797,949,1746
4472,15,State - MIZORAM,Rural,11,Illiterate,536,709,1245
4473,15,State - MIZORAM,Rural,12,Illiterate,429,645,1074
4474,15,State - MIZORAM,Rural,13,Illiterate,392,564,956
4475,15,State - MIZORAM,Rural,14,Illiterate,346,556,902
4476,15,State - MIZORAM,Rural,15,Illiterate,390,618,1008
4477,15,State - MIZORAM,Rural,16,Illiterate,390,559,949
4478,15,State - MIZORAM,Rural,17,Illiterate,387,582,969
4479,15,State - MIZORAM,Rural,18,Illiterate,481,835,1316
4480,15,State - MIZORAM,Rural,19,Illiterate,467,932,1399
4481,15,State - MIZORAM,Rural,20-24,Illiterate,2646,5081,7727
4482,15,State - MIZORAM,Rural,25-29,Illiterate,2464,4465,6929
4483,15,State - MIZORAM,Rural,30-34,Illiterate,2001,3480,5481
4484,15,State - MIZORAM,Rural,35-39,Illiterate,1865,3146,5011
4485,15,State - MIZORAM,Rural,40-44,Illiterate,1720,2984,4704
4486,15,State - MIZORAM,Rural,45-49,Illiterate,1624,2641,4265
4487,15,State - MIZORAM,Rural,50-54,Illiterate,1637,2544,4181
4488,15,State - MIZORAM,Rural,55-59,Illiterate,1186,1748,2934
4489,15,State - MIZORAM,Rural,60-64,Illiterate,1032,1590,2622
4490,15,State - MIZORAM,Rural,65-69,Illiterate,678,1184,1862
4491,15,State - MIZORAM,Rural,70-74,Illiterate,488,982,1470
4492,15,State - MIZORAM,Rural,75-79,Illiterate,297,709,1006
4493,15,State - MIZORAM,Rural,80+,Illiterate,339,938,1277
4494,15,State - MIZORAM,Rural,Age not stated,Illiterate,26,32,58
4495,15,State - MIZORAM,Urban,All ages,Illiterate,43075,43855,86930
4496,15,State - MIZORAM,Urban,0-6,Illiterate,38072,37075,75147
4497,15,State - MIZORAM,Urban,7,Illiterate,636,616,1252
4498,15,State - MIZORAM,Urban,8,Illiterate,204,181,385
4499,15,State - MIZORAM,Urban,9,Illiterate,114,100,214
4500,15,State - MIZORAM,Urban,10,Illiterate,173,160,333
4501,15,State - MIZORAM,Urban,11,Illiterate,83,64,147
4502,15,State - MIZORAM,Urban,12,Illiterate,51,35,86
4503,15,State - MIZORAM,Urban,13,Illiterate,43,39,82
4504,15,State - MIZORAM,Urban,14,Illiterate,44,43,87
4505,15,State - MIZORAM,Urban,15,Illiterate,57,52,109
4506,15,State - MIZORAM,Urban,16,Illiterate,49,54,103
4507,15,State - MIZORAM,Urban,17,Illiterate,46,62,108
4508,15,State - MIZORAM,Urban,18,Illiterate,68,59,127
4509,15,State - MIZORAM,Urban,19,Illiterate,60,47,107
4510,15,State - MIZORAM,Urban,20-24,Illiterate,394,344,738
4511,15,State - MIZORAM,Urban,25-29,Illiterate,392,369,761
4512,15,State - MIZORAM,Urban,30-34,Illiterate,401,351,752
4513,15,State - MIZORAM,Urban,35-39,Illiterate,365,362,727
4514,15,State - MIZORAM,Urban,40-44,Illiterate,361,404,765
4515,15,State - MIZORAM,Urban,45-49,Illiterate,312,453,765
4516,15,State - MIZORAM,Urban,50-54,Illiterate,328,453,781
4517,15,State - MIZORAM,Urban,55-59,Illiterate,213,402,615
4518,15,State - MIZORAM,Urban,60-64,Illiterate,164,375,539
4519,15,State - MIZORAM,Urban,65-69,Illiterate,115,345,460
4520,15,State - MIZORAM,Urban,70-74,Illiterate,111,419,530
4521,15,State - MIZORAM,Urban,75-79,Illiterate,73,400,473
4522,15,State - MIZORAM,Urban,80+,Illiterate,126,575,701
4523,15,State - MIZORAM,Urban,Age not stated,Illiterate,20,16,36
4524,16,State - TRIPURA,Total,All ages,Illiterate,373007,496127,869134
4525,16,State - TRIPURA,Total,0-6,Illiterate,234008,224006,458014
4526,16,State - TRIPURA,Total,7,Illiterate,6029,5925,11954
4527,16,State - TRIPURA,Total,8,Illiterate,2382,2425,4807
4528,16,State - TRIPURA,Total,9,Illiterate,1549,1680,3229
4529,16,State - TRIPURA,Total,10,Illiterate,1880,2035,3915
4530,16,State - TRIPURA,Total,11,Illiterate,1093,1294,2387
4531,16,State - TRIPURA,Total,12,Illiterate,1079,1415,2494
4532,16,State - TRIPURA,Total,13,Illiterate,868,1137,2005
4533,16,State - TRIPURA,Total,14,Illiterate,968,1302,2270
4534,16,State - TRIPURA,Total,15,Illiterate,1136,1795,2931
4535,16,State - TRIPURA,Total,16,Illiterate,1129,1815,2944
4536,16,State - TRIPURA,Total,17,Illiterate,1122,1801,2923
4537,16,State - TRIPURA,Total,18,Illiterate,1562,3105,4667
4538,16,State - TRIPURA,Total,19,Illiterate,1163,2685,3848
4539,16,State - TRIPURA,Total,20-24,Illiterate,7901,16445,24346
4540,16,State - TRIPURA,Total,25-29,Illiterate,9625,18672,28297
4541,16,State - TRIPURA,Total,30-34,Illiterate,9029,17487,26516
4542,16,State - TRIPURA,Total,35-39,Illiterate,10740,22687,33427
4543,16,State - TRIPURA,Total,40-44,Illiterate,12280,24843,37123
4544,16,State - TRIPURA,Total,45-49,Illiterate,13302,25393,38695
4545,16,State - TRIPURA,Total,50-54,Illiterate,12523,22320,34843
4546,16,State - TRIPURA,Total,55-59,Illiterate,9156,18978,28134
4547,16,State - TRIPURA,Total,60-64,Illiterate,9385,20709,30094
4548,16,State - TRIPURA,Total,65-69,Illiterate,7418,17560,24978
4549,16,State - TRIPURA,Total,70-74,Illiterate,6400,15019,21419
4550,16,State - TRIPURA,Total,75-79,Illiterate,3654,9291,12945
4551,16,State - TRIPURA,Total,80+,Illiterate,5456,14090,19546
4552,16,State - TRIPURA,Total,Age not stated,Illiterate,170,213,383
4553,16,State - TRIPURA,Rural,All ages,Illiterate,305670,414021,719691
4554,16,State - TRIPURA,Rural,0-6,Illiterate,186400,178909,365309
4555,16,State - TRIPURA,Rural,7,Illiterate,5156,5078,10234
4556,16,State - TRIPURA,Rural,8,Illiterate,2144,2211,4355
4557,16,State - TRIPURA,Rural,9,Illiterate,1372,1532,2904
4558,16,State - TRIPURA,Rural,10,Illiterate,1645,1828,3473
4559,16,State - TRIPURA,Rural,11,Illiterate,960,1166,2126
4560,16,State - TRIPURA,Rural,12,Illiterate,940,1305,2245
4561,16,State - TRIPURA,Rural,13,Illiterate,760,1053,1813
4562,16,State - TRIPURA,Rural,14,Illiterate,834,1185,2019
4563,16,State - TRIPURA,Rural,15,Illiterate,993,1643,2636
4564,16,State - TRIPURA,Rural,16,Illiterate,998,1650,2648
4565,16,State - TRIPURA,Rural,17,Illiterate,959,1628,2587
4566,16,State - TRIPURA,Rural,18,Illiterate,1328,2833,4161
4567,16,State - TRIPURA,Rural,19,Illiterate,986,2453,3439
4568,16,State - TRIPURA,Rural,20-24,Illiterate,6834,14966,21800
4569,16,State - TRIPURA,Rural,25-29,Illiterate,8370,16881,25251
4570,16,State - TRIPURA,Rural,30-34,Illiterate,7823,15630,23453
4571,16,State - TRIPURA,Rural,35-39,Illiterate,9184,19898,29082
4572,16,State - TRIPURA,Rural,40-44,Illiterate,10363,21508,31871
4573,16,State - TRIPURA,Rural,45-49,Illiterate,11227,21880,33107
4574,16,State - TRIPURA,Rural,50-54,Illiterate,10628,19036,29664
4575,16,State - TRIPURA,Rural,55-59,Illiterate,7769,16238,24007
4576,16,State - TRIPURA,Rural,60-64,Illiterate,8054,17514,25568
4577,16,State - TRIPURA,Rural,65-69,Illiterate,6419,14768,21187
4578,16,State - TRIPURA,Rural,70-74,Illiterate,5531,12325,17856
4579,16,State - TRIPURA,Rural,75-79,Illiterate,3115,7449,10564
4580,16,State - TRIPURA,Rural,80+,Illiterate,4746,11296,16042
4581,16,State - TRIPURA,Rural,Age not stated,Illiterate,132,158,290
4582,16,State - TRIPURA,Urban,All ages,Illiterate,67337,82106,149443
4583,16,State - TRIPURA,Urban,0-6,Illiterate,47608,45097,92705
4584,16,State - TRIPURA,Urban,7,Illiterate,873,847,1720
4585,16,State - TRIPURA,Urban,8,Illiterate,238,214,452
4586,16,State - TRIPURA,Urban,9,Illiterate,177,148,325
4587,16,State - TRIPURA,Urban,10,Illiterate,235,207,442
4588,16,State - TRIPURA,Urban,11,Illiterate,133,128,261
4589,16,State - TRIPURA,Urban,12,Illiterate,139,110,249
4590,16,State - TRIPURA,Urban,13,Illiterate,108,84,192
4591,16,State - TRIPURA,Urban,14,Illiterate,134,117,251
4592,16,State - TRIPURA,Urban,15,Illiterate,143,152,295
4593,16,State - TRIPURA,Urban,16,Illiterate,131,165,296
4594,16,State - TRIPURA,Urban,17,Illiterate,163,173,336
4595,16,State - TRIPURA,Urban,18,Illiterate,234,272,506
4596,16,State - TRIPURA,Urban,19,Illiterate,177,232,409
4597,16,State - TRIPURA,Urban,20-24,Illiterate,1067,1479,2546
4598,16,State - TRIPURA,Urban,25-29,Illiterate,1255,1791,3046
4599,16,State - TRIPURA,Urban,30-34,Illiterate,1206,1857,3063
4600,16,State - TRIPURA,Urban,35-39,Illiterate,1556,2789,4345
4601,16,State - TRIPURA,Urban,40-44,Illiterate,1917,3335,5252
4602,16,State - TRIPURA,Urban,45-49,Illiterate,2075,3513,5588
4603,16,State - TRIPURA,Urban,50-54,Illiterate,1895,3284,5179
4604,16,State - TRIPURA,Urban,55-59,Illiterate,1387,2740,4127
4605,16,State - TRIPURA,Urban,60-64,Illiterate,1331,3195,4526
4606,16,State - TRIPURA,Urban,65-69,Illiterate,999,2792,3791
4607,16,State - TRIPURA,Urban,70-74,Illiterate,869,2694,3563
4608,16,State - TRIPURA,Urban,75-79,Illiterate,539,1842,2381
4609,16,State - TRIPURA,Urban,80+,Illiterate,710,2794,3504
4610,16,State - TRIPURA,Urban,Age not stated,Illiterate,38,55,93
4611,17,State - MEGHALAYA,Total,All ages,Illiterate,577953,603931,1181884
4612,17,State - MEGHALAYA,Total,0-6,Illiterate,288646,279890,568536
4613,17,State - MEGHALAYA,Total,7,Illiterate,18177,16873,35050
4614,17,State - MEGHALAYA,Total,8,Illiterate,11781,10690,22471
4615,17,State - MEGHALAYA,Total,9,Illiterate,9037,7771,16808
4616,17,State - MEGHALAYA,Total,10,Illiterate,9245,7654,16899
4617,17,State - MEGHALAYA,Total,11,Illiterate,6285,4996,11281
4618,17,State - MEGHALAYA,Total,12,Illiterate,5397,4051,9448
4619,17,State - MEGHALAYA,Total,13,Illiterate,4482,3326,7808
4620,17,State - MEGHALAYA,Total,14,Illiterate,4367,3173,7540
4621,17,State - MEGHALAYA,Total,15,Illiterate,4802,3328,8130
4622,17,State - MEGHALAYA,Total,16,Illiterate,4649,3288,7937
4623,17,State - MEGHALAYA,Total,17,Illiterate,4432,3271,7703
4624,17,State - MEGHALAYA,Total,18,Illiterate,5157,4321,9478
4625,17,State - MEGHALAYA,Total,19,Illiterate,4287,4265,8552
4626,17,State - MEGHALAYA,Total,20-24,Illiterate,25200,26140,51340
4627,17,State - MEGHALAYA,Total,25-29,Illiterate,26793,29634,56427
4628,17,State - MEGHALAYA,Total,30-34,Illiterate,22911,25506,48417
4629,17,State - MEGHALAYA,Total,35-39,Illiterate,23914,29442,53356
4630,17,State - MEGHALAYA,Total,40-44,Illiterate,21756,28233,49989
4631,17,State - MEGHALAYA,Total,45-49,Illiterate,20125,27034,47159
4632,17,State - MEGHALAYA,Total,50-54,Illiterate,16095,20518,36613
4633,17,State - MEGHALAYA,Total,55-59,Illiterate,10785,15295,26080
4634,17,State - MEGHALAYA,Total,60-64,Illiterate,10103,14388,24491
4635,17,State - MEGHALAYA,Total,65-69,Illiterate,7297,11109,18406
4636,17,State - MEGHALAYA,Total,70-74,Illiterate,5277,8279,13556
4637,17,State - MEGHALAYA,Total,75-79,Illiterate,2686,4685,7371
4638,17,State - MEGHALAYA,Total,80+,Illiterate,3238,5781,9019
4639,17,State - MEGHALAYA,Total,Age not stated,Illiterate,1029,990,2019
4640,17,State - MEGHALAYA,Rural,All ages,Illiterate,518624,537661,1056285
4641,17,State - MEGHALAYA,Rural,0-6,Illiterate,248751,241841,490592
4642,17,State - MEGHALAYA,Rural,7,Illiterate,16748,15611,32359
4643,17,State - MEGHALAYA,Rural,8,Illiterate,11240,10219,21459
4644,17,State - MEGHALAYA,Rural,9,Illiterate,8575,7416,15991
4645,17,State - MEGHALAYA,Rural,10,Illiterate,8842,7273,16115
4646,17,State - MEGHALAYA,Rural,11,Illiterate,6042,4766,10808
4647,17,State - MEGHALAYA,Rural,12,Illiterate,5205,3861,9066
4648,17,State - MEGHALAYA,Rural,13,Illiterate,4294,3152,7446
4649,17,State - MEGHALAYA,Rural,14,Illiterate,4149,2971,7120
4650,17,State - MEGHALAYA,Rural,15,Illiterate,4568,3075,7643
4651,17,State - MEGHALAYA,Rural,16,Illiterate,4414,3042,7456
4652,17,State - MEGHALAYA,Rural,17,Illiterate,4187,3045,7232
4653,17,State - MEGHALAYA,Rural,18,Illiterate,4881,4008,8889
4654,17,State - MEGHALAYA,Rural,19,Illiterate,4003,3972,7975
4655,17,State - MEGHALAYA,Rural,20-24,Illiterate,23610,24319,47929
4656,17,State - MEGHALAYA,Rural,25-29,Illiterate,25005,27389,52394
4657,17,State - MEGHALAYA,Rural,30-34,Illiterate,21262,23270,44532
4658,17,State - MEGHALAYA,Rural,35-39,Illiterate,22070,26721,48791
4659,17,State - MEGHALAYA,Rural,40-44,Illiterate,20102,25657,45759
4660,17,State - MEGHALAYA,Rural,45-49,Illiterate,18590,24485,43075
4661,17,State - MEGHALAYA,Rural,50-54,Illiterate,14862,18348,33210
4662,17,State - MEGHALAYA,Rural,55-59,Illiterate,9992,13658,23650
4663,17,State - MEGHALAYA,Rural,60-64,Illiterate,9298,12840,22138
4664,17,State - MEGHALAYA,Rural,65-69,Illiterate,6747,9848,16595
4665,17,State - MEGHALAYA,Rural,70-74,Illiterate,4836,7196,12032
4666,17,State - MEGHALAYA,Rural,75-79,Illiterate,2441,3950,6391
4667,17,State - MEGHALAYA,Rural,80+,Illiterate,2933,4809,7742
4668,17,State - MEGHALAYA,Rural,Age not stated,Illiterate,977,919,1896
4669,17,State - MEGHALAYA,Urban,All ages,Illiterate,59329,66270,125599
4670,17,State - MEGHALAYA,Urban,0-6,Illiterate,39895,38049,77944
4671,17,State - MEGHALAYA,Urban,7,Illiterate,1429,1262,2691
4672,17,State - MEGHALAYA,Urban,8,Illiterate,541,471,1012
4673,17,State - MEGHALAYA,Urban,9,Illiterate,462,355,817
4674,17,State - MEGHALAYA,Urban,10,Illiterate,403,381,784
4675,17,State - MEGHALAYA,Urban,11,Illiterate,243,230,473
4676,17,State - MEGHALAYA,Urban,12,Illiterate,192,190,382
4677,17,State - MEGHALAYA,Urban,13,Illiterate,188,174,362
4678,17,State - MEGHALAYA,Urban,14,Illiterate,218,202,420
4679,17,State - MEGHALAYA,Urban,15,Illiterate,234,253,487
4680,17,State - MEGHALAYA,Urban,16,Illiterate,235,246,481
4681,17,State - MEGHALAYA,Urban,17,Illiterate,245,226,471
4682,17,State - MEGHALAYA,Urban,18,Illiterate,276,313,589
4683,17,State - MEGHALAYA,Urban,19,Illiterate,284,293,577
4684,17,State - MEGHALAYA,Urban,20-24,Illiterate,1590,1821,3411
4685,17,State - MEGHALAYA,Urban,25-29,Illiterate,1788,2245,4033
4686,17,State - MEGHALAYA,Urban,30-34,Illiterate,1649,2236,3885
4687,17,State - MEGHALAYA,Urban,35-39,Illiterate,1844,2721,4565
4688,17,State - MEGHALAYA,Urban,40-44,Illiterate,1654,2576,4230
4689,17,State - MEGHALAYA,Urban,45-49,Illiterate,1535,2549,4084
4690,17,State - MEGHALAYA,Urban,50-54,Illiterate,1233,2170,3403
4691,17,State - MEGHALAYA,Urban,55-59,Illiterate,793,1637,2430
4692,17,State - MEGHALAYA,Urban,60-64,Illiterate,805,1548,2353
4693,17,State - MEGHALAYA,Urban,65-69,Illiterate,550,1261,1811
4694,17,State - MEGHALAYA,Urban,70-74,Illiterate,441,1083,1524
4695,17,State - MEGHALAYA,Urban,75-79,Illiterate,245,735,980
4696,17,State - MEGHALAYA,Urban,80+,Illiterate,305,972,1277
4697,17,State - MEGHALAYA,Urban,Age not stated,Illiterate,52,71,123
4698,18,State - ASSAM,Total,All ages,Illiterate,5370804,6656795,12027599
4699,18,State - ASSAM,Total,0-6,Illiterate,2363485,2274645,4638130
4700,18,State - ASSAM,Total,7,Illiterate,113382,112760,226142
4701,18,State - ASSAM,Total,8,Illiterate,72232,72686,144918
4702,18,State - ASSAM,Total,9,Illiterate,47968,48247,96215
4703,18,State - ASSAM,Total,10,Illiterate,56599,54953,111552
4704,18,State - ASSAM,Total,11,Illiterate,37199,36478,73677
4705,18,State - ASSAM,Total,12,Illiterate,44376,41841,86217
4706,18,State - ASSAM,Total,13,Illiterate,35318,34972,70290
4707,18,State - ASSAM,Total,14,Illiterate,37215,36222,73437
4708,18,State - ASSAM,Total,15,Illiterate,45788,41179,86967
4709,18,State - ASSAM,Total,16,Illiterate,43951,39701,83652
4710,18,State - ASSAM,Total,17,Illiterate,35916,34354,70270
4711,18,State - ASSAM,Total,18,Illiterate,53488,64290,117778
4712,18,State - ASSAM,Total,19,Illiterate,36343,55926,92269
4713,18,State - ASSAM,Total,20-24,Illiterate,229984,370758,600742
4714,18,State - ASSAM,Total,25-29,Illiterate,282987,436582,719569
4715,18,State - ASSAM,Total,30-34,Illiterate,263809,404711,668520
4716,18,State - ASSAM,Total,35-39,Illiterate,294763,452091,746854
4717,18,State - ASSAM,Total,40-44,Illiterate,278568,409531,688099
4718,18,State - ASSAM,Total,45-49,Illiterate,260651,383804,644455
4719,18,State - ASSAM,Total,50-54,Illiterate,206044,306858,512902
4720,18,State - ASSAM,Total,55-59,Illiterate,139404,231980,371384
4721,18,State - ASSAM,Total,60-64,Illiterate,137555,248318,385873
4722,18,State - ASSAM,Total,65-69,Illiterate,84658,167648,252306
4723,18,State - ASSAM,Total,70-74,Illiterate,79062,140393,219455
4724,18,State - ASSAM,Total,75-79,Illiterate,36683,64146,100829
4725,18,State - ASSAM,Total,80+,Illiterate,50233,87693,137926
4726,18,State - ASSAM,Total,Age not stated,Illiterate,3143,4028,7171
4727,18,State - ASSAM,Rural,All ages,Illiterate,4972796,6148802,11121598
4728,18,State - ASSAM,Rural,0-6,Illiterate,2131586,2055737,4187323
4729,18,State - ASSAM,Rural,7,Illiterate,107200,106477,213677
4730,18,State - ASSAM,Rural,8,Illiterate,69407,69838,139245
4731,18,State - ASSAM,Rural,9,Illiterate,45883,46135,92018
4732,18,State - ASSAM,Rural,10,Illiterate,53942,52308,106250
4733,18,State - ASSAM,Rural,11,Illiterate,35509,34684,70193
4734,18,State - ASSAM,Rural,12,Illiterate,42546,39933,82479
4735,18,State - ASSAM,Rural,13,Illiterate,33837,33251,67088
4736,18,State - ASSAM,Rural,14,Illiterate,35569,34214,69783
4737,18,State - ASSAM,Rural,15,Illiterate,43753,38889,82642
4738,18,State - ASSAM,Rural,16,Illiterate,42093,37469,79562
4739,18,State - ASSAM,Rural,17,Illiterate,34146,32333,66479
4740,18,State - ASSAM,Rural,18,Illiterate,50881,60941,111822
4741,18,State - ASSAM,Rural,19,Illiterate,34464,53026,87490
4742,18,State - ASSAM,Rural,20-24,Illiterate,218280,351112,569392
4743,18,State - ASSAM,Rural,25-29,Illiterate,269026,412493,681519
4744,18,State - ASSAM,Rural,30-34,Illiterate,249794,380079,629873
4745,18,State - ASSAM,Rural,35-39,Illiterate,277753,421633,699386
4746,18,State - ASSAM,Rural,40-44,Illiterate,261325,380774,642099
4747,18,State - ASSAM,Rural,45-49,Illiterate,244500,356225,600725
4748,18,State - ASSAM,Rural,50-54,Illiterate,193180,284182,477362
4749,18,State - ASSAM,Rural,55-59,Illiterate,130901,215454,346355
4750,18,State - ASSAM,Rural,60-64,Illiterate,129125,229184,358309
4751,18,State - ASSAM,Rural,65-69,Illiterate,79503,154101,233604
4752,18,State - ASSAM,Rural,70-74,Illiterate,74132,128097,202229
4753,18,State - ASSAM,Rural,75-79,Illiterate,34379,57730,92109
4754,18,State - ASSAM,Rural,80+,Illiterate,47216,78889,126105
4755,18,State - ASSAM,Rural,Age not stated,Illiterate,2866,3614,6480
4756,18,State - ASSAM,Urban,All ages,Illiterate,398008,507993,906001
4757,18,State - ASSAM,Urban,0-6,Illiterate,231899,218908,450807
4758,18,State - ASSAM,Urban,7,Illiterate,6182,6283,12465
4759,18,State - ASSAM,Urban,8,Illiterate,2825,2848,5673
4760,18,State - ASSAM,Urban,9,Illiterate,2085,2112,4197
4761,18,State - ASSAM,Urban,10,Illiterate,2657,2645,5302
4762,18,State - ASSAM,Urban,11,Illiterate,1690,1794,3484
4763,18,State - ASSAM,Urban,12,Illiterate,1830,1908,3738
4764,18,State - ASSAM,Urban,13,Illiterate,1481,1721,3202
4765,18,State - ASSAM,Urban,14,Illiterate,1646,2008,3654
4766,18,State - ASSAM,Urban,15,Illiterate,2035,2290,4325
4767,18,State - ASSAM,Urban,16,Illiterate,1858,2232,4090
4768,18,State - ASSAM,Urban,17,Illiterate,1770,2021,3791
4769,18,State - ASSAM,Urban,18,Illiterate,2607,3349,5956
4770,18,State - ASSAM,Urban,19,Illiterate,1879,2900,4779
4771,18,State - ASSAM,Urban,20-24,Illiterate,11704,19646,31350
4772,18,State - ASSAM,Urban,25-29,Illiterate,13961,24089,38050
4773,18,State - ASSAM,Urban,30-34,Illiterate,14015,24632,38647
4774,18,State - ASSAM,Urban,35-39,Illiterate,17010,30458,47468
4775,18,State - ASSAM,Urban,40-44,Illiterate,17243,28757,46000
4776,18,State - ASSAM,Urban,45-49,Illiterate,16151,27579,43730
4777,18,State - ASSAM,Urban,50-54,Illiterate,12864,22676,35540
4778,18,State - ASSAM,Urban,55-59,Illiterate,8503,16526,25029
4779,18,State - ASSAM,Urban,60-64,Illiterate,8430,19134,27564
4780,18,State - ASSAM,Urban,65-69,Illiterate,5155,13547,18702
4781,18,State - ASSAM,Urban,70-74,Illiterate,4930,12296,17226
4782,18,State - ASSAM,Urban,75-79,Illiterate,2304,6416,8720
4783,18,State - ASSAM,Urban,80+,Illiterate,3017,8804,11821
4784,18,State - ASSAM,Urban,Age not stated,Illiterate,277,414,691
4785,19,State - WEST BENGAL,Total,All ages,Illiterate,12990217,16747617,29737834
4786,19,State - WEST BENGAL,Total,0-6,Illiterate,5410396,5171070,10581466
4787,19,State - WEST BENGAL,Total,7,Illiterate,187958,182341,370299
4788,19,State - WEST BENGAL,Total,8,Illiterate,102865,99552,202417
4789,19,State - WEST BENGAL,Total,9,Illiterate,67605,64365,131970
4790,19,State - WEST BENGAL,Total,10,Illiterate,89602,82491,172093
4791,19,State - WEST BENGAL,Total,11,Illiterate,57544,52537,110081
4792,19,State - WEST BENGAL,Total,12,Illiterate,71747,63991,135738
4793,19,State - WEST BENGAL,Total,13,Illiterate,58508,55198,113706
4794,19,State - WEST BENGAL,Total,14,Illiterate,67846,64641,132487
4795,19,State - WEST BENGAL,Total,15,Illiterate,81760,77991,159751
4796,19,State - WEST BENGAL,Total,16,Illiterate,84444,81807,166251
4797,19,State - WEST BENGAL,Total,17,Illiterate,73198,73609,146807
4798,19,State - WEST BENGAL,Total,18,Illiterate,115146,138358,253504
4799,19,State - WEST BENGAL,Total,19,Illiterate,79049,115050,194099
4800,19,State - WEST BENGAL,Total,20-24,Illiterate,553798,798015,1351813
4801,19,State - WEST BENGAL,Total,25-29,Illiterate,648674,940757,1589431
4802,19,State - WEST BENGAL,Total,30-34,Illiterate,639276,958370,1597646
4803,19,State - WEST BENGAL,Total,35-39,Illiterate,761201,1224933,1986134
4804,19,State - WEST BENGAL,Total,40-44,Illiterate,818991,1209062,2028053
4805,19,State - WEST BENGAL,Total,45-49,Illiterate,762069,1119796,1881865
4806,19,State - WEST BENGAL,Total,50-54,Illiterate,639665,930413,1570078
4807,19,State - WEST BENGAL,Total,55-59,Illiterate,451167,779118,1230285
4808,19,State - WEST BENGAL,Total,60-64,Illiterate,416486,793817,1210303
4809,19,State - WEST BENGAL,Total,65-69,Illiterate,289768,622469,912237
4810,19,State - WEST BENGAL,Total,70-74,Illiterate,213394,472943,686337
4811,19,State - WEST BENGAL,Total,75-79,Illiterate,105830,250566,356396
4812,19,State - WEST BENGAL,Total,80+,Illiterate,129361,308625,437986
4813,19,State - WEST BENGAL,Total,Age not stated,Illiterate,12869,15732,28601
4814,19,State - WEST BENGAL,Rural,All ages,Illiterate,9996748,12972586,22969334
4815,19,State - WEST BENGAL,Rural,0-6,Illiterate,3992655,3828055,7820710
4816,19,State - WEST BENGAL,Rural,7,Illiterate,148019,143799,291818
4817,19,State - WEST BENGAL,Rural,8,Illiterate,81605,78464,160069
4818,19,State - WEST BENGAL,Rural,9,Illiterate,52181,49542,101723
4819,19,State - WEST BENGAL,Rural,10,Illiterate,68141,62991,131132
4820,19,State - WEST BENGAL,Rural,11,Illiterate,43397,39780,83177
4821,19,State - WEST BENGAL,Rural,12,Illiterate,55358,49891,105249
4822,19,State - WEST BENGAL,Rural,13,Illiterate,45239,42851,88090
4823,19,State - WEST BENGAL,Rural,14,Illiterate,52355,50215,102570
4824,19,State - WEST BENGAL,Rural,15,Illiterate,63470,60626,124096
4825,19,State - WEST BENGAL,Rural,16,Illiterate,65735,63779,129514
4826,19,State - WEST BENGAL,Rural,17,Illiterate,55933,56561,112494
4827,19,State - WEST BENGAL,Rural,18,Illiterate,88682,108685,197367
4828,19,State - WEST BENGAL,Rural,19,Illiterate,60055,90279,150334
4829,19,State - WEST BENGAL,Rural,20-24,Illiterate,432966,636232,1069198
4830,19,State - WEST BENGAL,Rural,25-29,Illiterate,513977,751078,1265055
4831,19,State - WEST BENGAL,Rural,30-34,Illiterate,506111,763956,1270067
4832,19,State - WEST BENGAL,Rural,35-39,Illiterate,605611,976940,1582551
4833,19,State - WEST BENGAL,Rural,40-44,Illiterate,655202,965791,1620993
4834,19,State - WEST BENGAL,Rural,45-49,Illiterate,609069,883411,1492480
4835,19,State - WEST BENGAL,Rural,50-54,Illiterate,512533,732016,1244549
4836,19,State - WEST BENGAL,Rural,55-59,Illiterate,361111,617050,978161
4837,19,State - WEST BENGAL,Rural,60-64,Illiterate,331917,627839,959756
4838,19,State - WEST BENGAL,Rural,65-69,Illiterate,234226,496597,730823
4839,19,State - WEST BENGAL,Rural,70-74,Illiterate,169203,366572,535775
4840,19,State - WEST BENGAL,Rural,75-79,Illiterate,84461,192924,277385
4841,19,State - WEST BENGAL,Rural,80+,Illiterate,100224,226966,327190
4842,19,State - WEST BENGAL,Rural,Age not stated,Illiterate,7312,9696,17008
4843,19,State - WEST BENGAL,Urban,All ages,Illiterate,2993469,3775031,6768500
4844,19,State - WEST BENGAL,Urban,0-6,Illiterate,1417741,1343015,2760756
4845,19,State - WEST BENGAL,Urban,7,Illiterate,39939,38542,78481
4846,19,State - WEST BENGAL,Urban,8,Illiterate,21260,21088,42348
4847,19,State - WEST BENGAL,Urban,9,Illiterate,15424,14823,30247
4848,19,State - WEST BENGAL,Urban,10,Illiterate,21461,19500,40961
4849,19,State - WEST BENGAL,Urban,11,Illiterate,14147,12757,26904
4850,19,State - WEST BENGAL,Urban,12,Illiterate,16389,14100,30489
4851,19,State - WEST BENGAL,Urban,13,Illiterate,13269,12347,25616
4852,19,State - WEST BENGAL,Urban,14,Illiterate,15491,14426,29917
4853,19,State - WEST BENGAL,Urban,15,Illiterate,18290,17365,35655
4854,19,State - WEST BENGAL,Urban,16,Illiterate,18709,18028,36737
4855,19,State - WEST BENGAL,Urban,17,Illiterate,17265,17048,34313
4856,19,State - WEST BENGAL,Urban,18,Illiterate,26464,29673,56137
4857,19,State - WEST BENGAL,Urban,19,Illiterate,18994,24771,43765
4858,19,State - WEST BENGAL,Urban,20-24,Illiterate,120832,161783,282615
4859,19,State - WEST BENGAL,Urban,25-29,Illiterate,134697,189679,324376
4860,19,State - WEST BENGAL,Urban,30-34,Illiterate,133165,194414,327579
4861,19,State - WEST BENGAL,Urban,35-39,Illiterate,155590,247993,403583
4862,19,State - WEST BENGAL,Urban,40-44,Illiterate,163789,243271,407060
4863,19,State - WEST BENGAL,Urban,45-49,Illiterate,153000,236385,389385
4864,19,State - WEST BENGAL,Urban,50-54,Illiterate,127132,198397,325529
4865,19,State - WEST BENGAL,Urban,55-59,Illiterate,90056,162068,252124
4866,19,State - WEST BENGAL,Urban,60-64,Illiterate,84569,165978,250547
4867,19,State - WEST BENGAL,Urban,65-69,Illiterate,55542,125872,181414
4868,19,State - WEST BENGAL,Urban,70-74,Illiterate,44191,106371,150562
4869,19,State - WEST BENGAL,Urban,75-79,Illiterate,21369,57642,79011
4870,19,State - WEST BENGAL,Urban,80+,Illiterate,29137,81659,110796
4871,19,State - WEST BENGAL,Urban,Age not stated,Illiterate,5557,6036,11593
4872,20,State - JHARKHAND,Total,All ages,Illiterate,6047796,8612269,14660065
4873,20,State - JHARKHAND,Total,0-6,Illiterate,2767147,2622348,5389495
4874,20,State - JHARKHAND,Total,7,Illiterate,119734,127053,246787
4875,20,State - JHARKHAND,Total,8,Illiterate,78229,87492,165721
4876,20,State - JHARKHAND,Total,9,Illiterate,41148,47346,88494
4877,20,State - JHARKHAND,Total,10,Illiterate,57013,65453,122466
4878,20,State - JHARKHAND,Total,11,Illiterate,27862,34792,62654
4879,20,State - JHARKHAND,Total,12,Illiterate,39475,51503,90978
4880,20,State - JHARKHAND,Total,13,Illiterate,25296,36299,61595
4881,20,State - JHARKHAND,Total,14,Illiterate,29421,42437,71858
4882,20,State - JHARKHAND,Total,15,Illiterate,40418,53742,94160
4883,20,State - JHARKHAND,Total,16,Illiterate,36063,51444,87507
4884,20,State - JHARKHAND,Total,17,Illiterate,26294,41922,68216
4885,20,State - JHARKHAND,Total,18,Illiterate,52381,94862,147243
4886,20,State - JHARKHAND,Total,19,Illiterate,27567,68171,95738
4887,20,State - JHARKHAND,Total,20-24,Illiterate,219675,516675,736350
4888,20,State - JHARKHAND,Total,25-29,Illiterate,271312,596932,868244
4889,20,State - JHARKHAND,Total,30-34,Illiterate,278751,604019,882770
4890,20,State - JHARKHAND,Total,35-39,Illiterate,305136,621128,926264
4891,20,State - JHARKHAND,Total,40-44,Illiterate,304348,561862,866210
4892,20,State - JHARKHAND,Total,45-49,Illiterate,290608,511547,802155
4893,20,State - JHARKHAND,Total,50-54,Illiterate,245278,407541,652819
4894,20,State - JHARKHAND,Total,55-59,Illiterate,185905,377617,563522
4895,20,State - JHARKHAND,Total,60-64,Illiterate,215571,389173,604744
4896,20,State - JHARKHAND,Total,65-69,Illiterate,148227,263361,411588
4897,20,State - JHARKHAND,Total,70-74,Illiterate,108584,166889,275473
4898,20,State - JHARKHAND,Total,75-79,Illiterate,40077,70391,110468
4899,20,State - JHARKHAND,Total,80+,Illiterate,48891,76182,125073
4900,20,State - JHARKHAND,Total,Age not stated,Illiterate,17385,24088,41473
4901,20,State - JHARKHAND,Rural,All ages,Illiterate,5093755,7318240,12411995
4902,20,State - JHARKHAND,Rural,0-6,Illiterate,2231494,2136013,4367507
4903,20,State - JHARKHAND,Rural,7,Illiterate,101734,109440,211174
4904,20,State - JHARKHAND,Rural,8,Illiterate,68244,77378,145622
4905,20,State - JHARKHAND,Rural,9,Illiterate,35479,41514,76993
4906,20,State - JHARKHAND,Rural,10,Illiterate,49087,57382,106469
4907,20,State - JHARKHAND,Rural,11,Illiterate,23513,30258,53771
4908,20,State - JHARKHAND,Rural,12,Illiterate,33942,45640,79582
4909,20,State - JHARKHAND,Rural,13,Illiterate,21421,31853,53274
4910,20,State - JHARKHAND,Rural,14,Illiterate,24882,37018,61900
4911,20,State - JHARKHAND,Rural,15,Illiterate,34550,47178,81728
4912,20,State - JHARKHAND,Rural,16,Illiterate,30368,44910,75278
4913,20,State - JHARKHAND,Rural,17,Illiterate,21658,36483,58141
4914,20,State - JHARKHAND,Rural,18,Illiterate,44049,84227,128276
4915,20,State - JHARKHAND,Rural,19,Illiterate,22792,60552,83344
4916,20,State - JHARKHAND,Rural,20-24,Illiterate,188171,459751,647922
4917,20,State - JHARKHAND,Rural,25-29,Illiterate,236416,528014,764430
4918,20,State - JHARKHAND,Rural,30-34,Illiterate,243972,530284,774256
4919,20,State - JHARKHAND,Rural,35-39,Illiterate,266724,536209,802933
4920,20,State - JHARKHAND,Rural,40-44,Illiterate,265911,481529,747440
4921,20,State - JHARKHAND,Rural,45-49,Illiterate,255319,433840,689159
4922,20,State - JHARKHAND,Rural,50-54,Illiterate,215907,342105,558012
4923,20,State - JHARKHAND,Rural,55-59,Illiterate,164166,321172,485338
4924,20,State - JHARKHAND,Rural,60-64,Illiterate,193061,335907,528968
4925,20,State - JHARKHAND,Rural,65-69,Illiterate,134252,229621,363873
4926,20,State - JHARKHAND,Rural,70-74,Illiterate,97751,143025,240776
4927,20,State - JHARKHAND,Rural,75-79,Illiterate,35872,59803,95675
4928,20,State - JHARKHAND,Rural,80+,Illiterate,42876,62397,105273
4929,20,State - JHARKHAND,Rural,Age not stated,Illiterate,10144,14737,24881
4930,20,State - JHARKHAND,Urban,All ages,Illiterate,954041,1294029,2248070
4931,20,State - JHARKHAND,Urban,0-6,Illiterate,535653,486335,1021988
4932,20,State - JHARKHAND,Urban,7,Illiterate,18000,17613,35613
4933,20,State - JHARKHAND,Urban,8,Illiterate,9985,10114,20099
4934,20,State - JHARKHAND,Urban,9,Illiterate,5669,5832,11501
4935,20,State - JHARKHAND,Urban,10,Illiterate,7926,8071,15997
4936,20,State - JHARKHAND,Urban,11,Illiterate,4349,4534,8883
4937,20,State - JHARKHAND,Urban,12,Illiterate,5533,5863,11396
4938,20,State - JHARKHAND,Urban,13,Illiterate,3875,4446,8321
4939,20,State - JHARKHAND,Urban,14,Illiterate,4539,5419,9958
4940,20,State - JHARKHAND,Urban,15,Illiterate,5868,6564,12432
4941,20,State - JHARKHAND,Urban,16,Illiterate,5695,6534,12229
4942,20,State - JHARKHAND,Urban,17,Illiterate,4636,5439,10075
4943,20,State - JHARKHAND,Urban,18,Illiterate,8332,10635,18967
4944,20,State - JHARKHAND,Urban,19,Illiterate,4775,7619,12394
4945,20,State - JHARKHAND,Urban,20-24,Illiterate,31504,56924,88428
4946,20,State - JHARKHAND,Urban,25-29,Illiterate,34896,68918,103814
4947,20,State - JHARKHAND,Urban,30-34,Illiterate,34779,73735,108514
4948,20,State - JHARKHAND,Urban,35-39,Illiterate,38412,84919,123331
4949,20,State - JHARKHAND,Urban,40-44,Illiterate,38437,80333,118770
4950,20,State - JHARKHAND,Urban,45-49,Illiterate,35289,77707,112996
4951,20,State - JHARKHAND,Urban,50-54,Illiterate,29371,65436,94807
4952,20,State - JHARKHAND,Urban,55-59,Illiterate,21739,56445,78184
4953,20,State - JHARKHAND,Urban,60-64,Illiterate,22510,53266,75776
4954,20,State - JHARKHAND,Urban,65-69,Illiterate,13975,33740,47715
4955,20,State - JHARKHAND,Urban,70-74,Illiterate,10833,23864,34697
4956,20,State - JHARKHAND,Urban,75-79,Illiterate,4205,10588,14793
4957,20,State - JHARKHAND,Urban,80+,Illiterate,6015,13785,19800
4958,20,State - JHARKHAND,Urban,Age not stated,Illiterate,7241,9351,16592
4959,21,State - ODISHA,Total,All ages,Illiterate,6122455,9109168,15231623
4960,21,State - ODISHA,Total,0-6,Illiterate,2716497,2556697,5273194
4961,21,State - ODISHA,Total,7,Illiterate,119751,123393,243144
4962,21,State - ODISHA,Total,8,Illiterate,62990,67181,130171
4963,21,State - ODISHA,Total,9,Illiterate,35470,40209,75679
4964,21,State - ODISHA,Total,10,Illiterate,45389,51658,97047
4965,21,State - ODISHA,Total,11,Illiterate,26646,32904,59550
4966,21,State - ODISHA,Total,12,Illiterate,32355,42915,75270
4967,21,State - ODISHA,Total,13,Illiterate,24217,35283,59500
4968,21,State - ODISHA,Total,14,Illiterate,25425,39742,65167
4969,21,State - ODISHA,Total,15,Illiterate,35207,55332,90539
4970,21,State - ODISHA,Total,16,Illiterate,30872,53579,84451
4971,21,State - ODISHA,Total,17,Illiterate,25638,48059,73697
4972,21,State - ODISHA,Total,18,Illiterate,42286,84380,126666
4973,21,State - ODISHA,Total,19,Illiterate,26800,60056,86856
4974,21,State - ODISHA,Total,20-24,Illiterate,187851,426938,614789
4975,21,State - ODISHA,Total,25-29,Illiterate,236050,499028,735078
4976,21,State - ODISHA,Total,30-34,Illiterate,249248,534843,784091
4977,21,State - ODISHA,Total,35-39,Illiterate,306615,635844,942459
4978,21,State - ODISHA,Total,40-44,Illiterate,334118,633283,967401
4979,21,State - ODISHA,Total,45-49,Illiterate,328635,595554,924189
4980,21,State - ODISHA,Total,50-54,Illiterate,273359,505139,778498
4981,21,State - ODISHA,Total,55-59,Illiterate,204134,455414,659548
4982,21,State - ODISHA,Total,60-64,Illiterate,255814,529140,784954
4983,21,State - ODISHA,Total,65-69,Illiterate,176224,371747,547971
4984,21,State - ODISHA,Total,70-74,Illiterate,152486,309012,461498
4985,21,State - ODISHA,Total,75-79,Illiterate,67700,143535,211235
4986,21,State - ODISHA,Total,80+,Illiterate,83906,153208,237114
4987,21,State - ODISHA,Total,Age not stated,Illiterate,16772,25095,41867
4988,21,State - ODISHA,Rural,All ages,Illiterate,5431651,8160996,13592647
4989,21,State - ODISHA,Rural,0-6,Illiterate,2325832,2200038,4525870
4990,21,State - ODISHA,Rural,7,Illiterate,107752,111707,219459
4991,21,State - ODISHA,Rural,8,Illiterate,57501,61565,119066
4992,21,State - ODISHA,Rural,9,Illiterate,32108,36713,68821
4993,21,State - ODISHA,Rural,10,Illiterate,40805,46885,87690
4994,21,State - ODISHA,Rural,11,Illiterate,23796,30016,53812
4995,21,State - ODISHA,Rural,12,Illiterate,29078,39298,68376
4996,21,State - ODISHA,Rural,13,Illiterate,21667,32296,53963
4997,21,State - ODISHA,Rural,14,Illiterate,22803,36230,59033
4998,21,State - ODISHA,Rural,15,Illiterate,31620,50920,82540
4999,21,State - ODISHA,Rural,16,Illiterate,27543,49145,76688
5000,21,State - ODISHA,Rural,17,Illiterate,22620,43854,66474
5001,21,State - ODISHA,Rural,18,Illiterate,37479,77459,114938
5002,21,State - ODISHA,Rural,19,Illiterate,23546,54770,78316
5003,21,State - ODISHA,Rural,20-24,Illiterate,167228,388909,556137
5004,21,State - ODISHA,Rural,25-29,Illiterate,212455,453191,665646
5005,21,State - ODISHA,Rural,30-34,Illiterate,225253,486876,712129
5006,21,State - ODISHA,Rural,35-39,Illiterate,279377,577885,857262
5007,21,State - ODISHA,Rural,40-44,Illiterate,305301,575744,881045
5008,21,State - ODISHA,Rural,45-49,Illiterate,301570,540300,841870
5009,21,State - ODISHA,Rural,50-54,Illiterate,251048,456923,707971
5010,21,State - ODISHA,Rural,55-59,Illiterate,188123,416331,604454
5011,21,State - ODISHA,Rural,60-64,Illiterate,236954,483758,720712
5012,21,State - ODISHA,Rural,65-69,Illiterate,164559,341591,506150
5013,21,State - ODISHA,Rural,70-74,Illiterate,141100,280403,421503
5014,21,State - ODISHA,Rural,75-79,Illiterate,62821,130144,192965
5015,21,State - ODISHA,Rural,80+,Illiterate,76989,135782,212771
5016,21,State - ODISHA,Rural,Age not stated,Illiterate,14723,22263,36986
5017,21,State - ODISHA,Urban,All ages,Illiterate,690804,948172,1638976
5018,21,State - ODISHA,Urban,0-6,Illiterate,390665,356659,747324
5019,21,State - ODISHA,Urban,7,Illiterate,11999,11686,23685
5020,21,State - ODISHA,Urban,8,Illiterate,5489,5616,11105
5021,21,State - ODISHA,Urban,9,Illiterate,3362,3496,6858
5022,21,State - ODISHA,Urban,10,Illiterate,4584,4773,9357
5023,21,State - ODISHA,Urban,11,Illiterate,2850,2888,5738
5024,21,State - ODISHA,Urban,12,Illiterate,3277,3617,6894
5025,21,State - ODISHA,Urban,13,Illiterate,2550,2987,5537
5026,21,State - ODISHA,Urban,14,Illiterate,2622,3512,6134
5027,21,State - ODISHA,Urban,15,Illiterate,3587,4412,7999
5028,21,State - ODISHA,Urban,16,Illiterate,3329,4434,7763
5029,21,State - ODISHA,Urban,17,Illiterate,3018,4205,7223
5030,21,State - ODISHA,Urban,18,Illiterate,4807,6921,11728
5031,21,State - ODISHA,Urban,19,Illiterate,3254,5286,8540
5032,21,State - ODISHA,Urban,20-24,Illiterate,20623,38029,58652
5033,21,State - ODISHA,Urban,25-29,Illiterate,23595,45837,69432
5034,21,State - ODISHA,Urban,30-34,Illiterate,23995,47967,71962
5035,21,State - ODISHA,Urban,35-39,Illiterate,27238,57959,85197
5036,21,State - ODISHA,Urban,40-44,Illiterate,28817,57539,86356
5037,21,State - ODISHA,Urban,45-49,Illiterate,27065,55254,82319
5038,21,State - ODISHA,Urban,50-54,Illiterate,22311,48216,70527
5039,21,State - ODISHA,Urban,55-59,Illiterate,16011,39083,55094
5040,21,State - ODISHA,Urban,60-64,Illiterate,18860,45382,64242
5041,21,State - ODISHA,Urban,65-69,Illiterate,11665,30156,41821
5042,21,State - ODISHA,Urban,70-74,Illiterate,11386,28609,39995
5043,21,State - ODISHA,Urban,75-79,Illiterate,4879,13391,18270
5044,21,State - ODISHA,Urban,80+,Illiterate,6917,17426,24343
5045,21,State - ODISHA,Urban,Age not stated,Illiterate,2049,2832,4881
5046,22,State - CHHATTISGARH,Total,All ages,Illiterate,4025002,6140274,10165276
5047,22,State - CHHATTISGARH,Total,0-6,Illiterate,1859935,1801754,3661689
5048,22,State - CHHATTISGARH,Total,7,Illiterate,84596,85751,170347
5049,22,State - CHHATTISGARH,Total,8,Illiterate,38765,41189,79954
5050,22,State - CHHATTISGARH,Total,9,Illiterate,20889,22812,43701
5051,22,State - CHHATTISGARH,Total,10,Illiterate,26445,28473,54918
5052,22,State - CHHATTISGARH,Total,11,Illiterate,13942,16492,30434
5053,22,State - CHHATTISGARH,Total,12,Illiterate,17282,22108,39390
5054,22,State - CHHATTISGARH,Total,13,Illiterate,12730,18124,30854
5055,22,State - CHHATTISGARH,Total,14,Illiterate,14563,21150,35713
5056,22,State - CHHATTISGARH,Total,15,Illiterate,19787,29043,48830
5057,22,State - CHHATTISGARH,Total,16,Illiterate,18424,29090,47514
5058,22,State - CHHATTISGARH,Total,17,Illiterate,14720,25198,39918
5059,22,State - CHHATTISGARH,Total,18,Illiterate,24265,44266,68531
5060,22,State - CHHATTISGARH,Total,19,Illiterate,14874,34209,49083
5061,22,State - CHHATTISGARH,Total,20-24,Illiterate,108881,263214,372095
5062,22,State - CHHATTISGARH,Total,25-29,Illiterate,141672,315776,457448
5063,22,State - CHHATTISGARH,Total,30-34,Illiterate,156133,387743,543876
5064,22,State - CHHATTISGARH,Total,35-39,Illiterate,202333,475323,677656
5065,22,State - CHHATTISGARH,Total,40-44,Illiterate,231523,488906,720429
5066,22,State - CHHATTISGARH,Total,45-49,Illiterate,240579,436643,677222
5067,22,State - CHHATTISGARH,Total,50-54,Illiterate,187503,343809,531312
5068,22,State - CHHATTISGARH,Total,55-59,Illiterate,139504,301222,440726
5069,22,State - CHHATTISGARH,Total,60-64,Illiterate,147546,319982,467528
5070,22,State - CHHATTISGARH,Total,65-69,Illiterate,110890,244373,355263
5071,22,State - CHHATTISGARH,Total,70-74,Illiterate,89965,173897,263862
5072,22,State - CHHATTISGARH,Total,75-79,Illiterate,37874,79438,117312
5073,22,State - CHHATTISGARH,Total,80+,Illiterate,46013,85478,131491
5074,22,State - CHHATTISGARH,Total,Age not stated,Illiterate,3369,4811,8180
5075,22,State - CHHATTISGARH,Rural,All ages,Illiterate,3394414,5204591,8599005
5076,22,State - CHHATTISGARH,Rural,0-6,Illiterate,1479586,1445355,2924941
5077,22,State - CHHATTISGARH,Rural,7,Illiterate,72285,73975,146260
5078,22,State - CHHATTISGARH,Rural,8,Illiterate,34108,36740,70848
5079,22,State - CHHATTISGARH,Rural,9,Illiterate,18239,20337,38576
5080,22,State - CHHATTISGARH,Rural,10,Illiterate,22885,25224,48109
5081,22,State - CHHATTISGARH,Rural,11,Illiterate,12085,14672,26757
5082,22,State - CHHATTISGARH,Rural,12,Illiterate,15230,19936,35166
5083,22,State - CHHATTISGARH,Rural,13,Illiterate,11014,16275,27289
5084,22,State - CHHATTISGARH,Rural,14,Illiterate,12662,19005,31667
5085,22,State - CHHATTISGARH,Rural,15,Illiterate,17385,26098,43483
5086,22,State - CHHATTISGARH,Rural,16,Illiterate,16043,26234,42277
5087,22,State - CHHATTISGARH,Rural,17,Illiterate,12739,22533,35272
5088,22,State - CHHATTISGARH,Rural,18,Illiterate,21050,39908,60958
5089,22,State - CHHATTISGARH,Rural,19,Illiterate,12744,30567,43311
5090,22,State - CHHATTISGARH,Rural,20-24,Illiterate,94762,233364,328126
5091,22,State - CHHATTISGARH,Rural,25-29,Illiterate,124270,276385,400655
5092,22,State - CHHATTISGARH,Rural,30-34,Illiterate,137551,338754,476305
5093,22,State - CHHATTISGARH,Rural,35-39,Illiterate,178764,411810,590574
5094,22,State - CHHATTISGARH,Rural,40-44,Illiterate,204734,422281,627015
5095,22,State - CHHATTISGARH,Rural,45-49,Illiterate,213482,373541,587023
5096,22,State - CHHATTISGARH,Rural,50-54,Illiterate,166501,292625,459126
5097,22,State - CHHATTISGARH,Rural,55-59,Illiterate,124416,259334,383750
5098,22,State - CHHATTISGARH,Rural,60-64,Illiterate,132701,275605,408306
5099,22,State - CHHATTISGARH,Rural,65-69,Illiterate,100239,211581,311820
5100,22,State - CHHATTISGARH,Rural,70-74,Illiterate,80922,148864,229786
5101,22,State - CHHATTISGARH,Rural,75-79,Illiterate,34155,68242,102397
5102,22,State - CHHATTISGARH,Rural,80+,Illiterate,41505,71897,113402
5103,22,State - CHHATTISGARH,Rural,Age not stated,Illiterate,2357,3449,5806
5104,22,State - CHHATTISGARH,Urban,All ages,Illiterate,630588,935683,1566271
5105,22,State - CHHATTISGARH,Urban,0-6,Illiterate,380349,356399,736748
5106,22,State - CHHATTISGARH,Urban,7,Illiterate,12311,11776,24087
5107,22,State - CHHATTISGARH,Urban,8,Illiterate,4657,4449,9106
5108,22,State - CHHATTISGARH,Urban,9,Illiterate,2650,2475,5125
5109,22,State - CHHATTISGARH,Urban,10,Illiterate,3560,3249,6809
5110,22,State - CHHATTISGARH,Urban,11,Illiterate,1857,1820,3677
5111,22,State - CHHATTISGARH,Urban,12,Illiterate,2052,2172,4224
5112,22,State - CHHATTISGARH,Urban,13,Illiterate,1716,1849,3565
5113,22,State - CHHATTISGARH,Urban,14,Illiterate,1901,2145,4046
5114,22,State - CHHATTISGARH,Urban,15,Illiterate,2402,2945,5347
5115,22,State - CHHATTISGARH,Urban,16,Illiterate,2381,2856,5237
5116,22,State - CHHATTISGARH,Urban,17,Illiterate,1981,2665,4646
5117,22,State - CHHATTISGARH,Urban,18,Illiterate,3215,4358,7573
5118,22,State - CHHATTISGARH,Urban,19,Illiterate,2130,3642,5772
5119,22,State - CHHATTISGARH,Urban,20-24,Illiterate,14119,29850,43969
5120,22,State - CHHATTISGARH,Urban,25-29,Illiterate,17402,39391,56793
5121,22,State - CHHATTISGARH,Urban,30-34,Illiterate,18582,48989,67571
5122,22,State - CHHATTISGARH,Urban,35-39,Illiterate,23569,63513,87082
5123,22,State - CHHATTISGARH,Urban,40-44,Illiterate,26789,66625,93414
5124,22,State - CHHATTISGARH,Urban,45-49,Illiterate,27097,63102,90199
5125,22,State - CHHATTISGARH,Urban,50-54,Illiterate,21002,51184,72186
5126,22,State - CHHATTISGARH,Urban,55-59,Illiterate,15088,41888,56976
5127,22,State - CHHATTISGARH,Urban,60-64,Illiterate,14845,44377,59222
5128,22,State - CHHATTISGARH,Urban,65-69,Illiterate,10651,32792,43443
5129,22,State - CHHATTISGARH,Urban,70-74,Illiterate,9043,25033,34076
5130,22,State - CHHATTISGARH,Urban,75-79,Illiterate,3719,11196,14915
5131,22,State - CHHATTISGARH,Urban,80+,Illiterate,4508,13581,18089
5132,22,State - CHHATTISGARH,Urban,Age not stated,Illiterate,1012,1362,2374
5133,23,State - MADHYA PRADESH,Total,All ages,Illiterate,12437978,17337662,29775640
5134,23,State - MADHYA PRADESH,Total,0-6,Illiterate,5636172,5173223,10809395
5135,23,State - MADHYA PRADESH,Total,7,Illiterate,231135,220554,451689
5136,23,State - MADHYA PRADESH,Total,8,Illiterate,128581,126563,255144
5137,23,State - MADHYA PRADESH,Total,9,Illiterate,72231,73668,145899
5138,23,State - MADHYA PRADESH,Total,10,Illiterate,99464,100166,199630
5139,23,State - MADHYA PRADESH,Total,11,Illiterate,54673,57445,112118
5140,23,State - MADHYA PRADESH,Total,12,Illiterate,67146,73636,140782
5141,23,State - MADHYA PRADESH,Total,13,Illiterate,48897,59030,107927
5142,23,State - MADHYA PRADESH,Total,14,Illiterate,58309,70609,128918
5143,23,State - MADHYA PRADESH,Total,15,Illiterate,76032,88480,164512
5144,23,State - MADHYA PRADESH,Total,16,Illiterate,74836,93695,168531
5145,23,State - MADHYA PRADESH,Total,17,Illiterate,57039,80235,137274
5146,23,State - MADHYA PRADESH,Total,18,Illiterate,101399,161918,263317
5147,23,State - MADHYA PRADESH,Total,19,Illiterate,59190,123041,182231
5148,23,State - MADHYA PRADESH,Total,20-24,Illiterate,453809,939709,1393518
5149,23,State - MADHYA PRADESH,Total,25-29,Illiterate,534120,1100043,1634163
5150,23,State - MADHYA PRADESH,Total,30-34,Illiterate,579968,1215857,1795825
5151,23,State - MADHYA PRADESH,Total,35-39,Illiterate,645375,1296698,1942073
5152,23,State - MADHYA PRADESH,Total,40-44,Illiterate,659510,1219001,1878511
5153,23,State - MADHYA PRADESH,Total,45-49,Illiterate,605426,1087937,1693363
5154,23,State - MADHYA PRADESH,Total,50-54,Illiterate,510457,837229,1347686
5155,23,State - MADHYA PRADESH,Total,55-59,Illiterate,359925,740313,1100238
5156,23,State - MADHYA PRADESH,Total,60-64,Illiterate,420706,770391,1191097
5157,23,State - MADHYA PRADESH,Total,65-69,Illiterate,307746,604372,912118
5158,23,State - MADHYA PRADESH,Total,70-74,Illiterate,288909,475336,764245
5159,23,State - MADHYA PRADESH,Total,75-79,Illiterate,124543,234681,359224
5160,23,State - MADHYA PRADESH,Total,80+,Illiterate,168483,296254,464737
5161,23,State - MADHYA PRADESH,Total,Age not stated,Illiterate,13897,17578,31475
5162,23,State - MADHYA PRADESH,Rural,All ages,Illiterate,10094406,14181012,24275418
5163,23,State - MADHYA PRADESH,Rural,0-6,Illiterate,4329993,3995738,8325731
5164,23,State - MADHYA PRADESH,Rural,7,Illiterate,185932,178910,364842
5165,23,State - MADHYA PRADESH,Rural,8,Illiterate,106793,106420,213213
5166,23,State - MADHYA PRADESH,Rural,9,Illiterate,58450,60697,119147
5167,23,State - MADHYA PRADESH,Rural,10,Illiterate,80559,82846,163405
5168,23,State - MADHYA PRADESH,Rural,11,Illiterate,43528,47365,90893
5169,23,State - MADHYA PRADESH,Rural,12,Illiterate,55169,62630,117799
5170,23,State - MADHYA PRADESH,Rural,13,Illiterate,39274,49578,88852
5171,23,State - MADHYA PRADESH,Rural,14,Illiterate,47576,59961,107537
5172,23,State - MADHYA PRADESH,Rural,15,Illiterate,62081,75325,137406
5173,23,State - MADHYA PRADESH,Rural,16,Illiterate,61126,80469,141595
5174,23,State - MADHYA PRADESH,Rural,17,Illiterate,45147,68717,113864
5175,23,State - MADHYA PRADESH,Rural,18,Illiterate,81711,141608,223319
5176,23,State - MADHYA PRADESH,Rural,19,Illiterate,46670,107309,153979
5177,23,State - MADHYA PRADESH,Rural,20-24,Illiterate,373857,815348,1189205
5178,23,State - MADHYA PRADESH,Rural,25-29,Illiterate,450633,943845,1394478
5179,23,State - MADHYA PRADESH,Rural,30-34,Illiterate,493321,1038450,1531771
5180,23,State - MADHYA PRADESH,Rural,35-39,Illiterate,549640,1092473,1642113
5181,23,State - MADHYA PRADESH,Rural,40-44,Illiterate,563282,1019440,1582722
5182,23,State - MADHYA PRADESH,Rural,45-49,Illiterate,519011,901816,1420827
5183,23,State - MADHYA PRADESH,Rural,50-54,Illiterate,439502,687531,1127033
5184,23,State - MADHYA PRADESH,Rural,55-59,Illiterate,311730,613988,925718
5185,23,State - MADHYA PRADESH,Rural,60-64,Illiterate,365959,632032,997991
5186,23,State - MADHYA PRADESH,Rural,65-69,Illiterate,268654,498529,767183
5187,23,State - MADHYA PRADESH,Rural,70-74,Illiterate,251645,384806,636451
5188,23,State - MADHYA PRADESH,Rural,75-79,Illiterate,108496,190643,299139
5189,23,State - MADHYA PRADESH,Rural,80+,Illiterate,145120,232443,377563
5190,23,State - MADHYA PRADESH,Rural,Age not stated,Illiterate,9547,12095,21642
5191,23,State - MADHYA PRADESH,Urban,All ages,Illiterate,2343572,3156650,5500222
5192,23,State - MADHYA PRADESH,Urban,0-6,Illiterate,1306179,1177485,2483664
5193,23,State - MADHYA PRADESH,Urban,7,Illiterate,45203,41644,86847
5194,23,State - MADHYA PRADESH,Urban,8,Illiterate,21788,20143,41931
5195,23,State - MADHYA PRADESH,Urban,9,Illiterate,13781,12971,26752
5196,23,State - MADHYA PRADESH,Urban,10,Illiterate,18905,17320,36225
5197,23,State - MADHYA PRADESH,Urban,11,Illiterate,11145,10080,21225
5198,23,State - MADHYA PRADESH,Urban,12,Illiterate,11977,11006,22983
5199,23,State - MADHYA PRADESH,Urban,13,Illiterate,9623,9452,19075
5200,23,State - MADHYA PRADESH,Urban,14,Illiterate,10733,10648,21381
5201,23,State - MADHYA PRADESH,Urban,15,Illiterate,13951,13155,27106
5202,23,State - MADHYA PRADESH,Urban,16,Illiterate,13710,13226,26936
5203,23,State - MADHYA PRADESH,Urban,17,Illiterate,11892,11518,23410
5204,23,State - MADHYA PRADESH,Urban,18,Illiterate,19688,20310,39998
5205,23,State - MADHYA PRADESH,Urban,19,Illiterate,12520,15732,28252
5206,23,State - MADHYA PRADESH,Urban,20-24,Illiterate,79952,124361,204313
5207,23,State - MADHYA PRADESH,Urban,25-29,Illiterate,83487,156198,239685
5208,23,State - MADHYA PRADESH,Urban,30-34,Illiterate,86647,177407,264054
5209,23,State - MADHYA PRADESH,Urban,35-39,Illiterate,95735,204225,299960
5210,23,State - MADHYA PRADESH,Urban,40-44,Illiterate,96228,199561,295789
5211,23,State - MADHYA PRADESH,Urban,45-49,Illiterate,86415,186121,272536
5212,23,State - MADHYA PRADESH,Urban,50-54,Illiterate,70955,149698,220653
5213,23,State - MADHYA PRADESH,Urban,55-59,Illiterate,48195,126325,174520
5214,23,State - MADHYA PRADESH,Urban,60-64,Illiterate,54747,138359,193106
5215,23,State - MADHYA PRADESH,Urban,65-69,Illiterate,39092,105843,144935
5216,23,State - MADHYA PRADESH,Urban,70-74,Illiterate,37264,90530,127794
5217,23,State - MADHYA PRADESH,Urban,75-79,Illiterate,16047,44038,60085
5218,23,State - MADHYA PRADESH,Urban,80+,Illiterate,23363,63811,87174
5219,23,State - MADHYA PRADESH,Urban,Age not stated,Illiterate,4350,5483,9833
5220,24,State - GUJARAT,Total,All ages,Illiterate,8016387,11329947,19346334
5221,24,State - GUJARAT,Total,0-6,Illiterate,4115384,3661878,7777262
5222,24,State - GUJARAT,Total,7,Illiterate,126514,122980,249494
5223,24,State - GUJARAT,Total,8,Illiterate,57536,60295,117831
5224,24,State - GUJARAT,Total,9,Illiterate,36689,40223,76912
5225,24,State - GUJARAT,Total,10,Illiterate,45706,50126,95832
5226,24,State - GUJARAT,Total,11,Illiterate,29143,35784,64927
5227,24,State - GUJARAT,Total,12,Illiterate,31317,41262,72579
5228,24,State - GUJARAT,Total,13,Illiterate,26342,37444,63786
5229,24,State - GUJARAT,Total,14,Illiterate,28154,41282,69436
5230,24,State - GUJARAT,Total,15,Illiterate,38579,54266,92845
5231,24,State - GUJARAT,Total,16,Illiterate,34378,52004,86382
5232,24,State - GUJARAT,Total,17,Illiterate,32769,50294,83063
5233,24,State - GUJARAT,Total,18,Illiterate,50049,81050,131099
5234,24,State - GUJARAT,Total,19,Illiterate,36022,69088,105110
5235,24,State - GUJARAT,Total,20-24,Illiterate,251381,511515,762896
5236,24,State - GUJARAT,Total,25-29,Illiterate,279938,597655,877593
5237,24,State - GUJARAT,Total,30-34,Illiterate,313287,688331,1001618
5238,24,State - GUJARAT,Total,35-39,Illiterate,367300,747563,1114863
5239,24,State - GUJARAT,Total,40-44,Illiterate,387554,786316,1173870
5240,24,State - GUJARAT,Total,45-49,Illiterate,366529,740448,1106977
5241,24,State - GUJARAT,Total,50-54,Illiterate,335411,644380,979791
5242,24,State - GUJARAT,Total,55-59,Illiterate,244265,541240,785505
5243,24,State - GUJARAT,Total,60-64,Illiterate,253086,526512,779598
5244,24,State - GUJARAT,Total,65-69,Illiterate,174882,396949,571831
5245,24,State - GUJARAT,Total,70-74,Illiterate,159309,328784,488093
5246,24,State - GUJARAT,Total,75-79,Illiterate,69286,161608,230894
5247,24,State - GUJARAT,Total,80+,Illiterate,98612,222417,321029
5248,24,State - GUJARAT,Total,Age not stated,Illiterate,26965,38253,65218
5249,24,State - GUJARAT,Rural,All ages,Illiterate,5331516,7942251,13273767
5250,24,State - GUJARAT,Rural,0-6,Illiterate,2521455,2303448,4824903
5251,24,State - GUJARAT,Rural,7,Illiterate,81753,81673,163426
5252,24,State - GUJARAT,Rural,8,Illiterate,37766,40713,78479
5253,24,State - GUJARAT,Rural,9,Illiterate,23061,26560,49621
5254,24,State - GUJARAT,Rural,10,Illiterate,28580,32971,61551
5255,24,State - GUJARAT,Rural,11,Illiterate,18067,23804,41871
5256,24,State - GUJARAT,Rural,12,Illiterate,19998,28417,48415
5257,24,State - GUJARAT,Rural,13,Illiterate,16935,26103,43038
5258,24,State - GUJARAT,Rural,14,Illiterate,18007,29077,47084
5259,24,State - GUJARAT,Rural,15,Illiterate,24704,37989,62693
5260,24,State - GUJARAT,Rural,16,Illiterate,21889,37192,59081
5261,24,State - GUJARAT,Rural,17,Illiterate,19766,35803,55569
5262,24,State - GUJARAT,Rural,18,Illiterate,29983,59203,89186
5263,24,State - GUJARAT,Rural,19,Illiterate,21020,49383,70403
5264,24,State - GUJARAT,Rural,20-24,Illiterate,158130,368819,526949
5265,24,State - GUJARAT,Rural,25-29,Illiterate,185645,432155,617800
5266,24,State - GUJARAT,Rural,30-34,Illiterate,217425,508261,725686
5267,24,State - GUJARAT,Rural,35-39,Illiterate,264795,553263,818058
5268,24,State - GUJARAT,Rural,40-44,Illiterate,285748,585661,871409
5269,24,State - GUJARAT,Rural,45-49,Illiterate,276620,549746,826366
5270,24,State - GUJARAT,Rural,50-54,Illiterate,256307,482819,739126
5271,24,State - GUJARAT,Rural,55-59,Illiterate,191355,411286,602641
5272,24,State - GUJARAT,Rural,60-64,Illiterate,197749,394250,591999
5273,24,State - GUJARAT,Rural,65-69,Illiterate,138771,297928,436699
5274,24,State - GUJARAT,Rural,70-74,Illiterate,127980,244621,372601
5275,24,State - GUJARAT,Rural,75-79,Illiterate,55680,119889,175569
5276,24,State - GUJARAT,Rural,80+,Illiterate,76940,157645,234585
5277,24,State - GUJARAT,Rural,Age not stated,Illiterate,15387,23572,38959
5278,24,State - GUJARAT,Urban,All ages,Illiterate,2684871,3387696,6072567
5279,24,State - GUJARAT,Urban,0-6,Illiterate,1593929,1358430,2952359
5280,24,State - GUJARAT,Urban,7,Illiterate,44761,41307,86068
5281,24,State - GUJARAT,Urban,8,Illiterate,19770,19582,39352
5282,24,State - GUJARAT,Urban,9,Illiterate,13628,13663,27291
5283,24,State - GUJARAT,Urban,10,Illiterate,17126,17155,34281
5284,24,State - GUJARAT,Urban,11,Illiterate,11076,11980,23056
5285,24,State - GUJARAT,Urban,12,Illiterate,11319,12845,24164
5286,24,State - GUJARAT,Urban,13,Illiterate,9407,11341,20748
5287,24,State - GUJARAT,Urban,14,Illiterate,10147,12205,22352
5288,24,State - GUJARAT,Urban,15,Illiterate,13875,16277,30152
5289,24,State - GUJARAT,Urban,16,Illiterate,12489,14812,27301
5290,24,State - GUJARAT,Urban,17,Illiterate,13003,14491,27494
5291,24,State - GUJARAT,Urban,18,Illiterate,20066,21847,41913
5292,24,State - GUJARAT,Urban,19,Illiterate,15002,19705,34707
5293,24,State - GUJARAT,Urban,20-24,Illiterate,93251,142696,235947
5294,24,State - GUJARAT,Urban,25-29,Illiterate,94293,165500,259793
5295,24,State - GUJARAT,Urban,30-34,Illiterate,95862,180070,275932
5296,24,State - GUJARAT,Urban,35-39,Illiterate,102505,194300,296805
5297,24,State - GUJARAT,Urban,40-44,Illiterate,101806,200655,302461
5298,24,State - GUJARAT,Urban,45-49,Illiterate,89909,190702,280611
5299,24,State - GUJARAT,Urban,50-54,Illiterate,79104,161561,240665
5300,24,State - GUJARAT,Urban,55-59,Illiterate,52910,129954,182864
5301,24,State - GUJARAT,Urban,60-64,Illiterate,55337,132262,187599
5302,24,State - GUJARAT,Urban,65-69,Illiterate,36111,99021,135132
5303,24,State - GUJARAT,Urban,70-74,Illiterate,31329,84163,115492
5304,24,State - GUJARAT,Urban,75-79,Illiterate,13606,41719,55325
5305,24,State - GUJARAT,Urban,80+,Illiterate,21672,64772,86444
5306,24,State - GUJARAT,Urban,Age not stated,Illiterate,11578,14681,26259
5307,25,State - DAMAN & DIU,Total,All ages,Illiterate,25658,29183,54841
5308,25,State - DAMAN & DIU,Total,0-6,Illiterate,14144,12790,26934
5309,25,State - DAMAN & DIU,Total,7,Illiterate,370,313,683
5310,25,State - DAMAN & DIU,Total,8,Illiterate,133,128,261
5311,25,State - DAMAN & DIU,Total,9,Illiterate,73,75,148
5312,25,State - DAMAN & DIU,Total,10,Illiterate,86,95,181
5313,25,State - DAMAN & DIU,Total,11,Illiterate,48,66,114
5314,25,State - DAMAN & DIU,Total,12,Illiterate,44,47,91
5315,25,State - DAMAN & DIU,Total,13,Illiterate,42,34,76
5316,25,State - DAMAN & DIU,Total,14,Illiterate,67,50,117
5317,25,State - DAMAN & DIU,Total,15,Illiterate,111,59,170
5318,25,State - DAMAN & DIU,Total,16,Illiterate,120,63,183
5319,25,State - DAMAN & DIU,Total,17,Illiterate,210,67,277
5320,25,State - DAMAN & DIU,Total,18,Illiterate,502,135,637
5321,25,State - DAMAN & DIU,Total,19,Illiterate,335,126,461
5322,25,State - DAMAN & DIU,Total,20-24,Illiterate,1909,1229,3138
5323,25,State - DAMAN & DIU,Total,25-29,Illiterate,1542,1673,3215
5324,25,State - DAMAN & DIU,Total,30-34,Illiterate,1163,1536,2699
5325,25,State - DAMAN & DIU,Total,35-39,Illiterate,1080,1607,2687
5326,25,State - DAMAN & DIU,Total,40-44,Illiterate,883,1393,2276
5327,25,State - DAMAN & DIU,Total,45-49,Illiterate,727,1331,2058
5328,25,State - DAMAN & DIU,Total,50-54,Illiterate,498,1176,1674
5329,25,State - DAMAN & DIU,Total,55-59,Illiterate,387,1092,1479
5330,25,State - DAMAN & DIU,Total,60-64,Illiterate,404,1292,1696
5331,25,State - DAMAN & DIU,Total,65-69,Illiterate,272,962,1234
5332,25,State - DAMAN & DIU,Total,70-74,Illiterate,237,859,1096
5333,25,State - DAMAN & DIU,Total,75-79,Illiterate,113,444,557
5334,25,State - DAMAN & DIU,Total,80+,Illiterate,129,510,639
5335,25,State - DAMAN & DIU,Total,Age not stated,Illiterate,29,31,60
5336,25,State - DAMAN & DIU,Rural,All ages,Illiterate,6866,10441,17307
5337,25,State - DAMAN & DIU,Rural,0-6,Illiterate,3849,3589,7438
5338,25,State - DAMAN & DIU,Rural,7,Illiterate,129,82,211
5339,25,State - DAMAN & DIU,Rural,8,Illiterate,28,24,52
5340,25,State - DAMAN & DIU,Rural,9,Illiterate,15,10,25
5341,25,State - DAMAN & DIU,Rural,10,Illiterate,20,15,35
5342,25,State - DAMAN & DIU,Rural,11,Illiterate,10,11,21
5343,25,State - DAMAN & DIU,Rural,12,Illiterate,10,9,19
5344,25,State - DAMAN & DIU,Rural,13,Illiterate,9,7,16
5345,25,State - DAMAN & DIU,Rural,14,Illiterate,8,8,16
5346,25,State - DAMAN & DIU,Rural,15,Illiterate,12,9,21
5347,25,State - DAMAN & DIU,Rural,16,Illiterate,7,8,15
5348,25,State - DAMAN & DIU,Rural,17,Illiterate,26,11,37
5349,25,State - DAMAN & DIU,Rural,18,Illiterate,44,16,60
5350,25,State - DAMAN & DIU,Rural,19,Illiterate,34,27,61
5351,25,State - DAMAN & DIU,Rural,20-24,Illiterate,177,265,442
5352,25,State - DAMAN & DIU,Rural,25-29,Illiterate,210,425,635
5353,25,State - DAMAN & DIU,Rural,30-34,Illiterate,268,588,856
5354,25,State - DAMAN & DIU,Rural,35-39,Illiterate,318,811,1129
5355,25,State - DAMAN & DIU,Rural,40-44,Illiterate,303,759,1062
5356,25,State - DAMAN & DIU,Rural,45-49,Illiterate,305,719,1024
5357,25,State - DAMAN & DIU,Rural,50-54,Illiterate,220,672,892
5358,25,State - DAMAN & DIU,Rural,55-59,Illiterate,209,597,806
5359,25,State - DAMAN & DIU,Rural,60-64,Illiterate,222,636,858
5360,25,State - DAMAN & DIU,Rural,65-69,Illiterate,160,408,568
5361,25,State - DAMAN & DIU,Rural,70-74,Illiterate,147,348,495
5362,25,State - DAMAN & DIU,Rural,75-79,Illiterate,60,182,242
5363,25,State - DAMAN & DIU,Rural,80+,Illiterate,59,191,250
5364,25,State - DAMAN & DIU,Rural,Age not stated,Illiterate,7,14,21
5365,25,State - DAMAN & DIU,Urban,All ages,Illiterate,18792,18742,37534
5366,25,State - DAMAN & DIU,Urban,0-6,Illiterate,10295,9201,19496
5367,25,State - DAMAN & DIU,Urban,7,Illiterate,241,231,472
5368,25,State - DAMAN & DIU,Urban,8,Illiterate,105,104,209
5369,25,State - DAMAN & DIU,Urban,9,Illiterate,58,65,123
5370,25,State - DAMAN & DIU,Urban,10,Illiterate,66,80,146
5371,25,State - DAMAN & DIU,Urban,11,Illiterate,38,55,93
5372,25,State - DAMAN & DIU,Urban,12,Illiterate,34,38,72
5373,25,State - DAMAN & DIU,Urban,13,Illiterate,33,27,60
5374,25,State - DAMAN & DIU,Urban,14,Illiterate,59,42,101
5375,25,State - DAMAN & DIU,Urban,15,Illiterate,99,50,149
5376,25,State - DAMAN & DIU,Urban,16,Illiterate,113,55,168
5377,25,State - DAMAN & DIU,Urban,17,Illiterate,184,56,240
5378,25,State - DAMAN & DIU,Urban,18,Illiterate,458,119,577
5379,25,State - DAMAN & DIU,Urban,19,Illiterate,301,99,400
5380,25,State - DAMAN & DIU,Urban,20-24,Illiterate,1732,964,2696
5381,25,State - DAMAN & DIU,Urban,25-29,Illiterate,1332,1248,2580
5382,25,State - DAMAN & DIU,Urban,30-34,Illiterate,895,948,1843
5383,25,State - DAMAN & DIU,Urban,35-39,Illiterate,762,796,1558
5384,25,State - DAMAN & DIU,Urban,40-44,Illiterate,580,634,1214
5385,25,State - DAMAN & DIU,Urban,45-49,Illiterate,422,612,1034
5386,25,State - DAMAN & DIU,Urban,50-54,Illiterate,278,504,782
5387,25,State - DAMAN & DIU,Urban,55-59,Illiterate,178,495,673
5388,25,State - DAMAN & DIU,Urban,60-64,Illiterate,182,656,838
5389,25,State - DAMAN & DIU,Urban,65-69,Illiterate,112,554,666
5390,25,State - DAMAN & DIU,Urban,70-74,Illiterate,90,511,601
5391,25,State - DAMAN & DIU,Urban,75-79,Illiterate,53,262,315
5392,25,State - DAMAN & DIU,Urban,80+,Illiterate,70,319,389
5393,25,State - DAMAN & DIU,Urban,Age not stated,Illiterate,22,17,39
5394,26,State - DADRA & NAGAR HAVELI,Total,All ages,Illiterate,51239,69240,120479
5395,26,State - DADRA & NAGAR HAVELI,Total,0-6,Illiterate,26431,24464,50895
5396,26,State - DADRA & NAGAR HAVELI,Total,7,Illiterate,626,584,1210
5397,26,State - DADRA & NAGAR HAVELI,Total,8,Illiterate,224,251,475
5398,26,State - DADRA & NAGAR HAVELI,Total,9,Illiterate,135,189,324
5399,26,State - DADRA & NAGAR HAVELI,Total,10,Illiterate,193,245,438
5400,26,State - DADRA & NAGAR HAVELI,Total,11,Illiterate,98,163,261
5401,26,State - DADRA & NAGAR HAVELI,Total,12,Illiterate,89,212,301
5402,26,State - DADRA & NAGAR HAVELI,Total,13,Illiterate,84,205,289
5403,26,State - DADRA & NAGAR HAVELI,Total,14,Illiterate,97,242,339
5404,26,State - DADRA & NAGAR HAVELI,Total,15,Illiterate,138,322,460
5405,26,State - DADRA & NAGAR HAVELI,Total,16,Illiterate,168,421,589
5406,26,State - DADRA & NAGAR HAVELI,Total,17,Illiterate,187,386,573
5407,26,State - DADRA & NAGAR HAVELI,Total,18,Illiterate,377,660,1037
5408,26,State - DADRA & NAGAR HAVELI,Total,19,Illiterate,317,563,880
5409,26,State - DADRA & NAGAR HAVELI,Total,20-24,Illiterate,1993,4702,6695
5410,26,State - DADRA & NAGAR HAVELI,Total,25-29,Illiterate,2481,5344,7825
5411,26,State - DADRA & NAGAR HAVELI,Total,30-34,Illiterate,2431,4855,7286
5412,26,State - DADRA & NAGAR HAVELI,Total,35-39,Illiterate,2711,4897,7608
5413,26,State - DADRA & NAGAR HAVELI,Total,40-44,Illiterate,2750,4593,7343
5414,26,State - DADRA & NAGAR HAVELI,Total,45-49,Illiterate,2552,4082,6634
5415,26,State - DADRA & NAGAR HAVELI,Total,50-54,Illiterate,2065,3060,5125
5416,26,State - DADRA & NAGAR HAVELI,Total,55-59,Illiterate,1550,2569,4119
5417,26,State - DADRA & NAGAR HAVELI,Total,60-64,Illiterate,1454,2456,3910
5418,26,State - DADRA & NAGAR HAVELI,Total,65-69,Illiterate,984,1605,2589
5419,26,State - DADRA & NAGAR HAVELI,Total,70-74,Illiterate,606,1160,1766
5420,26,State - DADRA & NAGAR HAVELI,Total,75-79,Illiterate,233,454,687
5421,26,State - DADRA & NAGAR HAVELI,Total,80+,Illiterate,215,473,688
5422,26,State - DADRA & NAGAR HAVELI,Total,Age not stated,Illiterate,50,83,133
5423,26,State - DADRA & NAGAR HAVELI,Rural,All ages,Illiterate,34255,49717,83972
5424,26,State - DADRA & NAGAR HAVELI,Rural,0-6,Illiterate,14467,14037,28504
5425,26,State - DADRA & NAGAR HAVELI,Rural,7,Illiterate,330,341,671
5426,26,State - DADRA & NAGAR HAVELI,Rural,8,Illiterate,125,161,286
5427,26,State - DADRA & NAGAR HAVELI,Rural,9,Illiterate,86,131,217
5428,26,State - DADRA & NAGAR HAVELI,Rural,10,Illiterate,122,175,297
5429,26,State - DADRA & NAGAR HAVELI,Rural,11,Illiterate,61,126,187
5430,26,State - DADRA & NAGAR HAVELI,Rural,12,Illiterate,65,178,243
5431,26,State - DADRA & NAGAR HAVELI,Rural,13,Illiterate,58,178,236
5432,26,State - DADRA & NAGAR HAVELI,Rural,14,Illiterate,64,204,268
5433,26,State - DADRA & NAGAR HAVELI,Rural,15,Illiterate,105,290,395
5434,26,State - DADRA & NAGAR HAVELI,Rural,16,Illiterate,120,380,500
5435,26,State - DADRA & NAGAR HAVELI,Rural,17,Illiterate,134,350,484
5436,26,State - DADRA & NAGAR HAVELI,Rural,18,Illiterate,241,589,830
5437,26,State - DADRA & NAGAR HAVELI,Rural,19,Illiterate,181,473,654
5438,26,State - DADRA & NAGAR HAVELI,Rural,20-24,Illiterate,1388,3942,5330
5439,26,State - DADRA & NAGAR HAVELI,Rural,25-29,Illiterate,1893,4169,6062
5440,26,State - DADRA & NAGAR HAVELI,Rural,30-34,Illiterate,1960,3800,5760
5441,26,State - DADRA & NAGAR HAVELI,Rural,35-39,Illiterate,2225,3968,6193
5442,26,State - DADRA & NAGAR HAVELI,Rural,40-44,Illiterate,2374,3710,6084
5443,26,State - DADRA & NAGAR HAVELI,Rural,45-49,Illiterate,2199,3313,5512
5444,26,State - DADRA & NAGAR HAVELI,Rural,50-54,Illiterate,1833,2472,4305
5445,26,State - DADRA & NAGAR HAVELI,Rural,55-59,Illiterate,1339,2003,3342
5446,26,State - DADRA & NAGAR HAVELI,Rural,60-64,Illiterate,1229,1927,3156
5447,26,State - DADRA & NAGAR HAVELI,Rural,65-69,Illiterate,807,1221,2028
5448,26,State - DADRA & NAGAR HAVELI,Rural,70-74,Illiterate,481,883,1364
5449,26,State - DADRA & NAGAR HAVELI,Rural,75-79,Illiterate,183,333,516
5450,26,State - DADRA & NAGAR HAVELI,Rural,80+,Illiterate,145,297,442
5451,26,State - DADRA & NAGAR HAVELI,Rural,Age not stated,Illiterate,40,66,106
5452,26,State - DADRA & NAGAR HAVELI,Urban,All ages,Illiterate,16984,19523,36507
5453,26,State - DADRA & NAGAR HAVELI,Urban,0-6,Illiterate,11964,10427,22391
5454,26,State - DADRA & NAGAR HAVELI,Urban,7,Illiterate,296,243,539
5455,26,State - DADRA & NAGAR HAVELI,Urban,8,Illiterate,99,90,189
5456,26,State - DADRA & NAGAR HAVELI,Urban,9,Illiterate,49,58,107
5457,26,State - DADRA & NAGAR HAVELI,Urban,10,Illiterate,71,70,141
5458,26,State - DADRA & NAGAR HAVELI,Urban,11,Illiterate,37,37,74
5459,26,State - DADRA & NAGAR HAVELI,Urban,12,Illiterate,24,34,58
5460,26,State - DADRA & NAGAR HAVELI,Urban,13,Illiterate,26,27,53
5461,26,State - DADRA & NAGAR HAVELI,Urban,14,Illiterate,33,38,71
5462,26,State - DADRA & NAGAR HAVELI,Urban,15,Illiterate,33,32,65
5463,26,State - DADRA & NAGAR HAVELI,Urban,16,Illiterate,48,41,89
5464,26,State - DADRA & NAGAR HAVELI,Urban,17,Illiterate,53,36,89
5465,26,State - DADRA & NAGAR HAVELI,Urban,18,Illiterate,136,71,207
5466,26,State - DADRA & NAGAR HAVELI,Urban,19,Illiterate,136,90,226
5467,26,State - DADRA & NAGAR HAVELI,Urban,20-24,Illiterate,605,760,1365
5468,26,State - DADRA & NAGAR HAVELI,Urban,25-29,Illiterate,588,1175,1763
5469,26,State - DADRA & NAGAR HAVELI,Urban,30-34,Illiterate,471,1055,1526
5470,26,State - DADRA & NAGAR HAVELI,Urban,35-39,Illiterate,486,929,1415
5471,26,State - DADRA & NAGAR HAVELI,Urban,40-44,Illiterate,376,883,1259
5472,26,State - DADRA & NAGAR HAVELI,Urban,45-49,Illiterate,353,769,1122
5473,26,State - DADRA & NAGAR HAVELI,Urban,50-54,Illiterate,232,588,820
5474,26,State - DADRA & NAGAR HAVELI,Urban,55-59,Illiterate,211,566,777
5475,26,State - DADRA & NAGAR HAVELI,Urban,60-64,Illiterate,225,529,754
5476,26,State - DADRA & NAGAR HAVELI,Urban,65-69,Illiterate,177,384,561
5477,26,State - DADRA & NAGAR HAVELI,Urban,70-74,Illiterate,125,277,402
5478,26,State - DADRA & NAGAR HAVELI,Urban,75-79,Illiterate,50,121,171
5479,26,State - DADRA & NAGAR HAVELI,Urban,80+,Illiterate,70,176,246
5480,26,State - DADRA & NAGAR HAVELI,Urban,Age not stated,Illiterate,10,17,27
5481,27,State - MAHARASHTRA,Total,All ages,Illiterate,12985472,17834571,30820043
5482,27,State - MAHARASHTRA,Total,0-6,Illiterate,7035391,6291126,13326517
5483,27,State - MAHARASHTRA,Total,7,Illiterate,226295,211193,437488
5484,27,State - MAHARASHTRA,Total,8,Illiterate,83777,81543,165320
5485,27,State - MAHARASHTRA,Total,9,Illiterate,55308,54502,109810
5486,27,State - MAHARASHTRA,Total,10,Illiterate,71860,72029,143889
5487,27,State - MAHARASHTRA,Total,11,Illiterate,43763,45861,89624
5488,27,State - MAHARASHTRA,Total,12,Illiterate,40994,45475,86469
5489,27,State - MAHARASHTRA,Total,13,Illiterate,35442,39862,75304
5490,27,State - MAHARASHTRA,Total,14,Illiterate,38581,43269,81850
5491,27,State - MAHARASHTRA,Total,15,Illiterate,48409,53816,102225
5492,27,State - MAHARASHTRA,Total,16,Illiterate,46324,50414,96738
5493,27,State - MAHARASHTRA,Total,17,Illiterate,43627,46239,89866
5494,27,State - MAHARASHTRA,Total,18,Illiterate,64703,75793,140496
5495,27,State - MAHARASHTRA,Total,19,Illiterate,48272,65808,114080
5496,27,State - MAHARASHTRA,Total,20-24,Illiterate,325290,507461,832751
5497,27,State - MAHARASHTRA,Total,25-29,Illiterate,378439,662671,1041110
5498,27,State - MAHARASHTRA,Total,30-34,Illiterate,412295,814184,1226479
5499,27,State - MAHARASHTRA,Total,35-39,Illiterate,484336,1032156,1516492
5500,27,State - MAHARASHTRA,Total,40-44,Illiterate,546469,1103811,1650280
5501,27,State - MAHARASHTRA,Total,45-49,Illiterate,519125,1070949,1590074
5502,27,State - MAHARASHTRA,Total,50-54,Illiterate,463089,945186,1408275
5503,27,State - MAHARASHTRA,Total,55-59,Illiterate,356862,856456,1213318
5504,27,State - MAHARASHTRA,Total,60-64,Illiterate,411890,1065316,1477206
5505,27,State - MAHARASHTRA,Total,65-69,Illiterate,421180,1018449,1439629
5506,27,State - MAHARASHTRA,Total,70-74,Illiterate,366066,742334,1108400
5507,27,State - MAHARASHTRA,Total,75-79,Illiterate,172468,357121,529589
5508,27,State - MAHARASHTRA,Total,80+,Illiterate,202159,423299,625458
5509,27,State - MAHARASHTRA,Total,Age not stated,Illiterate,43058,58248,101306
5510,27,State - MAHARASHTRA,Rural,All ages,Illiterate,8147559,11925754,20073313
5511,27,State - MAHARASHTRA,Rural,0-6,Illiterate,4067399,3621555,7688954
5512,27,State - MAHARASHTRA,Rural,7,Illiterate,137582,130450,268032
5513,27,State - MAHARASHTRA,Rural,8,Illiterate,49882,50404,100286
5514,27,State - MAHARASHTRA,Rural,9,Illiterate,31882,33138,65020
5515,27,State - MAHARASHTRA,Rural,10,Illiterate,41513,43781,85294
5516,27,State - MAHARASHTRA,Rural,11,Illiterate,25331,28476,53807
5517,27,State - MAHARASHTRA,Rural,12,Illiterate,24515,29939,54454
5518,27,State - MAHARASHTRA,Rural,13,Illiterate,21261,26112,47373
5519,27,State - MAHARASHTRA,Rural,14,Illiterate,23480,28883,52363
5520,27,State - MAHARASHTRA,Rural,15,Illiterate,29825,36353,66178
5521,27,State - MAHARASHTRA,Rural,16,Illiterate,28234,34112,62346
5522,27,State - MAHARASHTRA,Rural,17,Illiterate,24898,30228,55126
5523,27,State - MAHARASHTRA,Rural,18,Illiterate,35731,51141,86872
5524,27,State - MAHARASHTRA,Rural,19,Illiterate,25018,43696,68714
5525,27,State - MAHARASHTRA,Rural,20-24,Illiterate,177013,335897,512910
5526,27,State - MAHARASHTRA,Rural,25-29,Illiterate,217021,435512,652533
5527,27,State - MAHARASHTRA,Rural,30-34,Illiterate,252200,559118,811318
5528,27,State - MAHARASHTRA,Rural,35-39,Illiterate,313174,724363,1037537
5529,27,State - MAHARASHTRA,Rural,40-44,Illiterate,373522,792591,1166113
5530,27,State - MAHARASHTRA,Rural,45-49,Illiterate,365436,769897,1135333
5531,27,State - MAHARASHTRA,Rural,50-54,Illiterate,331835,687709,1019544
5532,27,State - MAHARASHTRA,Rural,55-59,Illiterate,262981,641102,904083
5533,27,State - MAHARASHTRA,Rural,60-64,Illiterate,312454,808865,1121319
5534,27,State - MAHARASHTRA,Rural,65-69,Illiterate,343614,799143,1142757
5535,27,State - MAHARASHTRA,Rural,70-74,Illiterate,302185,570707,872892
5536,27,State - MAHARASHTRA,Rural,75-79,Illiterate,142340,270109,412449
5537,27,State - MAHARASHTRA,Rural,80+,Illiterate,161726,305980,467706
5538,27,State - MAHARASHTRA,Rural,Age not stated,Illiterate,25507,36493,62000
5539,27,State - MAHARASHTRA,Urban,All ages,Illiterate,4837913,5908817,10746730
5540,27,State - MAHARASHTRA,Urban,0-6,Illiterate,2967992,2669571,5637563
5541,27,State - MAHARASHTRA,Urban,7,Illiterate,88713,80743,169456
5542,27,State - MAHARASHTRA,Urban,8,Illiterate,33895,31139,65034
5543,27,State - MAHARASHTRA,Urban,9,Illiterate,23426,21364,44790
5544,27,State - MAHARASHTRA,Urban,10,Illiterate,30347,28248,58595
5545,27,State - MAHARASHTRA,Urban,11,Illiterate,18432,17385,35817
5546,27,State - MAHARASHTRA,Urban,12,Illiterate,16479,15536,32015
5547,27,State - MAHARASHTRA,Urban,13,Illiterate,14181,13750,27931
5548,27,State - MAHARASHTRA,Urban,14,Illiterate,15101,14386,29487
5549,27,State - MAHARASHTRA,Urban,15,Illiterate,18584,17463,36047
5550,27,State - MAHARASHTRA,Urban,16,Illiterate,18090,16302,34392
5551,27,State - MAHARASHTRA,Urban,17,Illiterate,18729,16011,34740
5552,27,State - MAHARASHTRA,Urban,18,Illiterate,28972,24652,53624
5553,27,State - MAHARASHTRA,Urban,19,Illiterate,23254,22112,45366
5554,27,State - MAHARASHTRA,Urban,20-24,Illiterate,148277,171564,319841
5555,27,State - MAHARASHTRA,Urban,25-29,Illiterate,161418,227159,388577
5556,27,State - MAHARASHTRA,Urban,30-34,Illiterate,160095,255066,415161
5557,27,State - MAHARASHTRA,Urban,35-39,Illiterate,171162,307793,478955
5558,27,State - MAHARASHTRA,Urban,40-44,Illiterate,172947,311220,484167
5559,27,State - MAHARASHTRA,Urban,45-49,Illiterate,153689,301052,454741
5560,27,State - MAHARASHTRA,Urban,50-54,Illiterate,131254,257477,388731
5561,27,State - MAHARASHTRA,Urban,55-59,Illiterate,93881,215354,309235
5562,27,State - MAHARASHTRA,Urban,60-64,Illiterate,99436,256451,355887
5563,27,State - MAHARASHTRA,Urban,65-69,Illiterate,77566,219306,296872
5564,27,State - MAHARASHTRA,Urban,70-74,Illiterate,63881,171627,235508
5565,27,State - MAHARASHTRA,Urban,75-79,Illiterate,30128,87012,117140
5566,27,State - MAHARASHTRA,Urban,80+,Illiterate,40433,117319,157752
5567,27,State - MAHARASHTRA,Urban,Age not stated,Illiterate,17551,21755,39306
5568,28,State - ANDHRA PRADESH,Total,All ages,Illiterate,14190903,19833114,34024017
5569,28,State - ANDHRA PRADESH,Total,0-6,Illiterate,4714950,4427852,9142802
5570,28,State - ANDHRA PRADESH,Total,7,Illiterate,206328,195022,401350
5571,28,State - ANDHRA PRADESH,Total,8,Illiterate,93512,92694,186206
5572,28,State - ANDHRA PRADESH,Total,9,Illiterate,55710,58189,113899
5573,28,State - ANDHRA PRADESH,Total,10,Illiterate,60237,65891,126128
5574,28,State - ANDHRA PRADESH,Total,11,Illiterate,36151,44164,80315
5575,28,State - ANDHRA PRADESH,Total,12,Illiterate,40506,53082,93588
5576,28,State - ANDHRA PRADESH,Total,13,Illiterate,33600,46533,80133
5577,28,State - ANDHRA PRADESH,Total,14,Illiterate,39930,53468,93398
5578,28,State - ANDHRA PRADESH,Total,15,Illiterate,54572,67771,122343
5579,28,State - ANDHRA PRADESH,Total,16,Illiterate,51327,65077,116404
5580,28,State - ANDHRA PRADESH,Total,17,Illiterate,47358,60052,107410
5581,28,State - ANDHRA PRADESH,Total,18,Illiterate,79721,128720,208441
5582,28,State - ANDHRA PRADESH,Total,19,Illiterate,58964,108444,167408
5583,28,State - ANDHRA PRADESH,Total,20-24,Illiterate,469916,913446,1383362
5584,28,State - ANDHRA PRADESH,Total,25-29,Illiterate,705422,1357493,2062915
5585,28,State - ANDHRA PRADESH,Total,30-34,Illiterate,796200,1407706,2203906
5586,28,State - ANDHRA PRADESH,Total,35-39,Illiterate,952658,1730421,2683079
5587,28,State - ANDHRA PRADESH,Total,40-44,Illiterate,1035571,1543260,2578831
5588,28,State - ANDHRA PRADESH,Total,45-49,Illiterate,989001,1460813,2449814
5589,28,State - ANDHRA PRADESH,Total,50-54,Illiterate,837562,1218879,2056441
5590,28,State - ANDHRA PRADESH,Total,55-59,Illiterate,586927,1110458,1697385
5591,28,State - ANDHRA PRADESH,Total,60-64,Illiterate,785239,1337485,2122724
5592,28,State - ANDHRA PRADESH,Total,65-69,Illiterate,567087,902551,1469638
5593,28,State - ANDHRA PRADESH,Total,70-74,Illiterate,446793,632669,1079462
5594,28,State - ANDHRA PRADESH,Total,75-79,Illiterate,166369,262315,428684
5595,28,State - ANDHRA PRADESH,Total,80+,Illiterate,178988,337339,516327
5596,28,State - ANDHRA PRADESH,Total,Age not stated,Illiterate,100304,151320,251624
5597,28,State - ANDHRA PRADESH,Rural,All ages,Illiterate,10847641,15162996,26010637
5598,28,State - ANDHRA PRADESH,Rural,0-6,Illiterate,3169288,2982734,6152022
5599,28,State - ANDHRA PRADESH,Rural,7,Illiterate,151721,143188,294909
5600,28,State - ANDHRA PRADESH,Rural,8,Illiterate,68165,67561,135726
5601,28,State - ANDHRA PRADESH,Rural,9,Illiterate,38779,41071,79850
5602,28,State - ANDHRA PRADESH,Rural,10,Illiterate,41731,47138,88869
5603,28,State - ANDHRA PRADESH,Rural,11,Illiterate,24122,30834,54956
5604,28,State - ANDHRA PRADESH,Rural,12,Illiterate,29038,40355,69393
5605,28,State - ANDHRA PRADESH,Rural,13,Illiterate,23781,34954,58735
5606,28,State - ANDHRA PRADESH,Rural,14,Illiterate,28690,40850,69540
5607,28,State - ANDHRA PRADESH,Rural,15,Illiterate,40462,52380,92842
5608,28,State - ANDHRA PRADESH,Rural,16,Illiterate,38012,49997,88009
5609,28,State - ANDHRA PRADESH,Rural,17,Illiterate,33879,44910,78789
5610,28,State - ANDHRA PRADESH,Rural,18,Illiterate,60905,102346,163251
5611,28,State - ANDHRA PRADESH,Rural,19,Illiterate,43234,83237,126471
5612,28,State - ANDHRA PRADESH,Rural,20-24,Illiterate,358687,717214,1075901
5613,28,State - ANDHRA PRADESH,Rural,25-29,Illiterate,554438,1078535,1632973
5614,28,State - ANDHRA PRADESH,Rural,30-34,Illiterate,638635,1127495,1766130
5615,28,State - ANDHRA PRADESH,Rural,35-39,Illiterate,766610,1371258,2137868
5616,28,State - ANDHRA PRADESH,Rural,40-44,Illiterate,843896,1217519,2061415
5617,28,State - ANDHRA PRADESH,Rural,45-49,Illiterate,806340,1141820,1948160
5618,28,State - ANDHRA PRADESH,Rural,50-54,Illiterate,689029,957048,1646077
5619,28,State - ANDHRA PRADESH,Rural,55-59,Illiterate,484694,890487,1375181
5620,28,State - ANDHRA PRADESH,Rural,60-64,Illiterate,672262,1090326,1762588
5621,28,State - ANDHRA PRADESH,Rural,65-69,Illiterate,493352,736802,1230154
5622,28,State - ANDHRA PRADESH,Rural,70-74,Illiterate,389482,511275,900757
5623,28,State - ANDHRA PRADESH,Rural,75-79,Illiterate,143226,205920,349146
5624,28,State - ANDHRA PRADESH,Rural,80+,Illiterate,151159,258631,409790
5625,28,State - ANDHRA PRADESH,Rural,Age not stated,Illiterate,64024,97111,161135
5626,28,State - ANDHRA PRADESH,Urban,All ages,Illiterate,3343262,4670118,8013380
5627,28,State - ANDHRA PRADESH,Urban,0-6,Illiterate,1545662,1445118,2990780
5628,28,State - ANDHRA PRADESH,Urban,7,Illiterate,54607,51834,106441
5629,28,State - ANDHRA PRADESH,Urban,8,Illiterate,25347,25133,50480
5630,28,State - ANDHRA PRADESH,Urban,9,Illiterate,16931,17118,34049
5631,28,State - ANDHRA PRADESH,Urban,10,Illiterate,18506,18753,37259
5632,28,State - ANDHRA PRADESH,Urban,11,Illiterate,12029,13330,25359
5633,28,State - ANDHRA PRADESH,Urban,12,Illiterate,11468,12727,24195
5634,28,State - ANDHRA PRADESH,Urban,13,Illiterate,9819,11579,21398
5635,28,State - ANDHRA PRADESH,Urban,14,Illiterate,11240,12618,23858
5636,28,State - ANDHRA PRADESH,Urban,15,Illiterate,14110,15391,29501
5637,28,State - ANDHRA PRADESH,Urban,16,Illiterate,13315,15080,28395
5638,28,State - ANDHRA PRADESH,Urban,17,Illiterate,13479,15142,28621
5639,28,State - ANDHRA PRADESH,Urban,18,Illiterate,18816,26374,45190
5640,28,State - ANDHRA PRADESH,Urban,19,Illiterate,15730,25207,40937
5641,28,State - ANDHRA PRADESH,Urban,20-24,Illiterate,111229,196232,307461
5642,28,State - ANDHRA PRADESH,Urban,25-29,Illiterate,150984,278958,429942
5643,28,State - ANDHRA PRADESH,Urban,30-34,Illiterate,157565,280211,437776
5644,28,State - ANDHRA PRADESH,Urban,35-39,Illiterate,186048,359163,545211
5645,28,State - ANDHRA PRADESH,Urban,40-44,Illiterate,191675,325741,517416
5646,28,State - ANDHRA PRADESH,Urban,45-49,Illiterate,182661,318993,501654
5647,28,State - ANDHRA PRADESH,Urban,50-54,Illiterate,148533,261831,410364
5648,28,State - ANDHRA PRADESH,Urban,55-59,Illiterate,102233,219971,322204
5649,28,State - ANDHRA PRADESH,Urban,60-64,Illiterate,112977,247159,360136
5650,28,State - ANDHRA PRADESH,Urban,65-69,Illiterate,73735,165749,239484
5651,28,State - ANDHRA PRADESH,Urban,70-74,Illiterate,57311,121394,178705
5652,28,State - ANDHRA PRADESH,Urban,75-79,Illiterate,23143,56395,79538
5653,28,State - ANDHRA PRADESH,Urban,80+,Illiterate,27829,78708,106537
5654,28,State - ANDHRA PRADESH,Urban,Age not stated,Illiterate,36280,54209,90489
5655,29,State - KARNATAKA,Total,All ages,Illiterate,8458186,11989789,20447975
5656,29,State - KARNATAKA,Total,0-6,Illiterate,3675291,3485742,7161033
5657,29,State - KARNATAKA,Total,7,Illiterate,107367,104866,212233
5658,29,State - KARNATAKA,Total,8,Illiterate,38026,41654,79680
5659,29,State - KARNATAKA,Total,9,Illiterate,24271,28206,52477
5660,29,State - KARNATAKA,Total,10,Illiterate,33478,38764,72242
5661,29,State - KARNATAKA,Total,11,Illiterate,19492,24883,44375
5662,29,State - KARNATAKA,Total,12,Illiterate,22062,30646,52708
5663,29,State - KARNATAKA,Total,13,Illiterate,17818,25645,43463
5664,29,State - KARNATAKA,Total,14,Illiterate,23306,31035,54341
5665,29,State - KARNATAKA,Total,15,Illiterate,29567,37378,66945
5666,29,State - KARNATAKA,Total,16,Illiterate,31111,38138,69249
5667,29,State - KARNATAKA,Total,17,Illiterate,26868,33262,60130
5668,29,State - KARNATAKA,Total,18,Illiterate,51330,70459,121789
5669,29,State - KARNATAKA,Total,19,Illiterate,33978,57763,91741
5670,29,State - KARNATAKA,Total,20-24,Illiterate,250002,434092,684094
5671,29,State - KARNATAKA,Total,25-29,Illiterate,336956,643933,980889
5672,29,State - KARNATAKA,Total,30-34,Illiterate,364751,682114,1046865
5673,29,State - KARNATAKA,Total,35-39,Illiterate,472659,935998,1408657
5674,29,State - KARNATAKA,Total,40-44,Illiterate,504523,852303,1356826
5675,29,State - KARNATAKA,Total,45-49,Illiterate,526686,877668,1404354
5676,29,State - KARNATAKA,Total,50-54,Illiterate,432732,725739,1158471
5677,29,State - KARNATAKA,Total,55-59,Illiterate,316568,629834,946402
5678,29,State - KARNATAKA,Total,60-64,Illiterate,374379,713192,1087571
5679,29,State - KARNATAKA,Total,65-69,Illiterate,290619,560067,850686
5680,29,State - KARNATAKA,Total,70-74,Illiterate,226915,411668,638583
5681,29,State - KARNATAKA,Total,75-79,Illiterate,102582,198911,301493
5682,29,State - KARNATAKA,Total,80+,Illiterate,119458,268595,388053
5683,29,State - KARNATAKA,Total,Age not stated,Illiterate,5391,7234,12625
5684,29,State - KARNATAKA,Rural,All ages,Illiterate,6035917,8784242,14820159
5685,29,State - KARNATAKA,Rural,0-6,Illiterate,2317069,2200576,4517645
5686,29,State - KARNATAKA,Rural,7,Illiterate,72224,71672,143896
5687,29,State - KARNATAKA,Rural,8,Illiterate,25598,28836,54434
5688,29,State - KARNATAKA,Rural,9,Illiterate,15988,19322,35310
5689,29,State - KARNATAKA,Rural,10,Illiterate,21876,26658,48534
5690,29,State - KARNATAKA,Rural,11,Illiterate,12840,17371,30211
5691,29,State - KARNATAKA,Rural,12,Illiterate,15613,23226,38839
5692,29,State - KARNATAKA,Rural,13,Illiterate,12492,19251,31743
5693,29,State - KARNATAKA,Rural,14,Illiterate,16869,23870,40739
5694,29,State - KARNATAKA,Rural,15,Illiterate,21731,28705,50436
5695,29,State - KARNATAKA,Rural,16,Illiterate,22927,29867,52794
5696,29,State - KARNATAKA,Rural,17,Illiterate,19137,24739,43876
5697,29,State - KARNATAKA,Rural,18,Illiterate,37924,54660,92584
5698,29,State - KARNATAKA,Rural,19,Illiterate,23802,43429,67231
5699,29,State - KARNATAKA,Rural,20-24,Illiterate,178697,328309,507006
5700,29,State - KARNATAKA,Rural,25-29,Illiterate,245321,490649,735970
5701,29,State - KARNATAKA,Rural,30-34,Illiterate,271978,528362,800340
5702,29,State - KARNATAKA,Rural,35-39,Illiterate,358635,726078,1084713
5703,29,State - KARNATAKA,Rural,40-44,Illiterate,396071,668895,1064966
5704,29,State - KARNATAKA,Rural,45-49,Illiterate,417904,680118,1098022
5705,29,State - KARNATAKA,Rural,50-54,Illiterate,347473,565284,912757
5706,29,State - KARNATAKA,Rural,55-59,Illiterate,255565,492492,748057
5707,29,State - KARNATAKA,Rural,60-64,Illiterate,307770,559212,866982
5708,29,State - KARNATAKA,Rural,65-69,Illiterate,242489,442650,685139
5709,29,State - KARNATAKA,Rural,70-74,Illiterate,190540,325758,516298
5710,29,State - KARNATAKA,Rural,75-79,Illiterate,85342,154174,239516
5711,29,State - KARNATAKA,Rural,80+,Illiterate,98535,205201,303736
5712,29,State - KARNATAKA,Rural,Age not stated,Illiterate,3507,4878,8385
5713,29,State - KARNATAKA,Urban,All ages,Illiterate,2422269,3205547,5627816
5714,29,State - KARNATAKA,Urban,0-6,Illiterate,1358222,1285166,2643388
5715,29,State - KARNATAKA,Urban,7,Illiterate,35143,33194,68337
5716,29,State - KARNATAKA,Urban,8,Illiterate,12428,12818,25246
5717,29,State - KARNATAKA,Urban,9,Illiterate,8283,8884,17167
5718,29,State - KARNATAKA,Urban,10,Illiterate,11602,12106,23708
5719,29,State - KARNATAKA,Urban,11,Illiterate,6652,7512,14164
5720,29,State - KARNATAKA,Urban,12,Illiterate,6449,7420,13869
5721,29,State - KARNATAKA,Urban,13,Illiterate,5326,6394,11720
5722,29,State - KARNATAKA,Urban,14,Illiterate,6437,7165,13602
5723,29,State - KARNATAKA,Urban,15,Illiterate,7836,8673,16509
5724,29,State - KARNATAKA,Urban,16,Illiterate,8184,8271,16455
5725,29,State - KARNATAKA,Urban,17,Illiterate,7731,8523,16254
5726,29,State - KARNATAKA,Urban,18,Illiterate,13406,15799,29205
5727,29,State - KARNATAKA,Urban,19,Illiterate,10176,14334,24510
5728,29,State - KARNATAKA,Urban,20-24,Illiterate,71305,105783,177088
5729,29,State - KARNATAKA,Urban,25-29,Illiterate,91635,153284,244919
5730,29,State - KARNATAKA,Urban,30-34,Illiterate,92773,153752,246525
5731,29,State - KARNATAKA,Urban,35-39,Illiterate,114024,209920,323944
5732,29,State - KARNATAKA,Urban,40-44,Illiterate,108452,183408,291860
5733,29,State - KARNATAKA,Urban,45-49,Illiterate,108782,197550,306332
5734,29,State - KARNATAKA,Urban,50-54,Illiterate,85259,160455,245714
5735,29,State - KARNATAKA,Urban,55-59,Illiterate,61003,137342,198345
5736,29,State - KARNATAKA,Urban,60-64,Illiterate,66609,153980,220589
5737,29,State - KARNATAKA,Urban,65-69,Illiterate,48130,117417,165547
5738,29,State - KARNATAKA,Urban,70-74,Illiterate,36375,85910,122285
5739,29,State - KARNATAKA,Urban,75-79,Illiterate,17240,44737,61977
5740,29,State - KARNATAKA,Urban,80+,Illiterate,20923,63394,84317
5741,29,State - KARNATAKA,Urban,Age not stated,Illiterate,1884,2356,4240
5742,30,State - GOA,Total,All ages,Illiterate,123317,169741,293058
5743,30,State - GOA,Total,0-6,Illiterate,74460,70151,144611
5744,30,State - GOA,Total,7,Illiterate,1882,1713,3595
5745,30,State - GOA,Total,8,Illiterate,557,575,1132
5746,30,State - GOA,Total,9,Illiterate,391,424,815
5747,30,State - GOA,Total,10,Illiterate,441,479,920
5748,30,State - GOA,Total,11,Illiterate,281,336,617
5749,30,State - GOA,Total,12,Illiterate,206,268,474
5750,30,State - GOA,Total,13,Illiterate,197,247,444
5751,30,State - GOA,Total,14,Illiterate,202,251,453
5752,30,State - GOA,Total,15,Illiterate,220,297,517
5753,30,State - GOA,Total,16,Illiterate,226,269,495
5754,30,State - GOA,Total,17,Illiterate,258,274,532
5755,30,State - GOA,Total,18,Illiterate,430,454,884
5756,30,State - GOA,Total,19,Illiterate,437,435,872
5757,30,State - GOA,Total,20-24,Illiterate,2811,3313,6124
5758,30,State - GOA,Total,25-29,Illiterate,3203,4814,8017
5759,30,State - GOA,Total,30-34,Illiterate,3236,5149,8385
5760,30,State - GOA,Total,35-39,Illiterate,3883,6801,10684
5761,30,State - GOA,Total,40-44,Illiterate,4035,7723,11758
5762,30,State - GOA,Total,45-49,Illiterate,4267,8812,13079
5763,30,State - GOA,Total,50-54,Illiterate,3743,8762,12505
5764,30,State - GOA,Total,55-59,Illiterate,3473,9365,12838
5765,30,State - GOA,Total,60-64,Illiterate,4718,12452,17170
5766,30,State - GOA,Total,65-69,Illiterate,3715,9637,13352
5767,30,State - GOA,Total,70-74,Illiterate,2927,7732,10659
5768,30,State - GOA,Total,75-79,Illiterate,1487,4121,5608
5769,30,State - GOA,Total,80+,Illiterate,1483,4629,6112
5770,30,State - GOA,Total,Age not stated,Illiterate,148,258,406
5771,30,State - GOA,Rural,All ages,Illiterate,48293,72167,120460
5772,30,State - GOA,Rural,0-6,Illiterate,27772,26242,54014
5773,30,State - GOA,Rural,7,Illiterate,712,645,1357
5774,30,State - GOA,Rural,8,Illiterate,194,190,384
5775,30,State - GOA,Rural,9,Illiterate,114,120,234
5776,30,State - GOA,Rural,10,Illiterate,144,139,283
5777,30,State - GOA,Rural,11,Illiterate,87,102,189
5778,30,State - GOA,Rural,12,Illiterate,64,86,150
5779,30,State - GOA,Rural,13,Illiterate,68,84,152
5780,30,State - GOA,Rural,14,Illiterate,62,90,152
5781,30,State - GOA,Rural,15,Illiterate,68,89,157
5782,30,State - GOA,Rural,16,Illiterate,81,85,166
5783,30,State - GOA,Rural,17,Illiterate,91,86,177
5784,30,State - GOA,Rural,18,Illiterate,130,149,279
5785,30,State - GOA,Rural,19,Illiterate,156,151,307
5786,30,State - GOA,Rural,20-24,Illiterate,831,1058,1889
5787,30,State - GOA,Rural,25-29,Illiterate,984,1610,2594
5788,30,State - GOA,Rural,30-34,Illiterate,1044,1889,2933
5789,30,State - GOA,Rural,35-39,Illiterate,1341,2847,4188
5790,30,State - GOA,Rural,40-44,Illiterate,1572,3522,5094
5791,30,State - GOA,Rural,45-49,Illiterate,1783,4312,6095
5792,30,State - GOA,Rural,50-54,Illiterate,1715,4411,6126
5793,30,State - GOA,Rural,55-59,Illiterate,1631,4766,6397
5794,30,State - GOA,Rural,60-64,Illiterate,2391,6324,8715
5795,30,State - GOA,Rural,65-69,Illiterate,2080,4909,6989
5796,30,State - GOA,Rural,70-74,Illiterate,1564,3941,5505
5797,30,State - GOA,Rural,75-79,Illiterate,762,2027,2789
5798,30,State - GOA,Rural,80+,Illiterate,790,2180,2970
5799,30,State - GOA,Rural,Age not stated,Illiterate,62,113,175
5800,30,State - GOA,Urban,All ages,Illiterate,75024,97574,172598
5801,30,State - GOA,Urban,0-6,Illiterate,46688,43909,90597
5802,30,State - GOA,Urban,7,Illiterate,1170,1068,2238
5803,30,State - GOA,Urban,8,Illiterate,363,385,748
5804,30,State - GOA,Urban,9,Illiterate,277,304,581
5805,30,State - GOA,Urban,10,Illiterate,297,340,637
5806,30,State - GOA,Urban,11,Illiterate,194,234,428
5807,30,State - GOA,Urban,12,Illiterate,142,182,324
5808,30,State - GOA,Urban,13,Illiterate,129,163,292
5809,30,State - GOA,Urban,14,Illiterate,140,161,301
5810,30,State - GOA,Urban,15,Illiterate,152,208,360
5811,30,State - GOA,Urban,16,Illiterate,145,184,329
5812,30,State - GOA,Urban,17,Illiterate,167,188,355
5813,30,State - GOA,Urban,18,Illiterate,300,305,605
5814,30,State - GOA,Urban,19,Illiterate,281,284,565
5815,30,State - GOA,Urban,20-24,Illiterate,1980,2255,4235
5816,30,State - GOA,Urban,25-29,Illiterate,2219,3204,5423
5817,30,State - GOA,Urban,30-34,Illiterate,2192,3260,5452
5818,30,State - GOA,Urban,35-39,Illiterate,2542,3954,6496
5819,30,State - GOA,Urban,40-44,Illiterate,2463,4201,6664
5820,30,State - GOA,Urban,45-49,Illiterate,2484,4500,6984
5821,30,State - GOA,Urban,50-54,Illiterate,2028,4351,6379
5822,30,State - GOA,Urban,55-59,Illiterate,1842,4599,6441
5823,30,State - GOA,Urban,60-64,Illiterate,2327,6128,8455
5824,30,State - GOA,Urban,65-69,Illiterate,1635,4728,6363
5825,30,State - GOA,Urban,70-74,Illiterate,1363,3791,5154
5826,30,State - GOA,Urban,75-79,Illiterate,725,2094,2819
5827,30,State - GOA,Urban,80+,Illiterate,693,2449,3142
5828,30,State - GOA,Urban,Age not stated,Illiterate,86,145,231
5829,31,State - LAKSHADWEEP,Total,All ages,Illiterate,5100,6820,11920
5830,31,State - LAKSHADWEEP,Total,0-6,Illiterate,3797,3458,7255
5831,31,State - LAKSHADWEEP,Total,7,Illiterate,168,167,335
5832,31,State - LAKSHADWEEP,Total,8,Illiterate,39,40,79
5833,31,State - LAKSHADWEEP,Total,9,Illiterate,35,41,76
5834,31,State - LAKSHADWEEP,Total,10,Illiterate,31,41,72
5835,31,State - LAKSHADWEEP,Total,11,Illiterate,26,18,44
5836,31,State - LAKSHADWEEP,Total,12,Illiterate,5,8,13
5837,31,State - LAKSHADWEEP,Total,13,Illiterate,3,2,5
5838,31,State - LAKSHADWEEP,Total,14,Illiterate,3,9,12
5839,31,State - LAKSHADWEEP,Total,15,Illiterate,5,3,8
5840,31,State - LAKSHADWEEP,Total,16,Illiterate,4,8,12
5841,31,State - LAKSHADWEEP,Total,17,Illiterate,8,10,18
5842,31,State - LAKSHADWEEP,Total,18,Illiterate,9,10,19
5843,31,State - LAKSHADWEEP,Total,19,Illiterate,15,10,25
5844,31,State - LAKSHADWEEP,Total,20-24,Illiterate,60,53,113
5845,31,State - LAKSHADWEEP,Total,25-29,Illiterate,67,54,121
5846,31,State - LAKSHADWEEP,Total,30-34,Illiterate,53,77,130
5847,31,State - LAKSHADWEEP,Total,35-39,Illiterate,57,116,173
5848,31,State - LAKSHADWEEP,Total,40-44,Illiterate,69,176,245
5849,31,State - LAKSHADWEEP,Total,45-49,Illiterate,59,226,285
5850,31,State - LAKSHADWEEP,Total,50-54,Illiterate,48,319,367
5851,31,State - LAKSHADWEEP,Total,55-59,Illiterate,65,432,497
5852,31,State - LAKSHADWEEP,Total,60-64,Illiterate,93,455,548
5853,31,State - LAKSHADWEEP,Total,65-69,Illiterate,117,412,529
5854,31,State - LAKSHADWEEP,Total,70-74,Illiterate,105,314,419
5855,31,State - LAKSHADWEEP,Total,75-79,Illiterate,80,162,242
5856,31,State - LAKSHADWEEP,Total,80+,Illiterate,61,186,247
5857,31,State - LAKSHADWEEP,Total,Age not stated,Illiterate,18,13,31
5858,31,State - LAKSHADWEEP,Rural,All ages,Illiterate,1294,1559,2853
5859,31,State - LAKSHADWEEP,Rural,0-6,Illiterate,950,865,1815
5860,31,State - LAKSHADWEEP,Rural,7,Illiterate,61,61,122
5861,31,State - LAKSHADWEEP,Rural,8,Illiterate,21,22,43
5862,31,State - LAKSHADWEEP,Rural,9,Illiterate,15,12,27
5863,31,State - LAKSHADWEEP,Rural,10,Illiterate,8,8,16
5864,31,State - LAKSHADWEEP,Rural,11,Illiterate,11,5,16
5865,31,State - LAKSHADWEEP,Rural,12,Illiterate,1,3,4
5866,31,State - LAKSHADWEEP,Rural,13,Illiterate,0,1,1
5867,31,State - LAKSHADWEEP,Rural,14,Illiterate,0,2,2
5868,31,State - LAKSHADWEEP,Rural,15,Illiterate,1,0,1
5869,31,State - LAKSHADWEEP,Rural,16,Illiterate,0,3,3
5870,31,State - LAKSHADWEEP,Rural,17,Illiterate,1,2,3
5871,31,State - LAKSHADWEEP,Rural,18,Illiterate,2,2,4
5872,31,State - LAKSHADWEEP,Rural,19,Illiterate,2,2,4
5873,31,State - LAKSHADWEEP,Rural,20-24,Illiterate,15,13,28
5874,31,State - LAKSHADWEEP,Rural,25-29,Illiterate,17,8,25
5875,31,State - LAKSHADWEEP,Rural,30-34,Illiterate,13,17,30
5876,31,State - LAKSHADWEEP,Rural,35-39,Illiterate,11,21,32
5877,31,State - LAKSHADWEEP,Rural,40-44,Illiterate,12,21,33
5878,31,State - LAKSHADWEEP,Rural,45-49,Illiterate,15,24,39
5879,31,State - LAKSHADWEEP,Rural,50-54,Illiterate,11,40,51
5880,31,State - LAKSHADWEEP,Rural,55-59,Illiterate,13,81,94
5881,31,State - LAKSHADWEEP,Rural,60-64,Illiterate,20,93,113
5882,31,State - LAKSHADWEEP,Rural,65-69,Illiterate,26,109,135
5883,31,State - LAKSHADWEEP,Rural,70-74,Illiterate,26,82,108
5884,31,State - LAKSHADWEEP,Rural,75-79,Illiterate,25,33,58
5885,31,State - LAKSHADWEEP,Rural,80+,Illiterate,15,28,43
5886,31,State - LAKSHADWEEP,Rural,Age not stated,Illiterate,2,1,3
5887,31,State - LAKSHADWEEP,Urban,All ages,Illiterate,3806,5261,9067
5888,31,State - LAKSHADWEEP,Urban,0-6,Illiterate,2847,2593,5440
5889,31,State - LAKSHADWEEP,Urban,7,Illiterate,107,106,213
5890,31,State - LAKSHADWEEP,Urban,8,Illiterate,18,18,36
5891,31,State - LAKSHADWEEP,Urban,9,Illiterate,20,29,49
5892,31,State - LAKSHADWEEP,Urban,10,Illiterate,23,33,56
5893,31,State - LAKSHADWEEP,Urban,11,Illiterate,15,13,28
5894,31,State - LAKSHADWEEP,Urban,12,Illiterate,4,5,9
5895,31,State - LAKSHADWEEP,Urban,13,Illiterate,3,1,4
5896,31,State - LAKSHADWEEP,Urban,14,Illiterate,3,7,10
5897,31,State - LAKSHADWEEP,Urban,15,Illiterate,4,3,7
5898,31,State - LAKSHADWEEP,Urban,16,Illiterate,4,5,9
5899,31,State - LAKSHADWEEP,Urban,17,Illiterate,7,8,15
5900,31,State - LAKSHADWEEP,Urban,18,Illiterate,7,8,15
5901,31,State - LAKSHADWEEP,Urban,19,Illiterate,13,8,21
5902,31,State - LAKSHADWEEP,Urban,20-24,Illiterate,45,40,85
5903,31,State - LAKSHADWEEP,Urban,25-29,Illiterate,50,46,96
5904,31,State - LAKSHADWEEP,Urban,30-34,Illiterate,40,60,100
5905,31,State - LAKSHADWEEP,Urban,35-39,Illiterate,46,95,141
5906,31,State - LAKSHADWEEP,Urban,40-44,Illiterate,57,155,212
5907,31,State - LAKSHADWEEP,Urban,45-49,Illiterate,44,202,246
5908,31,State - LAKSHADWEEP,Urban,50-54,Illiterate,37,279,316
5909,31,State - LAKSHADWEEP,Urban,55-59,Illiterate,52,351,403
5910,31,State - LAKSHADWEEP,Urban,60-64,Illiterate,73,362,435
5911,31,State - LAKSHADWEEP,Urban,65-69,Illiterate,91,303,394
5912,31,State - LAKSHADWEEP,Urban,70-74,Illiterate,79,232,311
5913,31,State - LAKSHADWEEP,Urban,75-79,Illiterate,55,129,184
5914,31,State - LAKSHADWEEP,Urban,80+,Illiterate,46,158,204
5915,31,State - LAKSHADWEEP,Urban,Age not stated,Illiterate,16,12,28
5916,32,State - KERALA,Total,All ages,Illiterate,2322509,2947728,5270237
5917,32,State - KERALA,Total,0-6,Illiterate,1768244,1704711,3472955
5918,32,State - KERALA,Total,7,Illiterate,35411,33307,68718
5919,32,State - KERALA,Total,8,Illiterate,7925,7367,15292
5920,32,State - KERALA,Total,9,Illiterate,4614,4321,8935
5921,32,State - KERALA,Total,10,Illiterate,6153,5783,11936
5922,32,State - KERALA,Total,11,Illiterate,3477,3223,6700
5923,32,State - KERALA,Total,12,Illiterate,2226,2229,4455
5924,32,State - KERALA,Total,13,Illiterate,2207,2299,4506
5925,32,State - KERALA,Total,14,Illiterate,2320,2161,4481
5926,32,State - KERALA,Total,15,Illiterate,2382,2281,4663
5927,32,State - KERALA,Total,16,Illiterate,1997,2046,4043
5928,32,State - KERALA,Total,17,Illiterate,1857,1894,3751
5929,32,State - KERALA,Total,18,Illiterate,2378,2267,4645
5930,32,State - KERALA,Total,19,Illiterate,2207,2109,4316
5931,32,State - KERALA,Total,20-24,Illiterate,14375,15103,29478
5932,32,State - KERALA,Total,25-29,Illiterate,17327,21234,38561
5933,32,State - KERALA,Total,30-34,Illiterate,19077,27128,46205
5934,32,State - KERALA,Total,35-39,Illiterate,27219,49718,76937
5935,32,State - KERALA,Total,40-44,Illiterate,33979,66397,100376
5936,32,State - KERALA,Total,45-49,Illiterate,47307,101213,148520
5937,32,State - KERALA,Total,50-54,Illiterate,45522,106360,151882
5938,32,State - KERALA,Total,55-59,Illiterate,52146,128975,181121
5939,32,State - KERALA,Total,60-64,Illiterate,55376,147069,202445
5940,32,State - KERALA,Total,65-69,Illiterate,51654,149897,201551
5941,32,State - KERALA,Total,70-74,Illiterate,43070,126636,169706
5942,32,State - KERALA,Total,75-79,Illiterate,32400,99108,131508
5943,32,State - KERALA,Total,80+,Illiterate,36651,129249,165900
5944,32,State - KERALA,Total,Age not stated,Illiterate,3008,3643,6651
5945,32,State - KERALA,Rural,All ages,Illiterate,1275624,1646191,2921815
5946,32,State - KERALA,Rural,0-6,Illiterate,927888,895776,1823664
5947,32,State - KERALA,Rural,7,Illiterate,19923,18501,38424
5948,32,State - KERALA,Rural,8,Illiterate,4651,4192,8843
5949,32,State - KERALA,Rural,9,Illiterate,2652,2351,5003
5950,32,State - KERALA,Rural,10,Illiterate,3342,3180,6522
5951,32,State - KERALA,Rural,11,Illiterate,1947,1776,3723
5952,32,State - KERALA,Rural,12,Illiterate,1292,1292,2584
5953,32,State - KERALA,Rural,13,Illiterate,1217,1235,2452
5954,32,State - KERALA,Rural,14,Illiterate,1310,1210,2520
5955,32,State - KERALA,Rural,15,Illiterate,1333,1269,2602
5956,32,State - KERALA,Rural,16,Illiterate,1108,1149,2257
5957,32,State - KERALA,Rural,17,Illiterate,1033,1075,2108
5958,32,State - KERALA,Rural,18,Illiterate,1347,1326,2673
5959,32,State - KERALA,Rural,19,Illiterate,1191,1256,2447
5960,32,State - KERALA,Rural,20-24,Illiterate,8121,9363,17484
5961,32,State - KERALA,Rural,25-29,Illiterate,10522,13910,24432
5962,32,State - KERALA,Rural,30-34,Illiterate,11731,18003,29734
5963,32,State - KERALA,Rural,35-39,Illiterate,17558,34062,51620
5964,32,State - KERALA,Rural,40-44,Illiterate,21887,44151,66038
5965,32,State - KERALA,Rural,45-49,Illiterate,31306,66717,98023
5966,32,State - KERALA,Rural,50-54,Illiterate,29665,66965,96630
5967,32,State - KERALA,Rural,55-59,Illiterate,33949,79125,113074
5968,32,State - KERALA,Rural,60-64,Illiterate,35554,87136,122690
5969,32,State - KERALA,Rural,65-69,Illiterate,33023,87583,120606
5970,32,State - KERALA,Rural,70-74,Illiterate,27074,71836,98910
5971,32,State - KERALA,Rural,75-79,Illiterate,20133,56359,76492
5972,32,State - KERALA,Rural,80+,Illiterate,23416,73510,96926
5973,32,State - KERALA,Rural,Age not stated,Illiterate,1451,1883,3334
5974,32,State - KERALA,Urban,All ages,Illiterate,1046885,1301537,2348422
5975,32,State - KERALA,Urban,0-6,Illiterate,840356,808935,1649291
5976,32,State - KERALA,Urban,7,Illiterate,15488,14806,30294
5977,32,State - KERALA,Urban,8,Illiterate,3274,3175,6449
5978,32,State - KERALA,Urban,9,Illiterate,1962,1970,3932
5979,32,State - KERALA,Urban,10,Illiterate,2811,2603,5414
5980,32,State - KERALA,Urban,11,Illiterate,1530,1447,2977
5981,32,State - KERALA,Urban,12,Illiterate,934,937,1871
5982,32,State - KERALA,Urban,13,Illiterate,990,1064,2054
5983,32,State - KERALA,Urban,14,Illiterate,1010,951,1961
5984,32,State - KERALA,Urban,15,Illiterate,1049,1012,2061
5985,32,State - KERALA,Urban,16,Illiterate,889,897,1786
5986,32,State - KERALA,Urban,17,Illiterate,824,819,1643
5987,32,State - KERALA,Urban,18,Illiterate,1031,941,1972
5988,32,State - KERALA,Urban,19,Illiterate,1016,853,1869
5989,32,State - KERALA,Urban,20-24,Illiterate,6254,5740,11994
5990,32,State - KERALA,Urban,25-29,Illiterate,6805,7324,14129
5991,32,State - KERALA,Urban,30-34,Illiterate,7346,9125,16471
5992,32,State - KERALA,Urban,35-39,Illiterate,9661,15656,25317
5993,32,State - KERALA,Urban,40-44,Illiterate,12092,22246,34338
5994,32,State - KERALA,Urban,45-49,Illiterate,16001,34496,50497
5995,32,State - KERALA,Urban,50-54,Illiterate,15857,39395,55252
5996,32,State - KERALA,Urban,55-59,Illiterate,18197,49850,68047
5997,32,State - KERALA,Urban,60-64,Illiterate,19822,59933,79755
5998,32,State - KERALA,Urban,65-69,Illiterate,18631,62314,80945
5999,32,State - KERALA,Urban,70-74,Illiterate,15996,54800,70796
6000,32,State - KERALA,Urban,75-79,Illiterate,12267,42749,55016
6001,32,State - KERALA,Urban,80+,Illiterate,13235,55739,68974
6002,32,State - KERALA,Urban,Age not stated,Illiterate,1557,1760,3317
6003,33,State - TAMIL NADU,Total,All ages,Illiterate,8097484,12212039,20309523
6004,33,State - TAMIL NADU,Total,0-6,Illiterate,3820276,3603556,7423832
6005,33,State - TAMIL NADU,Total,7,Illiterate,104516,99928,204444
6006,33,State - TAMIL NADU,Total,8,Illiterate,39586,38933,78519
6007,33,State - TAMIL NADU,Total,9,Illiterate,21300,21504,42804
6008,33,State - TAMIL NADU,Total,10,Illiterate,21681,22025,43706
6009,33,State - TAMIL NADU,Total,11,Illiterate,11878,12829,24707
6010,33,State - TAMIL NADU,Total,12,Illiterate,9748,10894,20642
6011,33,State - TAMIL NADU,Total,13,Illiterate,8810,10875,19685
6012,33,State - TAMIL NADU,Total,14,Illiterate,9386,11269,20655
6013,33,State - TAMIL NADU,Total,15,Illiterate,12253,14719,26972
6014,33,State - TAMIL NADU,Total,16,Illiterate,10548,12743,23291
6015,33,State - TAMIL NADU,Total,17,Illiterate,12036,14816,26852
6016,33,State - TAMIL NADU,Total,18,Illiterate,15939,22115,38054
6017,33,State - TAMIL NADU,Total,19,Illiterate,15809,25269,41078
6018,33,State - TAMIL NADU,Total,20-24,Illiterate,114708,224758,339466
6019,33,State - TAMIL NADU,Total,25-29,Illiterate,201501,444379,645880
6020,33,State - TAMIL NADU,Total,30-34,Illiterate,250969,571916,822885
6021,33,State - TAMIL NADU,Total,35-39,Illiterate,383766,931521,1315287
6022,33,State - TAMIL NADU,Total,40-44,Illiterate,458333,927392,1385725
6023,33,State - TAMIL NADU,Total,45-49,Illiterate,517884,1003583,1521467
6024,33,State - TAMIL NADU,Total,50-54,Illiterate,426386,851809,1278195
6025,33,State - TAMIL NADU,Total,55-59,Illiterate,372497,808414,1180911
6026,33,State - TAMIL NADU,Total,60-64,Illiterate,415621,849527,1265148
6027,33,State - TAMIL NADU,Total,65-69,Illiterate,305543,637972,943515
6028,33,State - TAMIL NADU,Total,70-74,Illiterate,262480,497459,759939
6029,33,State - TAMIL NADU,Total,75-79,Illiterate,128493,241241,369734
6030,33,State - TAMIL NADU,Total,80+,Illiterate,139170,290513,429683
6031,33,State - TAMIL NADU,Total,Age not stated,Illiterate,6367,10080,16447
6032,33,State - TAMIL NADU,Rural,All ages,Illiterate,5013226,7714169,12727395
6033,33,State - TAMIL NADU,Rural,0-6,Illiterate,2020550,1890752,3911302
6034,33,State - TAMIL NADU,Rural,7,Illiterate,60632,57438,118070
6035,33,State - TAMIL NADU,Rural,8,Illiterate,22960,22263,45223
6036,33,State - TAMIL NADU,Rural,9,Illiterate,12069,12148,24217
6037,33,State - TAMIL NADU,Rural,10,Illiterate,12245,12515,24760
6038,33,State - TAMIL NADU,Rural,11,Illiterate,6754,7395,14149
6039,33,State - TAMIL NADU,Rural,12,Illiterate,5760,6554,12314
6040,33,State - TAMIL NADU,Rural,13,Illiterate,5201,6576,11777
6041,33,State - TAMIL NADU,Rural,14,Illiterate,5591,6960,12551
6042,33,State - TAMIL NADU,Rural,15,Illiterate,7652,9388,17040
6043,33,State - TAMIL NADU,Rural,16,Illiterate,6465,8042,14507
6044,33,State - TAMIL NADU,Rural,17,Illiterate,7493,9533,17026
6045,33,State - TAMIL NADU,Rural,18,Illiterate,9994,14674,24668
6046,33,State - TAMIL NADU,Rural,19,Illiterate,9900,16825,26725
6047,33,State - TAMIL NADU,Rural,20-24,Illiterate,72828,152787,225615
6048,33,State - TAMIL NADU,Rural,25-29,Illiterate,132115,307703,439818
6049,33,State - TAMIL NADU,Rural,30-34,Illiterate,168732,396341,565073
6050,33,State - TAMIL NADU,Rural,35-39,Illiterate,263485,646348,909833
6051,33,State - TAMIL NADU,Rural,40-44,Illiterate,322272,642054,964326
6052,33,State - TAMIL NADU,Rural,45-49,Illiterate,367108,692658,1059766
6053,33,State - TAMIL NADU,Rural,50-54,Illiterate,306459,589269,895728
6054,33,State - TAMIL NADU,Rural,55-59,Illiterate,267571,552526,820097
6055,33,State - TAMIL NADU,Rural,60-64,Illiterate,305758,578436,884194
6056,33,State - TAMIL NADU,Rural,65-69,Illiterate,225559,426245,651804
6057,33,State - TAMIL NADU,Rural,70-74,Illiterate,193401,323636,517037
6058,33,State - TAMIL NADU,Rural,75-79,Illiterate,92320,148238,240558
6059,33,State - TAMIL NADU,Rural,80+,Illiterate,98366,170619,268985
6060,33,State - TAMIL NADU,Rural,Age not stated,Illiterate,3986,6246,10232
6061,33,State - TAMIL NADU,Urban,All ages,Illiterate,3084258,4497870,7582128
6062,33,State - TAMIL NADU,Urban,0-6,Illiterate,1799726,1712804,3512530
6063,33,State - TAMIL NADU,Urban,7,Illiterate,43884,42490,86374
6064,33,State - TAMIL NADU,Urban,8,Illiterate,16626,16670,33296
6065,33,State - TAMIL NADU,Urban,9,Illiterate,9231,9356,18587
6066,33,State - TAMIL NADU,Urban,10,Illiterate,9436,9510,18946
6067,33,State - TAMIL NADU,Urban,11,Illiterate,5124,5434,10558
6068,33,State - TAMIL NADU,Urban,12,Illiterate,3988,4340,8328
6069,33,State - TAMIL NADU,Urban,13,Illiterate,3609,4299,7908
6070,33,State - TAMIL NADU,Urban,14,Illiterate,3795,4309,8104
6071,33,State - TAMIL NADU,Urban,15,Illiterate,4601,5331,9932
6072,33,State - TAMIL NADU,Urban,16,Illiterate,4083,4701,8784
6073,33,State - TAMIL NADU,Urban,17,Illiterate,4543,5283,9826
6074,33,State - TAMIL NADU,Urban,18,Illiterate,5945,7441,13386
6075,33,State - TAMIL NADU,Urban,19,Illiterate,5909,8444,14353
6076,33,State - TAMIL NADU,Urban,20-24,Illiterate,41880,71971,113851
6077,33,State - TAMIL NADU,Urban,25-29,Illiterate,69386,136676,206062
6078,33,State - TAMIL NADU,Urban,30-34,Illiterate,82237,175575,257812
6079,33,State - TAMIL NADU,Urban,35-39,Illiterate,120281,285173,405454
6080,33,State - TAMIL NADU,Urban,40-44,Illiterate,136061,285338,421399
6081,33,State - TAMIL NADU,Urban,45-49,Illiterate,150776,310925,461701
6082,33,State - TAMIL NADU,Urban,50-54,Illiterate,119927,262540,382467
6083,33,State - TAMIL NADU,Urban,55-59,Illiterate,104926,255888,360814
6084,33,State - TAMIL NADU,Urban,60-64,Illiterate,109863,271091,380954
6085,33,State - TAMIL NADU,Urban,65-69,Illiterate,79984,211727,291711
6086,33,State - TAMIL NADU,Urban,70-74,Illiterate,69079,173823,242902
6087,33,State - TAMIL NADU,Urban,75-79,Illiterate,36173,93003,129176
6088,33,State - TAMIL NADU,Urban,80+,Illiterate,40804,119894,160698
6089,33,State - TAMIL NADU,Urban,Age not stated,Illiterate,2381,3834,6215
6090,34,State - PUDUCHERRY,Total,All ages,Illiterate,115133,175511,290644
6091,34,State - PUDUCHERRY,Total,0-6,Illiterate,67527,65331,132858
6092,34,State - PUDUCHERRY,Total,7,Illiterate,2232,2194,4426
6093,34,State - PUDUCHERRY,Total,8,Illiterate,910,898,1808
6094,34,State - PUDUCHERRY,Total,9,Illiterate,580,514,1094
6095,34,State - PUDUCHERRY,Total,10,Illiterate,514,490,1004
6096,34,State - PUDUCHERRY,Total,11,Illiterate,272,260,532
6097,34,State - PUDUCHERRY,Total,12,Illiterate,159,143,302
6098,34,State - PUDUCHERRY,Total,13,Illiterate,128,113,241
6099,34,State - PUDUCHERRY,Total,14,Illiterate,126,132,258
6100,34,State - PUDUCHERRY,Total,15,Illiterate,144,178,322
6101,34,State - PUDUCHERRY,Total,16,Illiterate,151,134,285
6102,34,State - PUDUCHERRY,Total,17,Illiterate,132,154,286
6103,34,State - PUDUCHERRY,Total,18,Illiterate,203,211,414
6104,34,State - PUDUCHERRY,Total,19,Illiterate,173,260,433
6105,34,State - PUDUCHERRY,Total,20-24,Illiterate,1356,2207,3563
6106,34,State - PUDUCHERRY,Total,25-29,Illiterate,2213,4285,6498
6107,34,State - PUDUCHERRY,Total,30-34,Illiterate,3059,6243,9302
6108,34,State - PUDUCHERRY,Total,35-39,Illiterate,4348,10329,14677
6109,34,State - PUDUCHERRY,Total,40-44,Illiterate,4793,11063,15856
6110,34,State - PUDUCHERRY,Total,45-49,Illiterate,5207,12113,17320
6111,34,State - PUDUCHERRY,Total,50-54,Illiterate,4113,9944,14057
6112,34,State - PUDUCHERRY,Total,55-59,Illiterate,3719,9985,13704
6113,34,State - PUDUCHERRY,Total,60-64,Illiterate,3997,11555,15552
6114,34,State - PUDUCHERRY,Total,65-69,Illiterate,2964,9061,12025
6115,34,State - PUDUCHERRY,Total,70-74,Illiterate,2675,7830,10505
6116,34,State - PUDUCHERRY,Total,75-79,Illiterate,1558,4480,6038
6117,34,State - PUDUCHERRY,Total,80+,Illiterate,1763,5220,6983
6118,34,State - PUDUCHERRY,Total,Age not stated,Illiterate,117,184,301
6119,34,State - PUDUCHERRY,Rural,All ages,Illiterate,44417,69901,114318
6120,34,State - PUDUCHERRY,Rural,0-6,Illiterate,22798,21716,44514
6121,34,State - PUDUCHERRY,Rural,7,Illiterate,886,867,1753
6122,34,State - PUDUCHERRY,Rural,8,Illiterate,377,408,785
6123,34,State - PUDUCHERRY,Rural,9,Illiterate,244,223,467
6124,34,State - PUDUCHERRY,Rural,10,Illiterate,193,217,410
6125,34,State - PUDUCHERRY,Rural,11,Illiterate,112,111,223
6126,34,State - PUDUCHERRY,Rural,12,Illiterate,44,47,91
6127,34,State - PUDUCHERRY,Rural,13,Illiterate,46,46,92
6128,34,State - PUDUCHERRY,Rural,14,Illiterate,39,52,91
6129,34,State - PUDUCHERRY,Rural,15,Illiterate,47,72,119
6130,34,State - PUDUCHERRY,Rural,16,Illiterate,49,47,96
6131,34,State - PUDUCHERRY,Rural,17,Illiterate,43,58,101
6132,34,State - PUDUCHERRY,Rural,18,Illiterate,68,80,148
6133,34,State - PUDUCHERRY,Rural,19,Illiterate,56,80,136
6134,34,State - PUDUCHERRY,Rural,20-24,Illiterate,457,829,1286
6135,34,State - PUDUCHERRY,Rural,25-29,Illiterate,746,1741,2487
6136,34,State - PUDUCHERRY,Rural,30-34,Illiterate,1094,2703,3797
6137,34,State - PUDUCHERRY,Rural,35-39,Illiterate,1813,4856,6669
6138,34,State - PUDUCHERRY,Rural,40-44,Illiterate,2137,5092,7229
6139,34,State - PUDUCHERRY,Rural,45-49,Illiterate,2506,5784,8290
6140,34,State - PUDUCHERRY,Rural,50-54,Illiterate,2054,4688,6742
6141,34,State - PUDUCHERRY,Rural,55-59,Illiterate,1905,4578,6483
6142,34,State - PUDUCHERRY,Rural,60-64,Illiterate,2113,5069,7182
6143,34,State - PUDUCHERRY,Rural,65-69,Illiterate,1539,3813,5352
6144,34,State - PUDUCHERRY,Rural,70-74,Illiterate,1378,3202,4580
6145,34,State - PUDUCHERRY,Rural,75-79,Illiterate,754,1603,2357
6146,34,State - PUDUCHERRY,Rural,80+,Illiterate,854,1831,2685
6147,34,State - PUDUCHERRY,Rural,Age not stated,Illiterate,65,88,153
6148,34,State - PUDUCHERRY,Urban,All ages,Illiterate,70716,105610,176326
6149,34,State - PUDUCHERRY,Urban,0-6,Illiterate,44729,43615,88344
6150,34,State - PUDUCHERRY,Urban,7,Illiterate,1346,1327,2673
6151,34,State - PUDUCHERRY,Urban,8,Illiterate,533,490,1023
6152,34,State - PUDUCHERRY,Urban,9,Illiterate,336,291,627
6153,34,State - PUDUCHERRY,Urban,10,Illiterate,321,273,594
6154,34,State - PUDUCHERRY,Urban,11,Illiterate,160,149,309
6155,34,State - PUDUCHERRY,Urban,12,Illiterate,115,96,211
6156,34,State - PUDUCHERRY,Urban,13,Illiterate,82,67,149
6157,34,State - PUDUCHERRY,Urban,14,Illiterate,87,80,167
6158,34,State - PUDUCHERRY,Urban,15,Illiterate,97,106,203
6159,34,State - PUDUCHERRY,Urban,16,Illiterate,102,87,189
6160,34,State - PUDUCHERRY,Urban,17,Illiterate,89,96,185
6161,34,State - PUDUCHERRY,Urban,18,Illiterate,135,131,266
6162,34,State - PUDUCHERRY,Urban,19,Illiterate,117,180,297
6163,34,State - PUDUCHERRY,Urban,20-24,Illiterate,899,1378,2277
6164,34,State - PUDUCHERRY,Urban,25-29,Illiterate,1467,2544,4011
6165,34,State - PUDUCHERRY,Urban,30-34,Illiterate,1965,3540,5505
6166,34,State - PUDUCHERRY,Urban,35-39,Illiterate,2535,5473,8008
6167,34,State - PUDUCHERRY,Urban,40-44,Illiterate,2656,5971,8627
6168,34,State - PUDUCHERRY,Urban,45-49,Illiterate,2701,6329,9030
6169,34,State - PUDUCHERRY,Urban,50-54,Illiterate,2059,5256,7315
6170,34,State - PUDUCHERRY,Urban,55-59,Illiterate,1814,5407,7221
6171,34,State - PUDUCHERRY,Urban,60-64,Illiterate,1884,6486,8370
6172,34,State - PUDUCHERRY,Urban,65-69,Illiterate,1425,5248,6673
6173,34,State - PUDUCHERRY,Urban,70-74,Illiterate,1297,4628,5925
6174,34,State - PUDUCHERRY,Urban,75-79,Illiterate,804,2877,3681
6175,34,State - PUDUCHERRY,Urban,80+,Illiterate,909,3389,4298
6176,34,State - PUDUCHERRY,Urban,Age not stated,Illiterate,52,96,148
6177,35,State - ANDAMAN & NICOBAR ISLANDS,Total,All ages,Illiterate,38494,47806,86300
6178,35,State - ANDAMAN & NICOBAR ISLANDS,Total,0-6,Illiterate,20770,20108,40878
6179,35,State - ANDAMAN & NICOBAR ISLANDS,Total,7,Illiterate,545,481,1026
6180,35,State - ANDAMAN & NICOBAR ISLANDS,Total,8,Illiterate,158,146,304
6181,35,State - ANDAMAN & NICOBAR ISLANDS,Total,9,Illiterate,136,153,289
6182,35,State - ANDAMAN & NICOBAR ISLANDS,Total,10,Illiterate,154,128,282
6183,35,State - ANDAMAN & NICOBAR ISLANDS,Total,11,Illiterate,107,81,188
6184,35,State - ANDAMAN & NICOBAR ISLANDS,Total,12,Illiterate,35,48,83
6185,35,State - ANDAMAN & NICOBAR ISLANDS,Total,13,Illiterate,38,45,83
6186,35,State - ANDAMAN & NICOBAR ISLANDS,Total,14,Illiterate,44,44,88
6187,35,State - ANDAMAN & NICOBAR ISLANDS,Total,15,Illiterate,54,61,115
6188,35,State - ANDAMAN & NICOBAR ISLANDS,Total,16,Illiterate,48,49,97
6189,35,State - ANDAMAN & NICOBAR ISLANDS,Total,17,Illiterate,45,63,108
6190,35,State - ANDAMAN & NICOBAR ISLANDS,Total,18,Illiterate,89,93,182
6191,35,State - ANDAMAN & NICOBAR ISLANDS,Total,19,Illiterate,108,82,190
6192,35,State - ANDAMAN & NICOBAR ISLANDS,Total,20-24,Illiterate,735,915,1650
6193,35,State - ANDAMAN & NICOBAR ISLANDS,Total,25-29,Illiterate,1051,1568,2619
6194,35,State - ANDAMAN & NICOBAR ISLANDS,Total,30-34,Illiterate,1112,1705,2817
6195,35,State - ANDAMAN & NICOBAR ISLANDS,Total,35-39,Illiterate,1445,2636,4081
6196,35,State - ANDAMAN & NICOBAR ISLANDS,Total,40-44,Illiterate,1812,3039,4851
6197,35,State - ANDAMAN & NICOBAR ISLANDS,Total,45-49,Illiterate,2040,3525,5565
6198,35,State - ANDAMAN & NICOBAR ISLANDS,Total,50-54,Illiterate,1790,2994,4784
6199,35,State - ANDAMAN & NICOBAR ISLANDS,Total,55-59,Illiterate,1664,2708,4372
6200,35,State - ANDAMAN & NICOBAR ISLANDS,Total,60-64,Illiterate,1629,2628,4257
6201,35,State - ANDAMAN & NICOBAR ISLANDS,Total,65-69,Illiterate,1091,1734,2825
6202,35,State - ANDAMAN & NICOBAR ISLANDS,Total,70-74,Illiterate,805,1193,1998
6203,35,State - ANDAMAN & NICOBAR ISLANDS,Total,75-79,Illiterate,456,658,1114
6204,35,State - ANDAMAN & NICOBAR ISLANDS,Total,80+,Illiterate,507,873,1380
6205,35,State - ANDAMAN & NICOBAR ISLANDS,Total,Age not stated,Illiterate,26,48,74
6206,35,State - ANDAMAN & NICOBAR ISLANDS,Rural,All ages,Illiterate,26327,32741,59068
6207,35,State - ANDAMAN & NICOBAR ISLANDS,Rural,0-6,Illiterate,13370,13045,26415
6208,35,State - ANDAMAN & NICOBAR ISLANDS,Rural,7,Illiterate,411,359,770
6209,35,State - ANDAMAN & NICOBAR ISLANDS,Rural,8,Illiterate,124,109,233
6210,35,State - ANDAMAN & NICOBAR ISLANDS,Rural,9,Illiterate,99,110,209
6211,35,State - ANDAMAN & NICOBAR ISLANDS,Rural,10,Illiterate,99,94,193
6212,35,State - ANDAMAN & NICOBAR ISLANDS,Rural,11,Illiterate,80,61,141
6213,35,State - ANDAMAN & NICOBAR ISLANDS,Rural,12,Illiterate,27,34,61
6214,35,State - ANDAMAN & NICOBAR ISLANDS,Rural,13,Illiterate,24,33,57
6215,35,State - ANDAMAN & NICOBAR ISLANDS,Rural,14,Illiterate,32,30,62
6216,35,State - ANDAMAN & NICOBAR ISLANDS,Rural,15,Illiterate,40,37,77
6217,35,State - ANDAMAN & NICOBAR ISLANDS,Rural,16,Illiterate,30,38,68
6218,35,State - ANDAMAN & NICOBAR ISLANDS,Rural,17,Illiterate,31,52,83
6219,35,State - ANDAMAN & NICOBAR ISLANDS,Rural,18,Illiterate,53,64,117
6220,35,State - ANDAMAN & NICOBAR ISLANDS,Rural,19,Illiterate,64,51,115
6221,35,State - ANDAMAN & NICOBAR ISLANDS,Rural,20-24,Illiterate,487,640,1127
6222,35,State - ANDAMAN & NICOBAR ISLANDS,Rural,25-29,Illiterate,682,1062,1744
6223,35,State - ANDAMAN & NICOBAR ISLANDS,Rural,30-34,Illiterate,735,1126,1861
6224,35,State - ANDAMAN & NICOBAR ISLANDS,Rural,35-39,Illiterate,962,1725,2687
6225,35,State - ANDAMAN & NICOBAR ISLANDS,Rural,40-44,Illiterate,1275,2075,3350
6226,35,State - ANDAMAN & NICOBAR ISLANDS,Rural,45-49,Illiterate,1475,2446,3921
6227,35,State - ANDAMAN & NICOBAR ISLANDS,Rural,50-54,Illiterate,1327,2128,3455
6228,35,State - ANDAMAN & NICOBAR ISLANDS,Rural,55-59,Illiterate,1267,1945,3212
6229,35,State - ANDAMAN & NICOBAR ISLANDS,Rural,60-64,Illiterate,1242,2016,3258
6230,35,State - ANDAMAN & NICOBAR ISLANDS,Rural,65-69,Illiterate,896,1343,2239
6231,35,State - ANDAMAN & NICOBAR ISLANDS,Rural,70-74,Illiterate,665,914,1579
6232,35,State - ANDAMAN & NICOBAR ISLANDS,Rural,75-79,Illiterate,376,504,880
6233,35,State - ANDAMAN & NICOBAR ISLANDS,Rural,80+,Illiterate,439,677,1116
6234,35,State - ANDAMAN & NICOBAR ISLANDS,Rural,Age not stated,Illiterate,15,23,38
6235,35,State - ANDAMAN & NICOBAR ISLANDS,Urban,All ages,Illiterate,12167,15065,27232
6236,35,State - ANDAMAN & NICOBAR ISLANDS,Urban,0-6,Illiterate,7400,7063,14463
6237,35,State - ANDAMAN & NICOBAR ISLANDS,Urban,7,Illiterate,134,122,256
6238,35,State - ANDAMAN & NICOBAR ISLANDS,Urban,8,Illiterate,34,37,71
6239,35,State - ANDAMAN & NICOBAR ISLANDS,Urban,9,Illiterate,37,43,80
6240,35,State - ANDAMAN & NICOBAR ISLANDS,Urban,10,Illiterate,55,34,89
6241,35,State - ANDAMAN & NICOBAR ISLANDS,Urban,11,Illiterate,27,20,47
6242,35,State - ANDAMAN & NICOBAR ISLANDS,Urban,12,Illiterate,8,14,22
6243,35,State - ANDAMAN & NICOBAR ISLANDS,Urban,13,Illiterate,14,12,26
6244,35,State - ANDAMAN & NICOBAR ISLANDS,Urban,14,Illiterate,12,14,26
6245,35,State - ANDAMAN & NICOBAR ISLANDS,Urban,15,Illiterate,14,24,38
6246,35,State - ANDAMAN & NICOBAR ISLANDS,Urban,16,Illiterate,18,11,29
6247,35,State - ANDAMAN & NICOBAR ISLANDS,Urban,17,Illiterate,14,11,25
6248,35,State - ANDAMAN & NICOBAR ISLANDS,Urban,18,Illiterate,36,29,65
6249,35,State - ANDAMAN & NICOBAR ISLANDS,Urban,19,Illiterate,44,31,75
6250,35,State - ANDAMAN & NICOBAR ISLANDS,Urban,20-24,Illiterate,248,275,523
6251,35,State - ANDAMAN & NICOBAR ISLANDS,Urban,25-29,Illiterate,369,506,875
6252,35,State - ANDAMAN & NICOBAR ISLANDS,Urban,30-34,Illiterate,377,579,956
6253,35,State - ANDAMAN & NICOBAR ISLANDS,Urban,35-39,Illiterate,483,911,1394
6254,35,State - ANDAMAN & NICOBAR ISLANDS,Urban,40-44,Illiterate,537,964,1501
6255,35,State - ANDAMAN & NICOBAR ISLANDS,Urban,45-49,Illiterate,565,1079,1644
6256,35,State - ANDAMAN & NICOBAR ISLANDS,Urban,50-54,Illiterate,463,866,1329
6257,35,State - ANDAMAN & NICOBAR ISLANDS,Urban,55-59,Illiterate,397,763,1160
6258,35,State - ANDAMAN & NICOBAR ISLANDS,Urban,60-64,Illiterate,387,612,999
6259,35,State - ANDAMAN & NICOBAR ISLANDS,Urban,65-69,Illiterate,195,391,586
6260,35,State - ANDAMAN & NICOBAR ISLANDS,Urban,70-74,Illiterate,140,279,419
6261,35,State - ANDAMAN & NICOBAR ISLANDS,Urban,75-79,Illiterate,80,154,234
6262,35,State - ANDAMAN & NICOBAR ISLANDS,Urban,80+,Illiterate,68,196,264
6263,35,State - ANDAMAN & NICOBAR ISLANDS,Urban,Age not stated,Illiterate,11,25,36
6264,0,INDIA,Total,All ages,Literate,434763622,328875190,763638812
6265,0,INDIA,Total,0-6,Literate,0,0,0
6266,0,INDIA,Total,7,Literate,9514681,8563745,18078426
6267,0,INDIA,Total,8,Literate,12048195,10788764,22836959
6268,0,INDIA,Total,9,Literate,11016646,9916088,20932734
6269,0,INDIA,Total,10,Literate,14428312,12669290,27097602
6270,0,INDIA,Total,11,Literate,12033276,10719197,22752473
6271,0,INDIA,Total,12,Literate,13550572,11935206,25485778
6272,0,INDIA,Total,13,Literate,11772852,10697355,22470207
6273,0,INDIA,Total,14,Literate,12244668,10912716,23157384
6274,0,INDIA,Total,15,Literate,12563120,10736377,23299497
6275,0,INDIA,Total,16,Literate,11917057,10162749,22079806
6276,0,INDIA,Total,17,Literate,10469408,8709604,19179012
6277,0,INDIA,Total,18,Literate,13488663,10741509,24230172
6278,0,INDIA,Total,19,Literate,9908961,8371453,18280414
6279,0,INDIA,Total,20-24,Literate,51117667,41627063,92744730
6280,0,INDIA,Total,25-29,Literate,43781869,34997656,78779525
6281,0,INDIA,Total,30-34,Literate,36629924,27635467,64265391
6282,0,INDIA,Total,35-39,Literate,33580413,23697144,57277557
6283,0,INDIA,Total,40-44,Literate,27890354,17740886,45631240
6284,0,INDIA,Total,45-49,Literate,23122598,14117966,37240564
6285,0,INDIA,Total,50-54,Literate,18042253,10204793,28247046
6286,0,INDIA,Total,55-59,Literate,13750284,7713690,21463974
6287,0,INDIA,Total,60-64,Literate,11677024,5997244,17674268
6288,0,INDIA,Total,65-69,Literate,7799193,3826183,11625376
6289,0,INDIA,Total,70-74,Literate,5281747,2358471,7640218
6290,0,INDIA,Total,75-79,Literate,2599918,1271393,3871311
6291,0,INDIA,Total,80+,Literate,2827203,1571355,4398558
6292,0,INDIA,Total,Age not stated,Literate,1706764,1191826,2898590
6293,0,INDIA,Rural,All ages,Literate,281361374,201432461,482793835
6294,0,INDIA,Rural,0-6,Literate,0,0,0
6295,0,INDIA,Rural,7,Literate,6757329,6097259,12854588
6296,0,INDIA,Rural,8,Literate,8883920,7983711,16867631
6297,0,INDIA,Rural,9,Literate,7947440,7200142,15147582
6298,0,INDIA,Rural,10,Literate,10600205,9342540,19942745
6299,0,INDIA,Rural,11,Literate,8608702,7688974,16297676
6300,0,INDIA,Rural,12,Literate,9934005,8740846,18674851
6301,0,INDIA,Rural,13,Literate,8420076,7643435,16063511
6302,0,INDIA,Rural,14,Literate,8758372,7769699,16528071
6303,0,INDIA,Rural,15,Literate,8958668,7560867,16519535
6304,0,INDIA,Rural,16,Literate,8399696,7040477,15440173
6305,0,INDIA,Rural,17,Literate,7099947,5764799,12864746
6306,0,INDIA,Rural,18,Literate,9352281,7223187,16575468
6307,0,INDIA,Rural,19,Literate,6479154,5346354,11825508
6308,0,INDIA,Rural,20-24,Literate,33174966,25582555,58757521
6309,0,INDIA,Rural,25-29,Literate,27388206,20238915,47627121
6310,0,INDIA,Rural,30-34,Literate,22469220,15499539,37968759
6311,0,INDIA,Rural,35-39,Literate,20566659,12816038,33382697
6312,0,INDIA,Rural,40-44,Literate,16696968,9094454,25791422
6313,0,INDIA,Rural,45-49,Literate,13493304,6883861,20377165
6314,0,INDIA,Rural,50-54,Literate,10344414,4779544,15123958
6315,0,INDIA,Rural,55-59,Literate,7796813,3578782,11375595
6316,0,INDIA,Rural,60-64,Literate,6979169,2794225,9773394
6317,0,INDIA,Rural,65-69,Literate,4789428,1794292,6583720
6318,0,INDIA,Rural,70-74,Literate,3219650,1044755,4264405
6319,0,INDIA,Rural,75-79,Literate,1503548,526785,2030333
6320,0,INDIA,Rural,80+,Literate,1694262,711588,2405850
6321,0,INDIA,Rural,Age not stated,Literate,1044972,684838,1729810
6322,0,INDIA,Urban,All ages,Literate,153402248,127442729,280844977
6323,0,INDIA,Urban,0-6,Literate,0,0,0
6324,0,INDIA,Urban,7,Literate,2757352,2466486,5223838
6325,0,INDIA,Urban,8,Literate,3164275,2805053,5969328
6326,0,INDIA,Urban,9,Literate,3069206,2715946,5785152
6327,0,INDIA,Urban,10,Literate,3828107,3326750,7154857
6328,0,INDIA,Urban,11,Literate,3424574,3030223,6454797
6329,0,INDIA,Urban,12,Literate,3616567,3194360,6810927
6330,0,INDIA,Urban,13,Literate,3352776,3053920,6406696
6331,0,INDIA,Urban,14,Literate,3486296,3143017,6629313
6332,0,INDIA,Urban,15,Literate,3604452,3175510,6779962
6333,0,INDIA,Urban,16,Literate,3517361,3122272,6639633
6334,0,INDIA,Urban,17,Literate,3369461,2944805,6314266
6335,0,INDIA,Urban,18,Literate,4136382,3518322,7654704
6336,0,INDIA,Urban,19,Literate,3429807,3025099,6454906
6337,0,INDIA,Urban,20-24,Literate,17942701,16044508,33987209
6338,0,INDIA,Urban,25-29,Literate,16393663,14758741,31152404
6339,0,INDIA,Urban,30-34,Literate,14160704,12135928,26296632
6340,0,INDIA,Urban,35-39,Literate,13013754,10881106,23894860
6341,0,INDIA,Urban,40-44,Literate,11193386,8646432,19839818
6342,0,INDIA,Urban,45-49,Literate,9629294,7234105,16863399
6343,0,INDIA,Urban,50-54,Literate,7697839,5425249,13123088
6344,0,INDIA,Urban,55-59,Literate,5953471,4134908,10088379
6345,0,INDIA,Urban,60-64,Literate,4697855,3203019,7900874
6346,0,INDIA,Urban,65-69,Literate,3009765,2031891,5041656
6347,0,INDIA,Urban,70-74,Literate,2062097,1313716,3375813
6348,0,INDIA,Urban,75-79,Literate,1096370,744608,1840978
6349,0,INDIA,Urban,80+,Literate,1132941,859767,1992708
6350,0,INDIA,Urban,Age not stated,Literate,661792,506988,1168780
6351,1,State - JAMMU & KASHMIR,Total,All ages,Literate,4264671,2802562,7067233
6352,1,State - JAMMU & KASHMIR,Total,0-6,Literate,0,0,0
6353,1,State - JAMMU & KASHMIR,Total,7,Literate,96477,82700,179177
6354,1,State - JAMMU & KASHMIR,Total,8,Literate,121795,103757,225552
6355,1,State - JAMMU & KASHMIR,Total,9,Literate,115235,98112,213347
6356,1,State - JAMMU & KASHMIR,Total,10,Literate,142328,119843,262171
6357,1,State - JAMMU & KASHMIR,Total,11,Literate,134165,113744,247909
6358,1,State - JAMMU & KASHMIR,Total,12,Literate,139489,118307,257796
6359,1,State - JAMMU & KASHMIR,Total,13,Literate,126905,108415,235320
6360,1,State - JAMMU & KASHMIR,Total,14,Literate,130022,109842,239864
6361,1,State - JAMMU & KASHMIR,Total,15,Literate,129055,109401,238456
6362,1,State - JAMMU & KASHMIR,Total,16,Literate,125243,105234,230477
6363,1,State - JAMMU & KASHMIR,Total,17,Literate,106478,88393,194871
6364,1,State - JAMMU & KASHMIR,Total,18,Literate,127096,104196,231292
6365,1,State - JAMMU & KASHMIR,Total,19,Literate,97079,77985,175064
6366,1,State - JAMMU & KASHMIR,Total,20-24,Literate,529100,395043,924143
6367,1,State - JAMMU & KASHMIR,Total,25-29,Literate,493116,304463,797579
6368,1,State - JAMMU & KASHMIR,Total,30-34,Literate,395882,224692,620574
6369,1,State - JAMMU & KASHMIR,Total,35-39,Literate,329705,173886,503591
6370,1,State - JAMMU & KASHMIR,Total,40-44,Literate,266536,118327,384863
6371,1,State - JAMMU & KASHMIR,Total,45-49,Literate,201550,86956,288506
6372,1,State - JAMMU & KASHMIR,Total,50-54,Literate,151949,57978,209927
6373,1,State - JAMMU & KASHMIR,Total,55-59,Literate,103272,38226,141498
6374,1,State - JAMMU & KASHMIR,Total,60-64,Literate,81761,25138,106899
6375,1,State - JAMMU & KASHMIR,Total,65-69,Literate,46091,14214,60305
6376,1,State - JAMMU & KASHMIR,Total,70-74,Literate,32007,8926,40933
6377,1,State - JAMMU & KASHMIR,Total,75-79,Literate,14940,4523,19463
6378,1,State - JAMMU & KASHMIR,Total,80+,Literate,20310,7439,27749
6379,1,State - JAMMU & KASHMIR,Total,Age not stated,Literate,7085,2822,9907
6380,1,State - JAMMU & KASHMIR,Rural,All ages,Literate,2891749,1856201,4747950
6381,1,State - JAMMU & KASHMIR,Rural,0-6,Literate,0,0,0
6382,1,State - JAMMU & KASHMIR,Rural,7,Literate,73356,62543,135899
6383,1,State - JAMMU & KASHMIR,Rural,8,Literate,93716,79805,173521
6384,1,State - JAMMU & KASHMIR,Rural,9,Literate,88133,75203,163336
6385,1,State - JAMMU & KASHMIR,Rural,10,Literate,109212,92295,201507
6386,1,State - JAMMU & KASHMIR,Rural,11,Literate,103464,88001,191465
6387,1,State - JAMMU & KASHMIR,Rural,12,Literate,107922,91165,199087
6388,1,State - JAMMU & KASHMIR,Rural,13,Literate,97422,82861,180283
6389,1,State - JAMMU & KASHMIR,Rural,14,Literate,98942,82847,181789
6390,1,State - JAMMU & KASHMIR,Rural,15,Literate,97665,81963,179628
6391,1,State - JAMMU & KASHMIR,Rural,16,Literate,93928,77815,171743
6392,1,State - JAMMU & KASHMIR,Rural,17,Literate,78454,63543,141997
6393,1,State - JAMMU & KASHMIR,Rural,18,Literate,93410,74382,167792
6394,1,State - JAMMU & KASHMIR,Rural,19,Literate,69629,54227,123856
6395,1,State - JAMMU & KASHMIR,Rural,20-24,Literate,363903,266035,629938
6396,1,State - JAMMU & KASHMIR,Rural,25-29,Literate,312801,189617,502418
6397,1,State - JAMMU & KASHMIR,Rural,30-34,Literate,253745,134627,388372
6398,1,State - JAMMU & KASHMIR,Rural,35-39,Literate,207530,97205,304735
6399,1,State - JAMMU & KASHMIR,Rural,40-44,Literate,162059,60988,223047
6400,1,State - JAMMU & KASHMIR,Rural,45-49,Literate,118890,39558,158448
6401,1,State - JAMMU & KASHMIR,Rural,50-54,Literate,91308,23943,115251
6402,1,State - JAMMU & KASHMIR,Rural,55-59,Literate,60161,13954,74115
6403,1,State - JAMMU & KASHMIR,Rural,60-64,Literate,47890,9077,56967
6404,1,State - JAMMU & KASHMIR,Rural,65-69,Literate,25974,4701,30675
6405,1,State - JAMMU & KASHMIR,Rural,70-74,Literate,17964,3027,20991
6406,1,State - JAMMU & KASHMIR,Rural,75-79,Literate,7700,1442,9142
6407,1,State - JAMMU & KASHMIR,Rural,80+,Literate,11783,3395,15178
6408,1,State - JAMMU & KASHMIR,Rural,Age not stated,Literate,4788,1982,6770
6409,1,State - JAMMU & KASHMIR,Urban,All ages,Literate,1372922,946361,2319283
6410,1,State - JAMMU & KASHMIR,Urban,0-6,Literate,0,0,0
6411,1,State - JAMMU & KASHMIR,Urban,7,Literate,23121,20157,43278
6412,1,State - JAMMU & KASHMIR,Urban,8,Literate,28079,23952,52031
6413,1,State - JAMMU & KASHMIR,Urban,9,Literate,27102,22909,50011
6414,1,State - JAMMU & KASHMIR,Urban,10,Literate,33116,27548,60664
6415,1,State - JAMMU & KASHMIR,Urban,11,Literate,30701,25743,56444
6416,1,State - JAMMU & KASHMIR,Urban,12,Literate,31567,27142,58709
6417,1,State - JAMMU & KASHMIR,Urban,13,Literate,29483,25554,55037
6418,1,State - JAMMU & KASHMIR,Urban,14,Literate,31080,26995,58075
6419,1,State - JAMMU & KASHMIR,Urban,15,Literate,31390,27438,58828
6420,1,State - JAMMU & KASHMIR,Urban,16,Literate,31315,27419,58734
6421,1,State - JAMMU & KASHMIR,Urban,17,Literate,28024,24850,52874
6422,1,State - JAMMU & KASHMIR,Urban,18,Literate,33686,29814,63500
6423,1,State - JAMMU & KASHMIR,Urban,19,Literate,27450,23758,51208
6424,1,State - JAMMU & KASHMIR,Urban,20-24,Literate,165197,129008,294205
6425,1,State - JAMMU & KASHMIR,Urban,25-29,Literate,180315,114846,295161
6426,1,State - JAMMU & KASHMIR,Urban,30-34,Literate,142137,90065,232202
6427,1,State - JAMMU & KASHMIR,Urban,35-39,Literate,122175,76681,198856
6428,1,State - JAMMU & KASHMIR,Urban,40-44,Literate,104477,57339,161816
6429,1,State - JAMMU & KASHMIR,Urban,45-49,Literate,82660,47398,130058
6430,1,State - JAMMU & KASHMIR,Urban,50-54,Literate,60641,34035,94676
6431,1,State - JAMMU & KASHMIR,Urban,55-59,Literate,43111,24272,67383
6432,1,State - JAMMU & KASHMIR,Urban,60-64,Literate,33871,16061,49932
6433,1,State - JAMMU & KASHMIR,Urban,65-69,Literate,20117,9513,29630
6434,1,State - JAMMU & KASHMIR,Urban,70-74,Literate,14043,5899,19942
6435,1,State - JAMMU & KASHMIR,Urban,75-79,Literate,7240,3081,10321
6436,1,State - JAMMU & KASHMIR,Urban,80+,Literate,8527,4044,12571
6437,1,State - JAMMU & KASHMIR,Urban,Age not stated,Literate,2297,840,3137
6438,2,State - HIMACHAL PRADESH,Total,All ages,Literate,2752590,2287146,5039736
6439,2,State - HIMACHAL PRADESH,Total,0-6,Literate,0,0,0
6440,2,State - HIMACHAL PRADESH,Total,7,Literate,53835,48719,102554
6441,2,State - HIMACHAL PRADESH,Total,8,Literate,58610,52374,110984
6442,2,State - HIMACHAL PRADESH,Total,9,Literate,61285,53252,114537
6443,2,State - HIMACHAL PRADESH,Total,10,Literate,68520,59901,128421
6444,2,State - HIMACHAL PRADESH,Total,11,Literate,65912,57877,123789
6445,2,State - HIMACHAL PRADESH,Total,12,Literate,65521,57559,123080
6446,2,State - HIMACHAL PRADESH,Total,13,Literate,64193,57424,121617
6447,2,State - HIMACHAL PRADESH,Total,14,Literate,65526,59031,124557
6448,2,State - HIMACHAL PRADESH,Total,15,Literate,65675,58439,124114
6449,2,State - HIMACHAL PRADESH,Total,16,Literate,65163,58215,123378
6450,2,State - HIMACHAL PRADESH,Total,17,Literate,64335,57381,121716
6451,2,State - HIMACHAL PRADESH,Total,18,Literate,70053,62193,132246
6452,2,State - HIMACHAL PRADESH,Total,19,Literate,63101,58355,121456
6453,2,State - HIMACHAL PRADESH,Total,20-24,Literate,312462,302875,615337
6454,2,State - HIMACHAL PRADESH,Total,25-29,Literate,276792,272347,549139
6455,2,State - HIMACHAL PRADESH,Total,30-34,Literate,255889,238673,494562
6456,2,State - HIMACHAL PRADESH,Total,35-39,Literate,238517,207043,445560
6457,2,State - HIMACHAL PRADESH,Total,40-44,Literate,198376,157046,355422
6458,2,State - HIMACHAL PRADESH,Total,45-49,Literate,170329,125176,295505
6459,2,State - HIMACHAL PRADESH,Total,50-54,Literate,139234,92156,231390
6460,2,State - HIMACHAL PRADESH,Total,55-59,Literate,111512,63800,175312
6461,2,State - HIMACHAL PRADESH,Total,60-64,Literate,85581,38648,124229
6462,2,State - HIMACHAL PRADESH,Total,65-69,Literate,53764,20287,74051
6463,2,State - HIMACHAL PRADESH,Total,70-74,Literate,35960,12127,48087
6464,2,State - HIMACHAL PRADESH,Total,75-79,Literate,18980,5916,24896
6465,2,State - HIMACHAL PRADESH,Total,80+,Literate,19448,7130,26578
6466,2,State - HIMACHAL PRADESH,Total,Age not stated,Literate,4017,3202,7219
6467,2,State - HIMACHAL PRADESH,Rural,All ages,Literate,2437821,2033915,4471736
6468,2,State - HIMACHAL PRADESH,Rural,0-6,Literate,0,0,0
6469,2,State - HIMACHAL PRADESH,Rural,7,Literate,48933,44554,93487
6470,2,State - HIMACHAL PRADESH,Rural,8,Literate,53034,47719,100753
6471,2,State - HIMACHAL PRADESH,Rural,9,Literate,55561,48536,104097
6472,2,State - HIMACHAL PRADESH,Rural,10,Literate,62081,54729,116810
6473,2,State - HIMACHAL PRADESH,Rural,11,Literate,59429,52825,112254
6474,2,State - HIMACHAL PRADESH,Rural,12,Literate,59225,52598,111823
6475,2,State - HIMACHAL PRADESH,Rural,13,Literate,58013,52458,110471
6476,2,State - HIMACHAL PRADESH,Rural,14,Literate,59234,53912,113146
6477,2,State - HIMACHAL PRADESH,Rural,15,Literate,59118,53156,112274
6478,2,State - HIMACHAL PRADESH,Rural,16,Literate,58498,52962,111460
6479,2,State - HIMACHAL PRADESH,Rural,17,Literate,57842,51959,109801
6480,2,State - HIMACHAL PRADESH,Rural,18,Literate,62215,56435,118650
6481,2,State - HIMACHAL PRADESH,Rural,19,Literate,55929,52674,108603
6482,2,State - HIMACHAL PRADESH,Rural,20-24,Literate,275836,272718,548554
6483,2,State - HIMACHAL PRADESH,Rural,25-29,Literate,243609,244092,487701
6484,2,State - HIMACHAL PRADESH,Rural,30-34,Literate,225722,212075,437797
6485,2,State - HIMACHAL PRADESH,Rural,35-39,Literate,210222,181543,391765
6486,2,State - HIMACHAL PRADESH,Rural,40-44,Literate,173197,136204,309401
6487,2,State - HIMACHAL PRADESH,Rural,45-49,Literate,147998,107962,255960
6488,2,State - HIMACHAL PRADESH,Rural,50-54,Literate,120792,79415,200207
6489,2,State - HIMACHAL PRADESH,Rural,55-59,Literate,97384,54611,151995
6490,2,State - HIMACHAL PRADESH,Rural,60-64,Literate,76544,32242,108786
6491,2,State - HIMACHAL PRADESH,Rural,65-69,Literate,48104,16239,64343
6492,2,State - HIMACHAL PRADESH,Rural,70-74,Literate,31902,9409,41311
6493,2,State - HIMACHAL PRADESH,Rural,75-79,Literate,16626,4413,21039
6494,2,State - HIMACHAL PRADESH,Rural,80+,Literate,17147,5540,22687
6495,2,State - HIMACHAL PRADESH,Rural,Age not stated,Literate,3626,2935,6561
6496,2,State - HIMACHAL PRADESH,Urban,All ages,Literate,314769,253231,568000
6497,2,State - HIMACHAL PRADESH,Urban,0-6,Literate,0,0,0
6498,2,State - HIMACHAL PRADESH,Urban,7,Literate,4902,4165,9067
6499,2,State - HIMACHAL PRADESH,Urban,8,Literate,5576,4655,10231
6500,2,State - HIMACHAL PRADESH,Urban,9,Literate,5724,4716,10440
6501,2,State - HIMACHAL PRADESH,Urban,10,Literate,6439,5172,11611
6502,2,State - HIMACHAL PRADESH,Urban,11,Literate,6483,5052,11535
6503,2,State - HIMACHAL PRADESH,Urban,12,Literate,6296,4961,11257
6504,2,State - HIMACHAL PRADESH,Urban,13,Literate,6180,4966,11146
6505,2,State - HIMACHAL PRADESH,Urban,14,Literate,6292,5119,11411
6506,2,State - HIMACHAL PRADESH,Urban,15,Literate,6557,5283,11840
6507,2,State - HIMACHAL PRADESH,Urban,16,Literate,6665,5253,11918
6508,2,State - HIMACHAL PRADESH,Urban,17,Literate,6493,5422,11915
6509,2,State - HIMACHAL PRADESH,Urban,18,Literate,7838,5758,13596
6510,2,State - HIMACHAL PRADESH,Urban,19,Literate,7172,5681,12853
6511,2,State - HIMACHAL PRADESH,Urban,20-24,Literate,36626,30157,66783
6512,2,State - HIMACHAL PRADESH,Urban,25-29,Literate,33183,28255,61438
6513,2,State - HIMACHAL PRADESH,Urban,30-34,Literate,30167,26598,56765
6514,2,State - HIMACHAL PRADESH,Urban,35-39,Literate,28295,25500,53795
6515,2,State - HIMACHAL PRADESH,Urban,40-44,Literate,25179,20842,46021
6516,2,State - HIMACHAL PRADESH,Urban,45-49,Literate,22331,17214,39545
6517,2,State - HIMACHAL PRADESH,Urban,50-54,Literate,18442,12741,31183
6518,2,State - HIMACHAL PRADESH,Urban,55-59,Literate,14128,9189,23317
6519,2,State - HIMACHAL PRADESH,Urban,60-64,Literate,9037,6406,15443
6520,2,State - HIMACHAL PRADESH,Urban,65-69,Literate,5660,4048,9708
6521,2,State - HIMACHAL PRADESH,Urban,70-74,Literate,4058,2718,6776
6522,2,State - HIMACHAL PRADESH,Urban,75-79,Literate,2354,1503,3857
6523,2,State - HIMACHAL PRADESH,Urban,80+,Literate,2301,1590,3891
6524,2,State - HIMACHAL PRADESH,Urban,Age not stated,Literate,391,267,658
6525,3,State - PUNJAB,Total,All ages,Literate,10436056,8271081,18707137
6526,3,State - PUNJAB,Total,0-6,Literate,0,0,0
6527,3,State - PUNJAB,Total,7,Literate,204531,170336,374867
6528,3,State - PUNJAB,Total,8,Literate,233482,188980,422462
6529,3,State - PUNJAB,Total,9,Literate,238733,185014,423747
6530,3,State - PUNJAB,Total,10,Literate,278056,210914,488970
6531,3,State - PUNJAB,Total,11,Literate,258199,198476,456675
6532,3,State - PUNJAB,Total,12,Literate,270576,211249,481825
6533,3,State - PUNJAB,Total,13,Literate,267052,211828,478880
6534,3,State - PUNJAB,Total,14,Literate,275341,218911,494252
6535,3,State - PUNJAB,Total,15,Literate,284722,224410,509132
6536,3,State - PUNJAB,Total,16,Literate,287123,229068,516191
6537,3,State - PUNJAB,Total,17,Literate,276698,219187,495885
6538,3,State - PUNJAB,Total,18,Literate,319861,247917,567778
6539,3,State - PUNJAB,Total,19,Literate,268676,216329,485005
6540,3,State - PUNJAB,Total,20-24,Literate,1308506,1138662,2447168
6541,3,State - PUNJAB,Total,25-29,Literate,1100401,968409,2068810
6542,3,State - PUNJAB,Total,30-34,Literate,896510,765247,1661757
6543,3,State - PUNJAB,Total,35-39,Literate,792255,662969,1455224
6544,3,State - PUNJAB,Total,40-44,Literate,679735,553277,1233012
6545,3,State - PUNJAB,Total,45-49,Literate,599449,456011,1055460
6546,3,State - PUNJAB,Total,50-54,Literate,467983,330853,798836
6547,3,State - PUNJAB,Total,55-59,Literate,352518,236698,589216
6548,3,State - PUNJAB,Total,60-64,Literate,295146,190533,485679
6549,3,State - PUNJAB,Total,65-69,Literate,206386,102671,309057
6550,3,State - PUNJAB,Total,70-74,Literate,126943,57564,184507
6551,3,State - PUNJAB,Total,75-79,Literate,59973,27576,87549
6552,3,State - PUNJAB,Total,80+,Literate,71284,35915,107199
6553,3,State - PUNJAB,Total,Age not stated,Literate,15917,12077,27994
6554,3,State - PUNJAB,Rural,All ages,Literate,6158807,4838850,10997657
6555,3,State - PUNJAB,Rural,0-6,Literate,0,0,0
6556,3,State - PUNJAB,Rural,7,Literate,129417,108360,237777
6557,3,State - PUNJAB,Rural,8,Literate,149895,122119,272014
6558,3,State - PUNJAB,Rural,9,Literate,153688,119724,273412
6559,3,State - PUNJAB,Rural,10,Literate,177184,135273,312457
6560,3,State - PUNJAB,Rural,11,Literate,166129,127958,294087
6561,3,State - PUNJAB,Rural,12,Literate,175973,137600,313573
6562,3,State - PUNJAB,Rural,13,Literate,173693,139087,312780
6563,3,State - PUNJAB,Rural,14,Literate,179345,143408,322753
6564,3,State - PUNJAB,Rural,15,Literate,184270,146925,331195
6565,3,State - PUNJAB,Rural,16,Literate,186754,150626,337380
6566,3,State - PUNJAB,Rural,17,Literate,178239,142685,320924
6567,3,State - PUNJAB,Rural,18,Literate,203040,159847,362887
6568,3,State - PUNJAB,Rural,19,Literate,166553,136508,303061
6569,3,State - PUNJAB,Rural,20-24,Literate,784995,700920,1485915
6570,3,State - PUNJAB,Rural,25-29,Literate,623282,562549,1185831
6571,3,State - PUNJAB,Rural,30-34,Literate,504591,435406,939997
6572,3,State - PUNJAB,Rural,35-39,Literate,446076,369916,815992
6573,3,State - PUNJAB,Rural,40-44,Literate,385957,305906,691863
6574,3,State - PUNJAB,Rural,45-49,Literate,332664,236721,569385
6575,3,State - PUNJAB,Rural,50-54,Literate,248823,157838,406661
6576,3,State - PUNJAB,Rural,55-59,Literate,180409,107069,287478
6577,3,State - PUNJAB,Rural,60-64,Literate,158068,88462,246530
6578,3,State - PUNJAB,Rural,65-69,Literate,117914,45091,163005
6579,3,State - PUNJAB,Rural,70-74,Literate,70224,23291,93515
6580,3,State - PUNJAB,Rural,75-79,Literate,30658,10553,41211
6581,3,State - PUNJAB,Rural,80+,Literate,39880,16702,56582
6582,3,State - PUNJAB,Rural,Age not stated,Literate,11086,8306,19392
6583,3,State - PUNJAB,Urban,All ages,Literate,4277249,3432231,7709480
6584,3,State - PUNJAB,Urban,0-6,Literate,0,0,0
6585,3,State - PUNJAB,Urban,7,Literate,75114,61976,137090
6586,3,State - PUNJAB,Urban,8,Literate,83587,66861,150448
6587,3,State - PUNJAB,Urban,9,Literate,85045,65290,150335
6588,3,State - PUNJAB,Urban,10,Literate,100872,75641,176513
6589,3,State - PUNJAB,Urban,11,Literate,92070,70518,162588
6590,3,State - PUNJAB,Urban,12,Literate,94603,73649,168252
6591,3,State - PUNJAB,Urban,13,Literate,93359,72741,166100
6592,3,State - PUNJAB,Urban,14,Literate,95996,75503,171499
6593,3,State - PUNJAB,Urban,15,Literate,100452,77485,177937
6594,3,State - PUNJAB,Urban,16,Literate,100369,78442,178811
6595,3,State - PUNJAB,Urban,17,Literate,98459,76502,174961
6596,3,State - PUNJAB,Urban,18,Literate,116821,88070,204891
6597,3,State - PUNJAB,Urban,19,Literate,102123,79821,181944
6598,3,State - PUNJAB,Urban,20-24,Literate,523511,437742,961253
6599,3,State - PUNJAB,Urban,25-29,Literate,477119,405860,882979
6600,3,State - PUNJAB,Urban,30-34,Literate,391919,329841,721760
6601,3,State - PUNJAB,Urban,35-39,Literate,346179,293053,639232
6602,3,State - PUNJAB,Urban,40-44,Literate,293778,247371,541149
6603,3,State - PUNJAB,Urban,45-49,Literate,266785,219290,486075
6604,3,State - PUNJAB,Urban,50-54,Literate,219160,173015,392175
6605,3,State - PUNJAB,Urban,55-59,Literate,172109,129629,301738
6606,3,State - PUNJAB,Urban,60-64,Literate,137078,102071,239149
6607,3,State - PUNJAB,Urban,65-69,Literate,88472,57580,146052
6608,3,State - PUNJAB,Urban,70-74,Literate,56719,34273,90992
6609,3,State - PUNJAB,Urban,75-79,Literate,29315,17023,46338
6610,3,State - PUNJAB,Urban,80+,Literate,31404,19213,50617
6611,3,State - PUNJAB,Urban,Age not stated,Literate,4831,3771,8602
6612,4,State - CHANDIGARH,Total,All ages,Literate,465346,340092,805438
6613,4,State - CHANDIGARH,Total,0-6,Literate,0,0,0
6614,4,State - CHANDIGARH,Total,7,Literate,8338,7114,15452
6615,4,State - CHANDIGARH,Total,8,Literate,8675,7201,15876
6616,4,State - CHANDIGARH,Total,9,Literate,8974,7348,16322
6617,4,State - CHANDIGARH,Total,10,Literate,10616,8179,18795
6618,4,State - CHANDIGARH,Total,11,Literate,9715,7632,17347
6619,4,State - CHANDIGARH,Total,12,Literate,10014,7775,17789
6620,4,State - CHANDIGARH,Total,13,Literate,9464,7484,16948
6621,4,State - CHANDIGARH,Total,14,Literate,9830,7717,17547
6622,4,State - CHANDIGARH,Total,15,Literate,9974,7776,17750
6623,4,State - CHANDIGARH,Total,16,Literate,10456,7889,18345
6624,4,State - CHANDIGARH,Total,17,Literate,10486,7485,17971
6625,4,State - CHANDIGARH,Total,18,Literate,13626,9123,22749
6626,4,State - CHANDIGARH,Total,19,Literate,12030,8649,20679
6627,4,State - CHANDIGARH,Total,20-24,Literate,63655,47161,110816
6628,4,State - CHANDIGARH,Total,25-29,Literate,55510,41370,96880
6629,4,State - CHANDIGARH,Total,30-34,Literate,44523,32225,76748
6630,4,State - CHANDIGARH,Total,35-39,Literate,39488,28082,67570
6631,4,State - CHANDIGARH,Total,40-44,Literate,32053,22773,54826
6632,4,State - CHANDIGARH,Total,45-49,Literate,28115,19815,47930
6633,4,State - CHANDIGARH,Total,50-54,Literate,22678,15331,38009
6634,4,State - CHANDIGARH,Total,55-59,Literate,17595,11173,28768
6635,4,State - CHANDIGARH,Total,60-64,Literate,11368,8036,19404
6636,4,State - CHANDIGARH,Total,65-69,Literate,7006,5017,12023
6637,4,State - CHANDIGARH,Total,70-74,Literate,5007,3437,8444
6638,4,State - CHANDIGARH,Total,75-79,Literate,2858,2094,4952
6639,4,State - CHANDIGARH,Total,80+,Literate,3127,2112,5239
6640,4,State - CHANDIGARH,Total,Age not stated,Literate,165,94,259
6641,4,State - CHANDIGARH,Rural,All ages,Literate,12752,7209,19961
6642,4,State - CHANDIGARH,Rural,0-6,Literate,0,0,0
6643,4,State - CHANDIGARH,Rural,7,Literate,251,204,455
6644,4,State - CHANDIGARH,Rural,8,Literate,269,230,499
6645,4,State - CHANDIGARH,Rural,9,Literate,246,222,468
6646,4,State - CHANDIGARH,Rural,10,Literate,320,231,551
6647,4,State - CHANDIGARH,Rural,11,Literate,285,222,507
6648,4,State - CHANDIGARH,Rural,12,Literate,284,183,467
6649,4,State - CHANDIGARH,Rural,13,Literate,219,181,400
6650,4,State - CHANDIGARH,Rural,14,Literate,225,190,415
6651,4,State - CHANDIGARH,Rural,15,Literate,278,188,466
6652,4,State - CHANDIGARH,Rural,16,Literate,290,160,450
6653,4,State - CHANDIGARH,Rural,17,Literate,258,161,419
6654,4,State - CHANDIGARH,Rural,18,Literate,423,182,605
6655,4,State - CHANDIGARH,Rural,19,Literate,349,174,523
6656,4,State - CHANDIGARH,Rural,20-24,Literate,1993,1101,3094
6657,4,State - CHANDIGARH,Rural,25-29,Literate,1981,1181,3162
6658,4,State - CHANDIGARH,Rural,30-34,Literate,1666,842,2508
6659,4,State - CHANDIGARH,Rural,35-39,Literate,1211,560,1771
6660,4,State - CHANDIGARH,Rural,40-44,Literate,779,356,1135
6661,4,State - CHANDIGARH,Rural,45-49,Literate,499,235,734
6662,4,State - CHANDIGARH,Rural,50-54,Literate,321,164,485
6663,4,State - CHANDIGARH,Rural,55-59,Literate,220,110,330
6664,4,State - CHANDIGARH,Rural,60-64,Literate,186,65,251
6665,4,State - CHANDIGARH,Rural,65-69,Literate,87,29,116
6666,4,State - CHANDIGARH,Rural,70-74,Literate,59,22,81
6667,4,State - CHANDIGARH,Rural,75-79,Literate,26,5,31
6668,4,State - CHANDIGARH,Rural,80+,Literate,24,10,34
6669,4,State - CHANDIGARH,Rural,Age not stated,Literate,3,1,4
6670,4,State - CHANDIGARH,Urban,All ages,Literate,452594,332883,785477
6671,4,State - CHANDIGARH,Urban,0-6,Literate,0,0,0
6672,4,State - CHANDIGARH,Urban,7,Literate,8087,6910,14997
6673,4,State - CHANDIGARH,Urban,8,Literate,8406,6971,15377
6674,4,State - CHANDIGARH,Urban,9,Literate,8728,7126,15854
6675,4,State - CHANDIGARH,Urban,10,Literate,10296,7948,18244
6676,4,State - CHANDIGARH,Urban,11,Literate,9430,7410,16840
6677,4,State - CHANDIGARH,Urban,12,Literate,9730,7592,17322
6678,4,State - CHANDIGARH,Urban,13,Literate,9245,7303,16548
6679,4,State - CHANDIGARH,Urban,14,Literate,9605,7527,17132
6680,4,State - CHANDIGARH,Urban,15,Literate,9696,7588,17284
6681,4,State - CHANDIGARH,Urban,16,Literate,10166,7729,17895
6682,4,State - CHANDIGARH,Urban,17,Literate,10228,7324,17552
6683,4,State - CHANDIGARH,Urban,18,Literate,13203,8941,22144
6684,4,State - CHANDIGARH,Urban,19,Literate,11681,8475,20156
6685,4,State - CHANDIGARH,Urban,20-24,Literate,61662,46060,107722
6686,4,State - CHANDIGARH,Urban,25-29,Literate,53529,40189,93718
6687,4,State - CHANDIGARH,Urban,30-34,Literate,42857,31383,74240
6688,4,State - CHANDIGARH,Urban,35-39,Literate,38277,27522,65799
6689,4,State - CHANDIGARH,Urban,40-44,Literate,31274,22417,53691
6690,4,State - CHANDIGARH,Urban,45-49,Literate,27616,19580,47196
6691,4,State - CHANDIGARH,Urban,50-54,Literate,22357,15167,37524
6692,4,State - CHANDIGARH,Urban,55-59,Literate,17375,11063,28438
6693,4,State - CHANDIGARH,Urban,60-64,Literate,11182,7971,19153
6694,4,State - CHANDIGARH,Urban,65-69,Literate,6919,4988,11907
6695,4,State - CHANDIGARH,Urban,70-74,Literate,4948,3415,8363
6696,4,State - CHANDIGARH,Urban,75-79,Literate,2832,2089,4921
6697,4,State - CHANDIGARH,Urban,80+,Literate,3103,2102,5205
6698,4,State - CHANDIGARH,Urban,Age not stated,Literate,162,93,255
6699,5,State - UTTARAKHAND,Total,All ages,Literate,3863708,3017245,6880953
6700,5,State - UTTARAKHAND,Total,0-6,Literate,0,0,0
6701,5,State - UTTARAKHAND,Total,7,Literate,87338,77654,164992
6702,5,State - UTTARAKHAND,Total,8,Literate,104014,91493,195507
6703,5,State - UTTARAKHAND,Total,9,Literate,98974,86768,185742
6704,5,State - UTTARAKHAND,Total,10,Literate,123365,105842,229207
6705,5,State - UTTARAKHAND,Total,11,Literate,108342,95323,203665
6706,5,State - UTTARAKHAND,Total,12,Literate,120115,106214,226329
6707,5,State - UTTARAKHAND,Total,13,Literate,107664,98893,206557
6708,5,State - UTTARAKHAND,Total,14,Literate,114440,104386,218826
6709,5,State - UTTARAKHAND,Total,15,Literate,116118,105198,221316
6710,5,State - UTTARAKHAND,Total,16,Literate,113572,103648,217220
6711,5,State - UTTARAKHAND,Total,17,Literate,103849,91972,195821
6712,5,State - UTTARAKHAND,Total,18,Literate,126683,108388,235071
6713,5,State - UTTARAKHAND,Total,19,Literate,97823,87052,184875
6714,5,State - UTTARAKHAND,Total,20-24,Literate,450715,422160,872875
6715,5,State - UTTARAKHAND,Total,25-29,Literate,360114,328145,688259
6716,5,State - UTTARAKHAND,Total,30-34,Literate,305632,250540,556172
6717,5,State - UTTARAKHAND,Total,35-39,Literate,282669,209424,492093
6718,5,State - UTTARAKHAND,Total,40-44,Literate,237452,156282,393734
6719,5,State - UTTARAKHAND,Total,45-49,Literate,203331,121191,324522
6720,5,State - UTTARAKHAND,Total,50-54,Literate,163719,87959,251678
6721,5,State - UTTARAKHAND,Total,55-59,Literate,122693,63739,186432
6722,5,State - UTTARAKHAND,Total,60-64,Literate,118696,46853,165549
6723,5,State - UTTARAKHAND,Total,65-69,Literate,78218,27866,106084
6724,5,State - UTTARAKHAND,Total,70-74,Literate,54492,16254,70746
6725,5,State - UTTARAKHAND,Total,75-79,Literate,27283,8210,35493
6726,5,State - UTTARAKHAND,Total,80+,Literate,28975,11006,39981
6727,5,State - UTTARAKHAND,Total,Age not stated,Literate,7422,4785,12207
6728,5,State - UTTARAKHAND,Rural,All ages,Literate,2596171,2017879,4614050
6729,5,State - UTTARAKHAND,Rural,0-6,Literate,0,0,0
6730,5,State - UTTARAKHAND,Rural,7,Literate,62389,56730,119119
6731,5,State - UTTARAKHAND,Rural,8,Literate,75527,67558,143085
6732,5,State - UTTARAKHAND,Rural,9,Literate,71667,64470,136137
6733,5,State - UTTARAKHAND,Rural,10,Literate,88949,78417,167366
6734,5,State - UTTARAKHAND,Rural,11,Literate,78496,70909,149405
6735,5,State - UTTARAKHAND,Rural,12,Literate,87798,79603,167401
6736,5,State - UTTARAKHAND,Rural,13,Literate,78119,73709,151828
6737,5,State - UTTARAKHAND,Rural,14,Literate,82679,77034,159713
6738,5,State - UTTARAKHAND,Rural,15,Literate,83325,77310,160635
6739,5,State - UTTARAKHAND,Rural,16,Literate,80847,75979,156826
6740,5,State - UTTARAKHAND,Rural,17,Literate,72509,65807,138316
6741,5,State - UTTARAKHAND,Rural,18,Literate,87408,77647,165055
6742,5,State - UTTARAKHAND,Rural,19,Literate,65412,61859,127271
6743,5,State - UTTARAKHAND,Rural,20-24,Literate,291959,289693,581652
6744,5,State - UTTARAKHAND,Rural,25-29,Literate,229352,213627,442979
6745,5,State - UTTARAKHAND,Rural,30-34,Literate,195175,158339,353514
6746,5,State - UTTARAKHAND,Rural,35-39,Literate,181998,128172,310170
6747,5,State - UTTARAKHAND,Rural,40-44,Literate,152953,92039,244992
6748,5,State - UTTARAKHAND,Rural,45-49,Literate,128774,68453,197227
6749,5,State - UTTARAKHAND,Rural,50-54,Literate,104422,48527,152949
6750,5,State - UTTARAKHAND,Rural,55-59,Literate,78431,34440,112871
6751,5,State - UTTARAKHAND,Rural,60-64,Literate,82988,24269,107257
6752,5,State - UTTARAKHAND,Rural,65-69,Literate,53726,13819,67545
6753,5,State - UTTARAKHAND,Rural,70-74,Literate,38260,7754,46014
6754,5,State - UTTARAKHAND,Rural,75-79,Literate,18974,3579,22553
6755,5,State - UTTARAKHAND,Rural,80+,Literate,19541,5190,24731
6756,5,State - UTTARAKHAND,Rural,Age not stated,Literate,4493,2946,7439
6757,5,State - UTTARAKHAND,Urban,All ages,Literate,1267537,999366,2266903
6758,5,State - UTTARAKHAND,Urban,0-6,Literate,0,0,0
6759,5,State - UTTARAKHAND,Urban,7,Literate,24949,20924,45873
6760,5,State - UTTARAKHAND,Urban,8,Literate,28487,23935,52422
6761,5,State - UTTARAKHAND,Urban,9,Literate,27307,22298,49605
6762,5,State - UTTARAKHAND,Urban,10,Literate,34416,27425,61841
6763,5,State - UTTARAKHAND,Urban,11,Literate,29846,24414,54260
6764,5,State - UTTARAKHAND,Urban,12,Literate,32317,26611,58928
6765,5,State - UTTARAKHAND,Urban,13,Literate,29545,25184,54729
6766,5,State - UTTARAKHAND,Urban,14,Literate,31761,27352,59113
6767,5,State - UTTARAKHAND,Urban,15,Literate,32793,27888,60681
6768,5,State - UTTARAKHAND,Urban,16,Literate,32725,27669,60394
6769,5,State - UTTARAKHAND,Urban,17,Literate,31340,26165,57505
6770,5,State - UTTARAKHAND,Urban,18,Literate,39275,30741,70016
6771,5,State - UTTARAKHAND,Urban,19,Literate,32411,25193,57604
6772,5,State - UTTARAKHAND,Urban,20-24,Literate,158756,132467,291223
6773,5,State - UTTARAKHAND,Urban,25-29,Literate,130762,114518,245280
6774,5,State - UTTARAKHAND,Urban,30-34,Literate,110457,92201,202658
6775,5,State - UTTARAKHAND,Urban,35-39,Literate,100671,81252,181923
6776,5,State - UTTARAKHAND,Urban,40-44,Literate,84499,64243,148742
6777,5,State - UTTARAKHAND,Urban,45-49,Literate,74557,52738,127295
6778,5,State - UTTARAKHAND,Urban,50-54,Literate,59297,39432,98729
6779,5,State - UTTARAKHAND,Urban,55-59,Literate,44262,29299,73561
6780,5,State - UTTARAKHAND,Urban,60-64,Literate,35708,22584,58292
6781,5,State - UTTARAKHAND,Urban,65-69,Literate,24492,14047,38539
6782,5,State - UTTARAKHAND,Urban,70-74,Literate,16232,8500,24732
6783,5,State - UTTARAKHAND,Urban,75-79,Literate,8309,4631,12940
6784,5,State - UTTARAKHAND,Urban,80+,Literate,9434,5816,15250
6785,5,State - UTTARAKHAND,Urban,Age not stated,Literate,2929,1839,4768
6786,6,State - HARYANA,Total,All ages,Literate,9794067,6804921,16598988
6787,6,State - HARYANA,Total,0-6,Literate,0,0,0
6788,6,State - HARYANA,Total,7,Literate,216880,176661,393541
6789,6,State - HARYANA,Total,8,Literate,253055,202852,455907
6790,6,State - HARYANA,Total,9,Literate,241530,189522,431052
6791,6,State - HARYANA,Total,10,Literate,296127,227244,523371
6792,6,State - HARYANA,Total,11,Literate,268085,208332,476417
6793,6,State - HARYANA,Total,12,Literate,290674,225992,516666
6794,6,State - HARYANA,Total,13,Literate,265117,214771,479888
6795,6,State - HARYANA,Total,14,Literate,274665,220106,494771
6796,6,State - HARYANA,Total,15,Literate,288207,225367,513574
6797,6,State - HARYANA,Total,16,Literate,284971,219924,504895
6798,6,State - HARYANA,Total,17,Literate,258592,196282,454874
6799,6,State - HARYANA,Total,18,Literate,315005,233409,548414
6800,6,State - HARYANA,Total,19,Literate,246589,190533,437122
6801,6,State - HARYANA,Total,20-24,Literate,1261175,997983,2259158
6802,6,State - HARYANA,Total,25-29,Literate,1056743,816998,1873741
6803,6,State - HARYANA,Total,30-34,Literate,848147,633306,1481453
6804,6,State - HARYANA,Total,35-39,Literate,757970,491953,1249923
6805,6,State - HARYANA,Total,40-44,Literate,617892,341694,959586
6806,6,State - HARYANA,Total,45-49,Literate,497047,245336,742383
6807,6,State - HARYANA,Total,50-54,Literate,373201,175406,548607
6808,6,State - HARYANA,Total,55-59,Literate,275698,127850,403548
6809,6,State - HARYANA,Total,60-64,Literate,258042,108600,366642
6810,6,State - HARYANA,Total,65-69,Literate,148223,55423,203646
6811,6,State - HARYANA,Total,70-74,Literate,92927,33341,126268
6812,6,State - HARYANA,Total,75-79,Literate,44638,16172,60810
6813,6,State - HARYANA,Total,80+,Literate,50981,21428,72409
6814,6,State - HARYANA,Total,Age not stated,Literate,11886,8436,20322
6815,6,State - HARYANA,Rural,All ages,Literate,6140099,4018343,10158442
6816,6,State - HARYANA,Rural,0-6,Literate,0,0,0
6817,6,State - HARYANA,Rural,7,Literate,144754,118174,262928
6818,6,State - HARYANA,Rural,8,Literate,171782,138021,309803
6819,6,State - HARYANA,Rural,9,Literate,162879,128467,291346
6820,6,State - HARYANA,Rural,10,Literate,199005,154248,353253
6821,6,State - HARYANA,Rural,11,Literate,181357,142160,323517
6822,6,State - HARYANA,Rural,12,Literate,198670,154785,353455
6823,6,State - HARYANA,Rural,13,Literate,180559,146573,327132
6824,6,State - HARYANA,Rural,14,Literate,186420,150145,336565
6825,6,State - HARYANA,Rural,15,Literate,195978,153316,349294
6826,6,State - HARYANA,Rural,16,Literate,193862,149648,343510
6827,6,State - HARYANA,Rural,17,Literate,172735,130601,303336
6828,6,State - HARYANA,Rural,18,Literate,210379,155502,365881
6829,6,State - HARYANA,Rural,19,Literate,160840,124770,285610
6830,6,State - HARYANA,Rural,20-24,Literate,815153,625858,1441011
6831,6,State - HARYANA,Rural,25-29,Literate,654961,476510,1131471
6832,6,State - HARYANA,Rural,30-34,Literate,514684,358366,873050
6833,6,State - HARYANA,Rural,35-39,Literate,457834,258203,716037
6834,6,State - HARYANA,Rural,40-44,Literate,366176,162250,528426
6835,6,State - HARYANA,Rural,45-49,Literate,282766,99575,382341
6836,6,State - HARYANA,Rural,50-54,Literate,203813,64052,267865
6837,6,State - HARYANA,Rural,55-59,Literate,146526,43849,190375
6838,6,State - HARYANA,Rural,60-64,Literate,148051,38721,186772
6839,6,State - HARYANA,Rural,65-69,Literate,82263,17452,99715
6840,6,State - HARYANA,Rural,70-74,Literate,50668,9753,60421
6841,6,State - HARYANA,Rural,75-79,Literate,22810,4471,27281
6842,6,State - HARYANA,Rural,80+,Literate,27687,7772,35459
6843,6,State - HARYANA,Rural,Age not stated,Literate,7487,5101,12588
6844,6,State - HARYANA,Urban,All ages,Literate,3653968,2786578,6440546
6845,6,State - HARYANA,Urban,0-6,Literate,0,0,0
6846,6,State - HARYANA,Urban,7,Literate,72126,58487,130613
6847,6,State - HARYANA,Urban,8,Literate,81273,64831,146104
6848,6,State - HARYANA,Urban,9,Literate,78651,61055,139706
6849,6,State - HARYANA,Urban,10,Literate,97122,72996,170118
6850,6,State - HARYANA,Urban,11,Literate,86728,66172,152900
6851,6,State - HARYANA,Urban,12,Literate,92004,71207,163211
6852,6,State - HARYANA,Urban,13,Literate,84558,68198,152756
6853,6,State - HARYANA,Urban,14,Literate,88245,69961,158206
6854,6,State - HARYANA,Urban,15,Literate,92229,72051,164280
6855,6,State - HARYANA,Urban,16,Literate,91109,70276,161385
6856,6,State - HARYANA,Urban,17,Literate,85857,65681,151538
6857,6,State - HARYANA,Urban,18,Literate,104626,77907,182533
6858,6,State - HARYANA,Urban,19,Literate,85749,65763,151512
6859,6,State - HARYANA,Urban,20-24,Literate,446022,372125,818147
6860,6,State - HARYANA,Urban,25-29,Literate,401782,340488,742270
6861,6,State - HARYANA,Urban,30-34,Literate,333463,274940,608403
6862,6,State - HARYANA,Urban,35-39,Literate,300136,233750,533886
6863,6,State - HARYANA,Urban,40-44,Literate,251716,179444,431160
6864,6,State - HARYANA,Urban,45-49,Literate,214281,145761,360042
6865,6,State - HARYANA,Urban,50-54,Literate,169388,111354,280742
6866,6,State - HARYANA,Urban,55-59,Literate,129172,84001,213173
6867,6,State - HARYANA,Urban,60-64,Literate,109991,69879,179870
6868,6,State - HARYANA,Urban,65-69,Literate,65960,37971,103931
6869,6,State - HARYANA,Urban,70-74,Literate,42259,23588,65847
6870,6,State - HARYANA,Urban,75-79,Literate,21828,11701,33529
6871,6,State - HARYANA,Urban,80+,Literate,23294,13656,36950
6872,6,State - HARYANA,Urban,Age not stated,Literate,4399,3335,7734
6873,7,State - NCT OF DELHI,Total,All ages,Literate,7194856,5542911,12737767
6874,7,State - NCT OF DELHI,Total,0-6,Literate,0,0,0
6875,7,State - NCT OF DELHI,Total,7,Literate,131337,113823,245160
6876,7,State - NCT OF DELHI,Total,8,Literate,152909,129257,282166
6877,7,State - NCT OF DELHI,Total,9,Literate,148167,123303,271470
6878,7,State - NCT OF DELHI,Total,10,Literate,186748,152100,338848
6879,7,State - NCT OF DELHI,Total,11,Literate,163835,136494,300329
6880,7,State - NCT OF DELHI,Total,12,Literate,176243,146224,322467
6881,7,State - NCT OF DELHI,Total,13,Literate,161275,138248,299523
6882,7,State - NCT OF DELHI,Total,14,Literate,169225,143458,312683
6883,7,State - NCT OF DELHI,Total,15,Literate,174518,143920,318438
6884,7,State - NCT OF DELHI,Total,16,Literate,170583,140815,311398
6885,7,State - NCT OF DELHI,Total,17,Literate,163625,131195,294820
6886,7,State - NCT OF DELHI,Total,18,Literate,203235,154296,357531
6887,7,State - NCT OF DELHI,Total,19,Literate,164472,129030,293502
6888,7,State - NCT OF DELHI,Total,20-24,Literate,891067,730168,1621235
6889,7,State - NCT OF DELHI,Total,25-29,Literate,813927,675968,1489895
6890,7,State - NCT OF DELHI,Total,30-34,Literate,693609,545624,1239233
6891,7,State - NCT OF DELHI,Total,35-39,Literate,625432,464844,1090276
6892,7,State - NCT OF DELHI,Total,40-44,Literate,519402,360292,879694
6893,7,State - NCT OF DELHI,Total,45-49,Literate,432365,289014,721379
6894,7,State - NCT OF DELHI,Total,50-54,Literate,329655,215857,545512
6895,7,State - NCT OF DELHI,Total,55-59,Literate,238632,159231,397863
6896,7,State - NCT OF DELHI,Total,60-64,Literate,197517,132116,329633
6897,7,State - NCT OF DELHI,Total,65-69,Literate,116968,76023,192991
6898,7,State - NCT OF DELHI,Total,70-74,Literate,78150,50454,128604
6899,7,State - NCT OF DELHI,Total,75-79,Literate,42694,27860,70554
6900,7,State - NCT OF DELHI,Total,80+,Literate,42278,28218,70496
6901,7,State - NCT OF DELHI,Total,Age not stated,Literate,6988,5079,12067
6902,7,State - NCT OF DELHI,Rural,All ages,Literate,174327,122273,296600
6903,7,State - NCT OF DELHI,Rural,0-6,Literate,0,0,0
6904,7,State - NCT OF DELHI,Rural,7,Literate,3812,3059,6871
6905,7,State - NCT OF DELHI,Rural,8,Literate,4323,3492,7815
6906,7,State - NCT OF DELHI,Rural,9,Literate,4228,3220,7448
6907,7,State - NCT OF DELHI,Rural,10,Literate,5440,4293,9733
6908,7,State - NCT OF DELHI,Rural,11,Literate,4584,3590,8174
6909,7,State - NCT OF DELHI,Rural,12,Literate,5061,3974,9035
6910,7,State - NCT OF DELHI,Rural,13,Literate,4708,3641,8349
6911,7,State - NCT OF DELHI,Rural,14,Literate,4650,3804,8454
6912,7,State - NCT OF DELHI,Rural,15,Literate,4770,3813,8583
6913,7,State - NCT OF DELHI,Rural,16,Literate,4762,3771,8533
6914,7,State - NCT OF DELHI,Rural,17,Literate,4475,3293,7768
6915,7,State - NCT OF DELHI,Rural,18,Literate,5393,3942,9335
6916,7,State - NCT OF DELHI,Rural,19,Literate,4189,3193,7382
6917,7,State - NCT OF DELHI,Rural,20-24,Literate,22278,18014,40292
6918,7,State - NCT OF DELHI,Rural,25-29,Literate,18980,15318,34298
6919,7,State - NCT OF DELHI,Rural,30-34,Literate,15827,12343,28170
6920,7,State - NCT OF DELHI,Rural,35-39,Literate,14804,9956,24760
6921,7,State - NCT OF DELHI,Rural,40-44,Literate,11984,6785,18769
6922,7,State - NCT OF DELHI,Rural,45-49,Literate,9159,4476,13635
6923,7,State - NCT OF DELHI,Rural,50-54,Literate,6605,2972,9577
6924,7,State - NCT OF DELHI,Rural,55-59,Literate,4505,1985,6490
6925,7,State - NCT OF DELHI,Rural,60-64,Literate,4425,1767,6192
6926,7,State - NCT OF DELHI,Rural,65-69,Literate,2375,688,3063
6927,7,State - NCT OF DELHI,Rural,70-74,Literate,1521,368,1889
6928,7,State - NCT OF DELHI,Rural,75-79,Literate,604,131,735
6929,7,State - NCT OF DELHI,Rural,80+,Literate,675,233,908
6930,7,State - NCT OF DELHI,Rural,Age not stated,Literate,190,152,342
6931,7,State - NCT OF DELHI,Urban,All ages,Literate,7020529,5420638,12441167
6932,7,State - NCT OF DELHI,Urban,0-6,Literate,0,0,0
6933,7,State - NCT OF DELHI,Urban,7,Literate,127525,110764,238289
6934,7,State - NCT OF DELHI,Urban,8,Literate,148586,125765,274351
6935,7,State - NCT OF DELHI,Urban,9,Literate,143939,120083,264022
6936,7,State - NCT OF DELHI,Urban,10,Literate,181308,147807,329115
6937,7,State - NCT OF DELHI,Urban,11,Literate,159251,132904,292155
6938,7,State - NCT OF DELHI,Urban,12,Literate,171182,142250,313432
6939,7,State - NCT OF DELHI,Urban,13,Literate,156567,134607,291174
6940,7,State - NCT OF DELHI,Urban,14,Literate,164575,139654,304229
6941,7,State - NCT OF DELHI,Urban,15,Literate,169748,140107,309855
6942,7,State - NCT OF DELHI,Urban,16,Literate,165821,137044,302865
6943,7,State - NCT OF DELHI,Urban,17,Literate,159150,127902,287052
6944,7,State - NCT OF DELHI,Urban,18,Literate,197842,150354,348196
6945,7,State - NCT OF DELHI,Urban,19,Literate,160283,125837,286120
6946,7,State - NCT OF DELHI,Urban,20-24,Literate,868789,712154,1580943
6947,7,State - NCT OF DELHI,Urban,25-29,Literate,794947,660650,1455597
6948,7,State - NCT OF DELHI,Urban,30-34,Literate,677782,533281,1211063
6949,7,State - NCT OF DELHI,Urban,35-39,Literate,610628,454888,1065516
6950,7,State - NCT OF DELHI,Urban,40-44,Literate,507418,353507,860925
6951,7,State - NCT OF DELHI,Urban,45-49,Literate,423206,284538,707744
6952,7,State - NCT OF DELHI,Urban,50-54,Literate,323050,212885,535935
6953,7,State - NCT OF DELHI,Urban,55-59,Literate,234127,157246,391373
6954,7,State - NCT OF DELHI,Urban,60-64,Literate,193092,130349,323441
6955,7,State - NCT OF DELHI,Urban,65-69,Literate,114593,75335,189928
6956,7,State - NCT OF DELHI,Urban,70-74,Literate,76629,50086,126715
6957,7,State - NCT OF DELHI,Urban,75-79,Literate,42090,27729,69819
6958,7,State - NCT OF DELHI,Urban,80+,Literate,41603,27985,69588
6959,7,State - NCT OF DELHI,Urban,Age not stated,Literate,6798,4927,11725
6960,8,State - RAJASTHAN,Total,All ages,Literate,23688412,14586870,38275282
6961,8,State - RAJASTHAN,Total,0-6,Literate,0,0,0
6962,8,State - RAJASTHAN,Total,7,Literate,580567,482388,1062955
6963,8,State - RAJASTHAN,Total,8,Literate,801083,665495,1466578
6964,8,State - RAJASTHAN,Total,9,Literate,675569,563529,1239098
6965,8,State - RAJASTHAN,Total,10,Literate,947003,776460,1723463
6966,8,State - RAJASTHAN,Total,11,Literate,758815,623656,1382471
6967,8,State - RAJASTHAN,Total,12,Literate,891168,719058,1610226
6968,8,State - RAJASTHAN,Total,13,Literate,750099,624934,1375033
6969,8,State - RAJASTHAN,Total,14,Literate,775216,626186,1401402
6970,8,State - RAJASTHAN,Total,15,Literate,804252,618015,1422267
6971,8,State - RAJASTHAN,Total,16,Literate,772010,590156,1362166
6972,8,State - RAJASTHAN,Total,17,Literate,623503,464301,1087804
6973,8,State - RAJASTHAN,Total,18,Literate,848820,605831,1454651
6974,8,State - RAJASTHAN,Total,19,Literate,548916,406700,955616
6975,8,State - RAJASTHAN,Total,20-24,Literate,3018153,1930068,4948221
6976,8,State - RAJASTHAN,Total,25-29,Literate,2352439,1331896,3684335
6977,8,State - RAJASTHAN,Total,30-34,Literate,1924594,984380,2908974
6978,8,State - RAJASTHAN,Total,35-39,Literate,1665122,740888,2406010
6979,8,State - RAJASTHAN,Total,40-44,Literate,1332506,536503,1869009
6980,8,State - RAJASTHAN,Total,45-49,Literate,1043291,396895,1440186
6981,8,State - RAJASTHAN,Total,50-54,Literate,811709,278559,1090268
6982,8,State - RAJASTHAN,Total,55-59,Literate,559693,195835,755528
6983,8,State - RAJASTHAN,Total,60-64,Literate,448846,146902,595748
6984,8,State - RAJASTHAN,Total,65-69,Literate,282003,94384,376387
6985,8,State - RAJASTHAN,Total,70-74,Literate,193663,58133,251796
6986,8,State - RAJASTHAN,Total,75-79,Literate,90056,29408,119464
6987,8,State - RAJASTHAN,Total,80+,Literate,93938,36219,130157
6988,8,State - RAJASTHAN,Total,Age not stated,Literate,95378,60091,155469
6989,8,State - RAJASTHAN,Rural,All ages,Literate,16904589,9567197,26471786
6990,8,State - RAJASTHAN,Rural,0-6,Literate,0,0,0
6991,8,State - RAJASTHAN,Rural,7,Literate,445014,367168,812182
6992,8,State - RAJASTHAN,Rural,8,Literate,629734,522486,1152220
6993,8,State - RAJASTHAN,Rural,9,Literate,523008,436765,959773
6994,8,State - RAJASTHAN,Rural,10,Literate,742831,609510,1352341
6995,8,State - RAJASTHAN,Rural,11,Literate,589463,481131,1070594
6996,8,State - RAJASTHAN,Rural,12,Literate,699235,559664,1258899
6997,8,State - RAJASTHAN,Rural,13,Literate,579799,476386,1056185
6998,8,State - RAJASTHAN,Rural,14,Literate,599636,475884,1075520
6999,8,State - RAJASTHAN,Rural,15,Literate,616492,463702,1080194
7000,8,State - RAJASTHAN,Rural,16,Literate,591373,439762,1031135
7001,8,State - RAJASTHAN,Rural,17,Literate,459538,330387,789925
7002,8,State - RAJASTHAN,Rural,18,Literate,637754,436315,1074069
7003,8,State - RAJASTHAN,Rural,19,Literate,393299,278009,671308
7004,8,State - RAJASTHAN,Rural,20-24,Literate,2188315,1250072,3438387
7005,8,State - RAJASTHAN,Rural,25-29,Literate,1644504,778024,2422528
7006,8,State - RAJASTHAN,Rural,30-34,Literate,1329453,542634,1872087
7007,8,State - RAJASTHAN,Rural,35-39,Literate,1129200,369051,1498251
7008,8,State - RAJASTHAN,Rural,40-44,Literate,876608,243151,1119759
7009,8,State - RAJASTHAN,Rural,45-49,Literate,656441,159508,815949
7010,8,State - RAJASTHAN,Rural,50-54,Literate,498047,102176,600223
7011,8,State - RAJASTHAN,Rural,55-59,Literate,333936,69508,403444
7012,8,State - RAJASTHAN,Rural,60-64,Literate,276556,52984,329540
7013,8,State - RAJASTHAN,Rural,65-69,Literate,172440,34894,207334
7014,8,State - RAJASTHAN,Rural,70-74,Literate,116111,20157,136268
7015,8,State - RAJASTHAN,Rural,75-79,Literate,49390,9430,58820
7016,8,State - RAJASTHAN,Rural,80+,Literate,53673,14437,68110
7017,8,State - RAJASTHAN,Rural,Age not stated,Literate,72739,44002,116741
7018,8,State - RAJASTHAN,Urban,All ages,Literate,6783823,5019673,11803496
7019,8,State - RAJASTHAN,Urban,0-6,Literate,0,0,0
7020,8,State - RAJASTHAN,Urban,7,Literate,135553,115220,250773
7021,8,State - RAJASTHAN,Urban,8,Literate,171349,143009,314358
7022,8,State - RAJASTHAN,Urban,9,Literate,152561,126764,279325
7023,8,State - RAJASTHAN,Urban,10,Literate,204172,166950,371122
7024,8,State - RAJASTHAN,Urban,11,Literate,169352,142525,311877
7025,8,State - RAJASTHAN,Urban,12,Literate,191933,159394,351327
7026,8,State - RAJASTHAN,Urban,13,Literate,170300,148548,318848
7027,8,State - RAJASTHAN,Urban,14,Literate,175580,150302,325882
7028,8,State - RAJASTHAN,Urban,15,Literate,187760,154313,342073
7029,8,State - RAJASTHAN,Urban,16,Literate,180637,150394,331031
7030,8,State - RAJASTHAN,Urban,17,Literate,163965,133914,297879
7031,8,State - RAJASTHAN,Urban,18,Literate,211066,169516,380582
7032,8,State - RAJASTHAN,Urban,19,Literate,155617,128691,284308
7033,8,State - RAJASTHAN,Urban,20-24,Literate,829838,679996,1509834
7034,8,State - RAJASTHAN,Urban,25-29,Literate,707935,553872,1261807
7035,8,State - RAJASTHAN,Urban,30-34,Literate,595141,441746,1036887
7036,8,State - RAJASTHAN,Urban,35-39,Literate,535922,371837,907759
7037,8,State - RAJASTHAN,Urban,40-44,Literate,455898,293352,749250
7038,8,State - RAJASTHAN,Urban,45-49,Literate,386850,237387,624237
7039,8,State - RAJASTHAN,Urban,50-54,Literate,313662,176383,490045
7040,8,State - RAJASTHAN,Urban,55-59,Literate,225757,126327,352084
7041,8,State - RAJASTHAN,Urban,60-64,Literate,172290,93918,266208
7042,8,State - RAJASTHAN,Urban,65-69,Literate,109563,59490,169053
7043,8,State - RAJASTHAN,Urban,70-74,Literate,77552,37976,115528
7044,8,State - RAJASTHAN,Urban,75-79,Literate,40666,19978,60644
7045,8,State - RAJASTHAN,Urban,80+,Literate,40265,21782,62047
7046,8,State - RAJASTHAN,Urban,Age not stated,Literate,22639,16089,38728
7047,9,State - UTTAR PRADESH,Total,All ages,Literate,68234964,46162591,114397555
7048,9,State - UTTAR PRADESH,Total,0-6,Literate,0,0,0
7049,9,State - UTTAR PRADESH,Total,7,Literate,1790679,1547814,3338493
7050,9,State - UTTAR PRADESH,Total,8,Literate,2387320,2057094,4444414
7051,9,State - UTTAR PRADESH,Total,9,Literate,1977159,1722342,3699501
7052,9,State - UTTAR PRADESH,Total,10,Literate,2929181,2465213,5394394
7053,9,State - UTTAR PRADESH,Total,11,Literate,2165084,1850702,4015786
7054,9,State - UTTAR PRADESH,Total,12,Literate,2663070,2262729,4925799
7055,9,State - UTTAR PRADESH,Total,13,Literate,2088632,1869840,3958472
7056,9,State - UTTAR PRADESH,Total,14,Literate,2334000,2054708,4388708
7057,9,State - UTTAR PRADESH,Total,15,Literate,2438739,2048002,4486741
7058,9,State - UTTAR PRADESH,Total,16,Literate,2288712,1976862,4265574
7059,9,State - UTTAR PRADESH,Total,17,Literate,1827457,1521785,3349242
7060,9,State - UTTAR PRADESH,Total,18,Literate,2656589,1987618,4644207
7061,9,State - UTTAR PRADESH,Total,19,Literate,1602600,1223093,2825693
7062,9,State - UTTAR PRADESH,Total,20-24,Literate,7995698,5567721,13563419
7063,9,State - UTTAR PRADESH,Total,25-29,Literate,6014851,3958415,9973266
7064,9,State - UTTAR PRADESH,Total,30-34,Literate,4906616,3055725,7962341
7065,9,State - UTTAR PRADESH,Total,35-39,Literate,4659580,2491251,7150831
7066,9,State - UTTAR PRADESH,Total,40-44,Literate,3737744,1762297,5500041
7067,9,State - UTTAR PRADESH,Total,45-49,Literate,2987337,1328988,4316325
7068,9,State - UTTAR PRADESH,Total,50-54,Literate,2327539,924556,3252095
7069,9,State - UTTAR PRADESH,Total,55-59,Literate,1706420,705577,2411997
7070,9,State - UTTAR PRADESH,Total,60-64,Literate,1630376,554558,2184934
7071,9,State - UTTAR PRADESH,Total,65-69,Literate,1033025,342708,1375733
7072,9,State - UTTAR PRADESH,Total,70-74,Literate,722677,204163,926840
7073,9,State - UTTAR PRADESH,Total,75-79,Literate,314309,101113,415422
7074,9,State - UTTAR PRADESH,Total,80+,Literate,451598,190218,641816
7075,9,State - UTTAR PRADESH,Total,Age not stated,Literate,597972,387499,985471
7076,9,State - UTTAR PRADESH,Rural,All ages,Literate,51793688,33490992,85284680
7077,9,State - UTTAR PRADESH,Rural,0-6,Literate,0,0,0
7078,9,State - UTTAR PRADESH,Rural,7,Literate,1451560,1257147,2708707
7079,9,State - UTTAR PRADESH,Rural,8,Literate,1971242,1706029,3677271
7080,9,State - UTTAR PRADESH,Rural,9,Literate,1606435,1407862,3014297
7081,9,State - UTTAR PRADESH,Rural,10,Literate,2407985,2036655,4444640
7082,9,State - UTTAR PRADESH,Rural,11,Literate,1745322,1498474,3243796
7083,9,State - UTTAR PRADESH,Rural,12,Literate,2175786,1849077,4024863
7084,9,State - UTTAR PRADESH,Rural,13,Literate,1684357,1504592,3188949
7085,9,State - UTTAR PRADESH,Rural,14,Literate,1875113,1644625,3519738
7086,9,State - UTTAR PRADESH,Rural,15,Literate,1962824,1631742,3594566
7087,9,State - UTTAR PRADESH,Rural,16,Literate,1817937,1555106,3373043
7088,9,State - UTTAR PRADESH,Rural,17,Literate,1405719,1155118,2560837
7089,9,State - UTTAR PRADESH,Rural,18,Literate,2073644,1517941,3591585
7090,9,State - UTTAR PRADESH,Rural,19,Literate,1190754,887418,2078172
7091,9,State - UTTAR PRADESH,Rural,20-24,Literate,5915922,3906519,9822441
7092,9,State - UTTAR PRADESH,Rural,25-29,Literate,4410291,2653814,7064105
7093,9,State - UTTAR PRADESH,Rural,30-34,Literate,3599556,2014320,5613876
7094,9,State - UTTAR PRADESH,Rural,35-39,Literate,3429280,1563731,4993011
7095,9,State - UTTAR PRADESH,Rural,40-44,Literate,2700322,1044642,3744964
7096,9,State - UTTAR PRADESH,Rural,45-49,Literate,2098985,738746,2837731
7097,9,State - UTTAR PRADESH,Rural,50-54,Literate,1623733,496644,2120377
7098,9,State - UTTAR PRADESH,Rural,55-59,Literate,1182525,383091,1565616
7099,9,State - UTTAR PRADESH,Rural,60-64,Literate,1195990,309491,1505481
7100,9,State - UTTAR PRADESH,Rural,65-69,Literate,760218,193441,953659
7101,9,State - UTTAR PRADESH,Rural,70-74,Literate,534660,111132,645792
7102,9,State - UTTAR PRADESH,Rural,75-79,Literate,224154,53316,277470
7103,9,State - UTTAR PRADESH,Rural,80+,Literate,327237,111802,439039
7104,9,State - UTTAR PRADESH,Rural,Age not stated,Literate,422137,258517,680654
7105,9,State - UTTAR PRADESH,Urban,All ages,Literate,16441276,12671599,29112875
7106,9,State - UTTAR PRADESH,Urban,0-6,Literate,0,0,0
7107,9,State - UTTAR PRADESH,Urban,7,Literate,339119,290667,629786
7108,9,State - UTTAR PRADESH,Urban,8,Literate,416078,351065,767143
7109,9,State - UTTAR PRADESH,Urban,9,Literate,370724,314480,685204
7110,9,State - UTTAR PRADESH,Urban,10,Literate,521196,428558,949754
7111,9,State - UTTAR PRADESH,Urban,11,Literate,419762,352228,771990
7112,9,State - UTTAR PRADESH,Urban,12,Literate,487284,413652,900936
7113,9,State - UTTAR PRADESH,Urban,13,Literate,404275,365248,769523
7114,9,State - UTTAR PRADESH,Urban,14,Literate,458887,410083,868970
7115,9,State - UTTAR PRADESH,Urban,15,Literate,475915,416260,892175
7116,9,State - UTTAR PRADESH,Urban,16,Literate,470775,421756,892531
7117,9,State - UTTAR PRADESH,Urban,17,Literate,421738,366667,788405
7118,9,State - UTTAR PRADESH,Urban,18,Literate,582945,469677,1052622
7119,9,State - UTTAR PRADESH,Urban,19,Literate,411846,335675,747521
7120,9,State - UTTAR PRADESH,Urban,20-24,Literate,2079776,1661202,3740978
7121,9,State - UTTAR PRADESH,Urban,25-29,Literate,1604560,1304601,2909161
7122,9,State - UTTAR PRADESH,Urban,30-34,Literate,1307060,1041405,2348465
7123,9,State - UTTAR PRADESH,Urban,35-39,Literate,1230300,927520,2157820
7124,9,State - UTTAR PRADESH,Urban,40-44,Literate,1037422,717655,1755077
7125,9,State - UTTAR PRADESH,Urban,45-49,Literate,888352,590242,1478594
7126,9,State - UTTAR PRADESH,Urban,50-54,Literate,703806,427912,1131718
7127,9,State - UTTAR PRADESH,Urban,55-59,Literate,523895,322486,846381
7128,9,State - UTTAR PRADESH,Urban,60-64,Literate,434386,245067,679453
7129,9,State - UTTAR PRADESH,Urban,65-69,Literate,272807,149267,422074
7130,9,State - UTTAR PRADESH,Urban,70-74,Literate,188017,93031,281048
7131,9,State - UTTAR PRADESH,Urban,75-79,Literate,90155,47797,137952
7132,9,State - UTTAR PRADESH,Urban,80+,Literate,124361,78416,202777
7133,9,State - UTTAR PRADESH,Urban,Age not stated,Literate,175835,128982,304817
7134,10,State - BIHAR,Total,All ages,Literate,31608023,20896530,52504553
7135,10,State - BIHAR,Total,0-6,Literate,0,0,0
7136,10,State - BIHAR,Total,7,Literate,919746,811397,1731143
7137,10,State - BIHAR,Total,8,Literate,1401129,1235844,2636973
7138,10,State - BIHAR,Total,9,Literate,1050782,926528,1977310
7139,10,State - BIHAR,Total,10,Literate,1679327,1431429,3110756
7140,10,State - BIHAR,Total,11,Literate,1079436,922935,2002371
7141,10,State - BIHAR,Total,12,Literate,1454013,1228192,2682205
7142,10,State - BIHAR,Total,13,Literate,994576,869729,1864305
7143,10,State - BIHAR,Total,14,Literate,1052800,884074,1936874
7144,10,State - BIHAR,Total,15,Literate,1068422,799911,1868333
7145,10,State - BIHAR,Total,16,Literate,943052,688473,1631525
7146,10,State - BIHAR,Total,17,Literate,665161,458327,1123488
7147,10,State - BIHAR,Total,18,Literate,1052912,647569,1700481
7148,10,State - BIHAR,Total,19,Literate,598481,416211,1014692
7149,10,State - BIHAR,Total,20-24,Literate,3230902,2108038,5338940
7150,10,State - BIHAR,Total,25-29,Literate,2756987,1829296,4586283
7151,10,State - BIHAR,Total,30-34,Literate,2411183,1537151,3948334
7152,10,State - BIHAR,Total,35-39,Literate,2173760,1212711,3386471
7153,10,State - BIHAR,Total,40-44,Literate,1712149,820184,2532333
7154,10,State - BIHAR,Total,45-49,Literate,1327501,601756,1929257
7155,10,State - BIHAR,Total,50-54,Literate,1022217,403657,1425874
7156,10,State - BIHAR,Total,55-59,Literate,779400,330572,1109972
7157,10,State - BIHAR,Total,60-64,Literate,812881,282758,1095639
7158,10,State - BIHAR,Total,65-69,Literate,573308,172184,745492
7159,10,State - BIHAR,Total,70-74,Literate,374031,89964,463995
7160,10,State - BIHAR,Total,75-79,Literate,154143,40423,194566
7161,10,State - BIHAR,Total,80+,Literate,180227,61992,242219
7162,10,State - BIHAR,Total,Age not stated,Literate,139497,85225,224722
7163,10,State - BIHAR,Rural,All ages,Literate,27241830,17570322,44812152
7164,10,State - BIHAR,Rural,0-6,Literate,0,0,0
7165,10,State - BIHAR,Rural,7,Literate,822454,725401,1547855
7166,10,State - BIHAR,Rural,8,Literate,1264461,1115726,2380187
7167,10,State - BIHAR,Rural,9,Literate,944365,832895,1777260
7168,10,State - BIHAR,Rural,10,Literate,1514845,1289851,2804696
7169,10,State - BIHAR,Rural,11,Literate,963734,821480,1785214
7170,10,State - BIHAR,Rural,12,Literate,1302633,1093598,2396231
7171,10,State - BIHAR,Rural,13,Literate,882087,764667,1646754
7172,10,State - BIHAR,Rural,14,Literate,926810,769099,1695909
7173,10,State - BIHAR,Rural,15,Literate,941226,690812,1632038
7174,10,State - BIHAR,Rural,16,Literate,820794,582915,1403709
7175,10,State - BIHAR,Rural,17,Literate,566694,377619,944313
7176,10,State - BIHAR,Rural,18,Literate,910151,538428,1448579
7177,10,State - BIHAR,Rural,19,Literate,507210,342671,849881
7178,10,State - BIHAR,Rural,20-24,Literate,2745521,1730764,4476285
7179,10,State - BIHAR,Rural,25-29,Literate,2346414,1497102,3843516
7180,10,State - BIHAR,Rural,30-34,Literate,2051785,1249503,3301288
7181,10,State - BIHAR,Rural,35-39,Literate,1845321,964962,2810283
7182,10,State - BIHAR,Rural,40-44,Literate,1432817,632865,2065682
7183,10,State - BIHAR,Rural,45-49,Literate,1095806,452254,1548060
7184,10,State - BIHAR,Rural,50-54,Literate,840644,296857,1137501
7185,10,State - BIHAR,Rural,55-59,Literate,634936,246014,880950
7186,10,State - BIHAR,Rural,60-64,Literate,683857,213852,897709
7187,10,State - BIHAR,Rural,65-69,Literate,486172,129494,615666
7188,10,State - BIHAR,Rural,70-74,Literate,314779,66449,381228
7189,10,State - BIHAR,Rural,75-79,Literate,127751,28863,156614
7190,10,State - BIHAR,Rural,80+,Literate,151906,47122,199028
7191,10,State - BIHAR,Rural,Age not stated,Literate,116657,69059,185716
7192,10,State - BIHAR,Urban,All ages,Literate,4366193,3326208,7692401
7193,10,State - BIHAR,Urban,0-6,Literate,0,0,0
7194,10,State - BIHAR,Urban,7,Literate,97292,85996,183288
7195,10,State - BIHAR,Urban,8,Literate,136668,120118,256786
7196,10,State - BIHAR,Urban,9,Literate,106417,93633,200050
7197,10,State - BIHAR,Urban,10,Literate,164482,141578,306060
7198,10,State - BIHAR,Urban,11,Literate,115702,101455,217157
7199,10,State - BIHAR,Urban,12,Literate,151380,134594,285974
7200,10,State - BIHAR,Urban,13,Literate,112489,105062,217551
7201,10,State - BIHAR,Urban,14,Literate,125990,114975,240965
7202,10,State - BIHAR,Urban,15,Literate,127196,109099,236295
7203,10,State - BIHAR,Urban,16,Literate,122258,105558,227816
7204,10,State - BIHAR,Urban,17,Literate,98467,80708,179175
7205,10,State - BIHAR,Urban,18,Literate,142761,109141,251902
7206,10,State - BIHAR,Urban,19,Literate,91271,73540,164811
7207,10,State - BIHAR,Urban,20-24,Literate,485381,377274,862655
7208,10,State - BIHAR,Urban,25-29,Literate,410573,332194,742767
7209,10,State - BIHAR,Urban,30-34,Literate,359398,287648,647046
7210,10,State - BIHAR,Urban,35-39,Literate,328439,247749,576188
7211,10,State - BIHAR,Urban,40-44,Literate,279332,187319,466651
7212,10,State - BIHAR,Urban,45-49,Literate,231695,149502,381197
7213,10,State - BIHAR,Urban,50-54,Literate,181573,106800,288373
7214,10,State - BIHAR,Urban,55-59,Literate,144464,84558,229022
7215,10,State - BIHAR,Urban,60-64,Literate,129024,68906,197930
7216,10,State - BIHAR,Urban,65-69,Literate,87136,42690,129826
7217,10,State - BIHAR,Urban,70-74,Literate,59252,23515,82767
7218,10,State - BIHAR,Urban,75-79,Literate,26392,11560,37952
7219,10,State - BIHAR,Urban,80+,Literate,28321,14870,43191
7220,10,State - BIHAR,Urban,Age not stated,Literate,22840,16166,39006
7221,11,State - SIKKIM,Total,All ages,Literate,251269,193683,444952
7222,11,State - SIKKIM,Total,0-6,Literate,0,0,0
7223,11,State - SIKKIM,Total,7,Literate,4647,4517,9164
7224,11,State - SIKKIM,Total,8,Literate,4926,4949,9875
7225,11,State - SIKKIM,Total,9,Literate,5532,5443,10975
7226,11,State - SIKKIM,Total,10,Literate,6378,6056,12434
7227,11,State - SIKKIM,Total,11,Literate,6337,6165,12502
7228,11,State - SIKKIM,Total,12,Literate,6610,6316,12926
7229,11,State - SIKKIM,Total,13,Literate,6488,6354,12842
7230,11,State - SIKKIM,Total,14,Literate,6552,6454,13006
7231,11,State - SIKKIM,Total,15,Literate,6423,6275,12698
7232,11,State - SIKKIM,Total,16,Literate,6385,6434,12819
7233,11,State - SIKKIM,Total,17,Literate,6494,6040,12534
7234,11,State - SIKKIM,Total,18,Literate,6954,6509,13463
7235,11,State - SIKKIM,Total,19,Literate,6183,5944,12127
7236,11,State - SIKKIM,Total,20-24,Literate,33236,29578,62814
7237,11,State - SIKKIM,Total,25-29,Literate,32351,26119,58470
7238,11,State - SIKKIM,Total,30-34,Literate,26257,19238,45495
7239,11,State - SIKKIM,Total,35-39,Literate,20861,14642,35503
7240,11,State - SIKKIM,Total,40-44,Literate,17222,9780,27002
7241,11,State - SIKKIM,Total,45-49,Literate,12684,6385,19069
7242,11,State - SIKKIM,Total,50-54,Literate,9807,4185,13992
7243,11,State - SIKKIM,Total,55-59,Literate,6711,2343,9054
7244,11,State - SIKKIM,Total,60-64,Literate,4345,1420,5765
7245,11,State - SIKKIM,Total,65-69,Literate,3099,1053,4152
7246,11,State - SIKKIM,Total,70-74,Literate,2056,489,2545
7247,11,State - SIKKIM,Total,75-79,Literate,1090,252,1342
7248,11,State - SIKKIM,Total,80+,Literate,1150,360,1510
7249,11,State - SIKKIM,Total,Age not stated,Literate,491,383,874
7250,11,State - SIKKIM,Rural,All ages,Literate,184245,137685,321930
7251,11,State - SIKKIM,Rural,0-6,Literate,0,0,0
7252,11,State - SIKKIM,Rural,7,Literate,3597,3512,7109
7253,11,State - SIKKIM,Rural,8,Literate,3771,3815,7586
7254,11,State - SIKKIM,Rural,9,Literate,4356,4241,8597
7255,11,State - SIKKIM,Rural,10,Literate,4998,4765,9763
7256,11,State - SIKKIM,Rural,11,Literate,4946,4801,9747
7257,11,State - SIKKIM,Rural,12,Literate,5207,4861,10068
7258,11,State - SIKKIM,Rural,13,Literate,5068,4939,10007
7259,11,State - SIKKIM,Rural,14,Literate,5070,5053,10123
7260,11,State - SIKKIM,Rural,15,Literate,4974,4782,9756
7261,11,State - SIKKIM,Rural,16,Literate,4891,4904,9795
7262,11,State - SIKKIM,Rural,17,Literate,4936,4582,9518
7263,11,State - SIKKIM,Rural,18,Literate,5282,4900,10182
7264,11,State - SIKKIM,Rural,19,Literate,4622,4479,9101
7265,11,State - SIKKIM,Rural,20-24,Literate,24794,21503,46297
7266,11,State - SIKKIM,Rural,25-29,Literate,23524,18059,41583
7267,11,State - SIKKIM,Rural,30-34,Literate,18852,13012,31864
7268,11,State - SIKKIM,Rural,35-39,Literate,14506,9653,24159
7269,11,State - SIKKIM,Rural,40-44,Literate,11965,6046,18011
7270,11,State - SIKKIM,Rural,45-49,Literate,8470,3754,12224
7271,11,State - SIKKIM,Rural,50-54,Literate,6658,2304,8962
7272,11,State - SIKKIM,Rural,55-59,Literate,4528,1287,5815
7273,11,State - SIKKIM,Rural,60-64,Literate,3208,843,4051
7274,11,State - SIKKIM,Rural,65-69,Literate,2347,623,2970
7275,11,State - SIKKIM,Rural,70-74,Literate,1564,289,1853
7276,11,State - SIKKIM,Rural,75-79,Literate,842,136,978
7277,11,State - SIKKIM,Rural,80+,Literate,867,222,1089
7278,11,State - SIKKIM,Rural,Age not stated,Literate,402,320,722
7279,11,State - SIKKIM,Urban,All ages,Literate,67024,55998,123022
7280,11,State - SIKKIM,Urban,0-6,Literate,0,0,0
7281,11,State - SIKKIM,Urban,7,Literate,1050,1005,2055
7282,11,State - SIKKIM,Urban,8,Literate,1155,1134,2289
7283,11,State - SIKKIM,Urban,9,Literate,1176,1202,2378
7284,11,State - SIKKIM,Urban,10,Literate,1380,1291,2671
7285,11,State - SIKKIM,Urban,11,Literate,1391,1364,2755
7286,11,State - SIKKIM,Urban,12,Literate,1403,1455,2858
7287,11,State - SIKKIM,Urban,13,Literate,1420,1415,2835
7288,11,State - SIKKIM,Urban,14,Literate,1482,1401,2883
7289,11,State - SIKKIM,Urban,15,Literate,1449,1493,2942
7290,11,State - SIKKIM,Urban,16,Literate,1494,1530,3024
7291,11,State - SIKKIM,Urban,17,Literate,1558,1458,3016
7292,11,State - SIKKIM,Urban,18,Literate,1672,1609,3281
7293,11,State - SIKKIM,Urban,19,Literate,1561,1465,3026
7294,11,State - SIKKIM,Urban,20-24,Literate,8442,8075,16517
7295,11,State - SIKKIM,Urban,25-29,Literate,8827,8060,16887
7296,11,State - SIKKIM,Urban,30-34,Literate,7405,6226,13631
7297,11,State - SIKKIM,Urban,35-39,Literate,6355,4989,11344
7298,11,State - SIKKIM,Urban,40-44,Literate,5257,3734,8991
7299,11,State - SIKKIM,Urban,45-49,Literate,4214,2631,6845
7300,11,State - SIKKIM,Urban,50-54,Literate,3149,1881,5030
7301,11,State - SIKKIM,Urban,55-59,Literate,2183,1056,3239
7302,11,State - SIKKIM,Urban,60-64,Literate,1137,577,1714
7303,11,State - SIKKIM,Urban,65-69,Literate,752,430,1182
7304,11,State - SIKKIM,Urban,70-74,Literate,492,200,692
7305,11,State - SIKKIM,Urban,75-79,Literate,248,116,364
7306,11,State - SIKKIM,Urban,80+,Literate,283,138,421
7307,11,State - SIKKIM,Urban,Age not stated,Literate,89,63,152
7308,12,State - ARUNACHAL PRADESH,Total,All ages,Literate,439868,326137,766005
7309,12,State - ARUNACHAL PRADESH,Total,0-6,Literate,0,0,0
7310,12,State - ARUNACHAL PRADESH,Total,7,Literate,9646,9091,18737
7311,12,State - ARUNACHAL PRADESH,Total,8,Literate,12494,11451,23945
7312,12,State - ARUNACHAL PRADESH,Total,9,Literate,12179,11235,23414
7313,12,State - ARUNACHAL PRADESH,Total,10,Literate,15542,14300,29842
7314,12,State - ARUNACHAL PRADESH,Total,11,Literate,14160,12922,27082
7315,12,State - ARUNACHAL PRADESH,Total,12,Literate,16402,15598,32000
7316,12,State - ARUNACHAL PRADESH,Total,13,Literate,14374,13955,28329
7317,12,State - ARUNACHAL PRADESH,Total,14,Literate,15559,14692,30251
7318,12,State - ARUNACHAL PRADESH,Total,15,Literate,15710,14648,30358
7319,12,State - ARUNACHAL PRADESH,Total,16,Literate,14407,13633,28040
7320,12,State - ARUNACHAL PRADESH,Total,17,Literate,12520,11316,23836
7321,12,State - ARUNACHAL PRADESH,Total,18,Literate,14848,13141,27989
7322,12,State - ARUNACHAL PRADESH,Total,19,Literate,10846,9923,20769
7323,12,State - ARUNACHAL PRADESH,Total,20-24,Literate,54496,46620,101116
7324,12,State - ARUNACHAL PRADESH,Total,25-29,Literate,50347,37204,87551
7325,12,State - ARUNACHAL PRADESH,Total,30-34,Literate,39974,26203,66177
7326,12,State - ARUNACHAL PRADESH,Total,35-39,Literate,34454,20885,55339
7327,12,State - ARUNACHAL PRADESH,Total,40-44,Literate,28685,12920,41605
7328,12,State - ARUNACHAL PRADESH,Total,45-49,Literate,21714,7901,29615
7329,12,State - ARUNACHAL PRADESH,Total,50-54,Literate,13912,3673,17585
7330,12,State - ARUNACHAL PRADESH,Total,55-59,Literate,7597,1574,9171
7331,12,State - ARUNACHAL PRADESH,Total,60-64,Literate,4197,1067,5264
7332,12,State - ARUNACHAL PRADESH,Total,65-69,Literate,2190,702,2892
7333,12,State - ARUNACHAL PRADESH,Total,70-74,Literate,1247,351,1598
7334,12,State - ARUNACHAL PRADESH,Total,75-79,Literate,587,157,744
7335,12,State - ARUNACHAL PRADESH,Total,80+,Literate,1185,634,1819
7336,12,State - ARUNACHAL PRADESH,Total,Age not stated,Literate,596,341,937
7337,12,State - ARUNACHAL PRADESH,Rural,All ages,Literate,309390,226512,535902
7338,12,State - ARUNACHAL PRADESH,Rural,0-6,Literate,0,0,0
7339,12,State - ARUNACHAL PRADESH,Rural,7,Literate,7220,6664,13884
7340,12,State - ARUNACHAL PRADESH,Rural,8,Literate,9643,8746,18389
7341,12,State - ARUNACHAL PRADESH,Rural,9,Literate,9387,8546,17933
7342,12,State - ARUNACHAL PRADESH,Rural,10,Literate,12015,11037,23052
7343,12,State - ARUNACHAL PRADESH,Rural,11,Literate,10816,9718,20534
7344,12,State - ARUNACHAL PRADESH,Rural,12,Literate,12657,11922,24579
7345,12,State - ARUNACHAL PRADESH,Rural,13,Literate,10829,10316,21145
7346,12,State - ARUNACHAL PRADESH,Rural,14,Literate,11752,10863,22615
7347,12,State - ARUNACHAL PRADESH,Rural,15,Literate,11716,10714,22430
7348,12,State - ARUNACHAL PRADESH,Rural,16,Literate,10556,9674,20230
7349,12,State - ARUNACHAL PRADESH,Rural,17,Literate,8924,7817,16741
7350,12,State - ARUNACHAL PRADESH,Rural,18,Literate,10812,9517,20329
7351,12,State - ARUNACHAL PRADESH,Rural,19,Literate,7757,6968,14725
7352,12,State - ARUNACHAL PRADESH,Rural,20-24,Literate,38784,32337,71121
7353,12,State - ARUNACHAL PRADESH,Rural,25-29,Literate,34432,24935,59367
7354,12,State - ARUNACHAL PRADESH,Rural,30-34,Literate,26893,16951,43844
7355,12,State - ARUNACHAL PRADESH,Rural,35-39,Literate,22761,12706,35467
7356,12,State - ARUNACHAL PRADESH,Rural,40-44,Literate,18056,7446,25502
7357,12,State - ARUNACHAL PRADESH,Rural,45-49,Literate,13458,4385,17843
7358,12,State - ARUNACHAL PRADESH,Rural,50-54,Literate,8665,2072,10737
7359,12,State - ARUNACHAL PRADESH,Rural,55-59,Literate,4798,966,5764
7360,12,State - ARUNACHAL PRADESH,Rural,60-64,Literate,3090,711,3801
7361,12,State - ARUNACHAL PRADESH,Rural,65-69,Literate,1651,471,2122
7362,12,State - ARUNACHAL PRADESH,Rural,70-74,Literate,980,249,1229
7363,12,State - ARUNACHAL PRADESH,Rural,75-79,Literate,449,95,544
7364,12,State - ARUNACHAL PRADESH,Rural,80+,Literate,840,417,1257
7365,12,State - ARUNACHAL PRADESH,Rural,Age not stated,Literate,449,269,718
7366,12,State - ARUNACHAL PRADESH,Urban,All ages,Literate,130478,99625,230103
7367,12,State - ARUNACHAL PRADESH,Urban,0-6,Literate,0,0,0
7368,12,State - ARUNACHAL PRADESH,Urban,7,Literate,2426,2427,4853
7369,12,State - ARUNACHAL PRADESH,Urban,8,Literate,2851,2705,5556
7370,12,State - ARUNACHAL PRADESH,Urban,9,Literate,2792,2689,5481
7371,12,State - ARUNACHAL PRADESH,Urban,10,Literate,3527,3263,6790
7372,12,State - ARUNACHAL PRADESH,Urban,11,Literate,3344,3204,6548
7373,12,State - ARUNACHAL PRADESH,Urban,12,Literate,3745,3676,7421
7374,12,State - ARUNACHAL PRADESH,Urban,13,Literate,3545,3639,7184
7375,12,State - ARUNACHAL PRADESH,Urban,14,Literate,3807,3829,7636
7376,12,State - ARUNACHAL PRADESH,Urban,15,Literate,3994,3934,7928
7377,12,State - ARUNACHAL PRADESH,Urban,16,Literate,3851,3959,7810
7378,12,State - ARUNACHAL PRADESH,Urban,17,Literate,3596,3499,7095
7379,12,State - ARUNACHAL PRADESH,Urban,18,Literate,4036,3624,7660
7380,12,State - ARUNACHAL PRADESH,Urban,19,Literate,3089,2955,6044
7381,12,State - ARUNACHAL PRADESH,Urban,20-24,Literate,15712,14283,29995
7382,12,State - ARUNACHAL PRADESH,Urban,25-29,Literate,15915,12269,28184
7383,12,State - ARUNACHAL PRADESH,Urban,30-34,Literate,13081,9252,22333
7384,12,State - ARUNACHAL PRADESH,Urban,35-39,Literate,11693,8179,19872
7385,12,State - ARUNACHAL PRADESH,Urban,40-44,Literate,10629,5474,16103
7386,12,State - ARUNACHAL PRADESH,Urban,45-49,Literate,8256,3516,11772
7387,12,State - ARUNACHAL PRADESH,Urban,50-54,Literate,5247,1601,6848
7388,12,State - ARUNACHAL PRADESH,Urban,55-59,Literate,2799,608,3407
7389,12,State - ARUNACHAL PRADESH,Urban,60-64,Literate,1107,356,1463
7390,12,State - ARUNACHAL PRADESH,Urban,65-69,Literate,539,231,770
7391,12,State - ARUNACHAL PRADESH,Urban,70-74,Literate,267,102,369
7392,12,State - ARUNACHAL PRADESH,Urban,75-79,Literate,138,62,200
7393,12,State - ARUNACHAL PRADESH,Urban,80+,Literate,345,217,562
7394,12,State - ARUNACHAL PRADESH,Urban,Age not stated,Literate,147,72,219
7395,13,State - NAGALAND,Total,All ages,Literate,723957,618477,1342434
7396,13,State - NAGALAND,Total,0-6,Literate,0,0,0
7397,13,State - NAGALAND,Total,7,Literate,14942,13766,28708
7398,13,State - NAGALAND,Total,8,Literate,18470,16969,35439
7399,13,State - NAGALAND,Total,9,Literate,18686,17423,36109
7400,13,State - NAGALAND,Total,10,Literate,23107,21236,44343
7401,13,State - NAGALAND,Total,11,Literate,22189,20321,42510
7402,13,State - NAGALAND,Total,12,Literate,23435,21493,44928
7403,13,State - NAGALAND,Total,13,Literate,22376,20392,42768
7404,13,State - NAGALAND,Total,14,Literate,22205,20547,42752
7405,13,State - NAGALAND,Total,15,Literate,23462,21352,44814
7406,13,State - NAGALAND,Total,16,Literate,22336,21023,43359
7407,13,State - NAGALAND,Total,17,Literate,19760,18829,38589
7408,13,State - NAGALAND,Total,18,Literate,22195,21021,43216
7409,13,State - NAGALAND,Total,19,Literate,18074,16821,34895
7410,13,State - NAGALAND,Total,20-24,Literate,91764,86181,177945
7411,13,State - NAGALAND,Total,25-29,Literate,78719,72322,151041
7412,13,State - NAGALAND,Total,30-34,Literate,66241,58594,124835
7413,13,State - NAGALAND,Total,35-39,Literate,54526,47204,101730
7414,13,State - NAGALAND,Total,40-44,Literate,46836,35164,82000
7415,13,State - NAGALAND,Total,45-49,Literate,37810,24809,62619
7416,13,State - NAGALAND,Total,50-54,Literate,26802,16372,43174
7417,13,State - NAGALAND,Total,55-59,Literate,17147,9726,26873
7418,13,State - NAGALAND,Total,60-64,Literate,12988,7020,20008
7419,13,State - NAGALAND,Total,65-69,Literate,8133,4311,12444
7420,13,State - NAGALAND,Total,70-74,Literate,4905,2357,7262
7421,13,State - NAGALAND,Total,75-79,Literate,2896,1281,4177
7422,13,State - NAGALAND,Total,80+,Literate,3325,1559,4884
7423,13,State - NAGALAND,Total,Age not stated,Literate,628,384,1012
7424,13,State - NAGALAND,Rural,All ages,Literate,484021,412642,896663
7425,13,State - NAGALAND,Rural,0-6,Literate,0,0,0
7426,13,State - NAGALAND,Rural,7,Literate,10341,9407,19748
7427,13,State - NAGALAND,Rural,8,Literate,13161,12048,25209
7428,13,State - NAGALAND,Rural,9,Literate,13230,12324,25554
7429,13,State - NAGALAND,Rural,10,Literate,16859,15200,32059
7430,13,State - NAGALAND,Rural,11,Literate,15828,14310,30138
7431,13,State - NAGALAND,Rural,12,Literate,16837,15352,32189
7432,13,State - NAGALAND,Rural,13,Literate,15705,14181,29886
7433,13,State - NAGALAND,Rural,14,Literate,15556,14208,29764
7434,13,State - NAGALAND,Rural,15,Literate,16661,14966,31627
7435,13,State - NAGALAND,Rural,16,Literate,15500,14558,30058
7436,13,State - NAGALAND,Rural,17,Literate,13483,12597,26080
7437,13,State - NAGALAND,Rural,18,Literate,15348,14519,29867
7438,13,State - NAGALAND,Rural,19,Literate,11993,11162,23155
7439,13,State - NAGALAND,Rural,20-24,Literate,60763,56512,117275
7440,13,State - NAGALAND,Rural,25-29,Literate,49656,46199,95855
7441,13,State - NAGALAND,Rural,30-34,Literate,42405,37502,79907
7442,13,State - NAGALAND,Rural,35-39,Literate,34775,30631,65406
7443,13,State - NAGALAND,Rural,40-44,Literate,30107,22977,53084
7444,13,State - NAGALAND,Rural,45-49,Literate,24187,15839,40026
7445,13,State - NAGALAND,Rural,50-54,Literate,17282,10592,27874
7446,13,State - NAGALAND,Rural,55-59,Literate,11086,6253,17339
7447,13,State - NAGALAND,Rural,60-64,Literate,8922,4708,13630
7448,13,State - NAGALAND,Rural,65-69,Literate,5733,2820,8553
7449,13,State - NAGALAND,Rural,70-74,Literate,3548,1563,5111
7450,13,State - NAGALAND,Rural,75-79,Literate,2088,867,2955
7451,13,State - NAGALAND,Rural,80+,Literate,2441,1022,3463
7452,13,State - NAGALAND,Rural,Age not stated,Literate,526,325,851
7453,13,State - NAGALAND,Urban,All ages,Literate,239936,205835,445771
7454,13,State - NAGALAND,Urban,0-6,Literate,0,0,0
7455,13,State - NAGALAND,Urban,7,Literate,4601,4359,8960
7456,13,State - NAGALAND,Urban,8,Literate,5309,4921,10230
7457,13,State - NAGALAND,Urban,9,Literate,5456,5099,10555
7458,13,State - NAGALAND,Urban,10,Literate,6248,6036,12284
7459,13,State - NAGALAND,Urban,11,Literate,6361,6011,12372
7460,13,State - NAGALAND,Urban,12,Literate,6598,6141,12739
7461,13,State - NAGALAND,Urban,13,Literate,6671,6211,12882
7462,13,State - NAGALAND,Urban,14,Literate,6649,6339,12988
7463,13,State - NAGALAND,Urban,15,Literate,6801,6386,13187
7464,13,State - NAGALAND,Urban,16,Literate,6836,6465,13301
7465,13,State - NAGALAND,Urban,17,Literate,6277,6232,12509
7466,13,State - NAGALAND,Urban,18,Literate,6847,6502,13349
7467,13,State - NAGALAND,Urban,19,Literate,6081,5659,11740
7468,13,State - NAGALAND,Urban,20-24,Literate,31001,29669,60670
7469,13,State - NAGALAND,Urban,25-29,Literate,29063,26123,55186
7470,13,State - NAGALAND,Urban,30-34,Literate,23836,21092,44928
7471,13,State - NAGALAND,Urban,35-39,Literate,19751,16573,36324
7472,13,State - NAGALAND,Urban,40-44,Literate,16729,12187,28916
7473,13,State - NAGALAND,Urban,45-49,Literate,13623,8970,22593
7474,13,State - NAGALAND,Urban,50-54,Literate,9520,5780,15300
7475,13,State - NAGALAND,Urban,55-59,Literate,6061,3473,9534
7476,13,State - NAGALAND,Urban,60-64,Literate,4066,2312,6378
7477,13,State - NAGALAND,Urban,65-69,Literate,2400,1491,3891
7478,13,State - NAGALAND,Urban,70-74,Literate,1357,794,2151
7479,13,State - NAGALAND,Urban,75-79,Literate,808,414,1222
7480,13,State - NAGALAND,Urban,80+,Literate,884,537,1421
7481,13,State - NAGALAND,Urban,Age not stated,Literate,102,59,161
7482,14,State - MANIPUR,Total,All ages,Literate,1039858,868618,1908476
7483,14,State - MANIPUR,Total,0-6,Literate,0,0,0
7484,14,State - MANIPUR,Total,7,Literate,19299,18111,37410
7485,14,State - MANIPUR,Total,8,Literate,22786,21137,43923
7486,14,State - MANIPUR,Total,9,Literate,22137,20389,42526
7487,14,State - MANIPUR,Total,10,Literate,29092,26416,55508
7488,14,State - MANIPUR,Total,11,Literate,26644,24638,51282
7489,14,State - MANIPUR,Total,12,Literate,29774,27580,57354
7490,14,State - MANIPUR,Total,13,Literate,28122,26668,54790
7491,14,State - MANIPUR,Total,14,Literate,28454,27007,55461
7492,14,State - MANIPUR,Total,15,Literate,29256,27574,56830
7493,14,State - MANIPUR,Total,16,Literate,26114,24930,51044
7494,14,State - MANIPUR,Total,17,Literate,24291,23102,47393
7495,14,State - MANIPUR,Total,18,Literate,29249,27743,56992
7496,14,State - MANIPUR,Total,19,Literate,22604,21683,44287
7497,14,State - MANIPUR,Total,20-24,Literate,124928,118469,243397
7498,14,State - MANIPUR,Total,25-29,Literate,117940,109572,227512
7499,14,State - MANIPUR,Total,30-34,Literate,96009,84815,180824
7500,14,State - MANIPUR,Total,35-39,Literate,83894,70021,153915
7501,14,State - MANIPUR,Total,40-44,Literate,71247,52860,124107
7502,14,State - MANIPUR,Total,45-49,Literate,59479,40200,99679
7503,14,State - MANIPUR,Total,50-54,Literate,46651,29237,75888
7504,14,State - MANIPUR,Total,55-59,Literate,34215,18848,53063
7505,14,State - MANIPUR,Total,60-64,Literate,25867,12033,37900
7506,14,State - MANIPUR,Total,65-69,Literate,15763,6086,21849
7507,14,State - MANIPUR,Total,70-74,Literate,10150,3257,13407
7508,14,State - MANIPUR,Total,75-79,Literate,6184,1695,7879
7509,14,State - MANIPUR,Total,80+,Literate,6425,2271,8696
7510,14,State - MANIPUR,Total,Age not stated,Literate,3284,2276,5560
7511,14,State - MANIPUR,Rural,All ages,Literate,710134,572725,1282859
7512,14,State - MANIPUR,Rural,0-6,Literate,0,0,0
7513,14,State - MANIPUR,Rural,7,Literate,13723,12654,26377
7514,14,State - MANIPUR,Rural,8,Literate,16354,15008,31362
7515,14,State - MANIPUR,Rural,9,Literate,15904,14535,30439
7516,14,State - MANIPUR,Rural,10,Literate,21035,19044,40079
7517,14,State - MANIPUR,Rural,11,Literate,19168,17516,36684
7518,14,State - MANIPUR,Rural,12,Literate,21738,19707,41445
7519,14,State - MANIPUR,Rural,13,Literate,20285,18834,39119
7520,14,State - MANIPUR,Rural,14,Literate,20517,19217,39734
7521,14,State - MANIPUR,Rural,15,Literate,21274,19807,41081
7522,14,State - MANIPUR,Rural,16,Literate,19134,18044,37178
7523,14,State - MANIPUR,Rural,17,Literate,17527,16471,33998
7524,14,State - MANIPUR,Rural,18,Literate,21694,20119,41813
7525,14,State - MANIPUR,Rural,19,Literate,16563,15427,31990
7526,14,State - MANIPUR,Rural,20-24,Literate,88934,81829,170763
7527,14,State - MANIPUR,Rural,25-29,Literate,80376,71458,151834
7528,14,State - MANIPUR,Rural,30-34,Literate,64108,53669,117777
7529,14,State - MANIPUR,Rural,35-39,Literate,55415,43088,98503
7530,14,State - MANIPUR,Rural,40-44,Literate,46786,31711,78497
7531,14,State - MANIPUR,Rural,45-49,Literate,38269,23446,61715
7532,14,State - MANIPUR,Rural,50-54,Literate,29115,16066,45181
7533,14,State - MANIPUR,Rural,55-59,Literate,21061,10000,31061
7534,14,State - MANIPUR,Rural,60-64,Literate,15849,6410,22259
7535,14,State - MANIPUR,Rural,65-69,Literate,9580,3253,12833
7536,14,State - MANIPUR,Rural,70-74,Literate,6131,1724,7855
7537,14,State - MANIPUR,Rural,75-79,Literate,3529,875,4404
7538,14,State - MANIPUR,Rural,80+,Literate,3674,1293,4967
7539,14,State - MANIPUR,Rural,Age not stated,Literate,2391,1520,3911
7540,14,State - MANIPUR,Urban,All ages,Literate,329724,295893,625617
7541,14,State - MANIPUR,Urban,0-6,Literate,0,0,0
7542,14,State - MANIPUR,Urban,7,Literate,5576,5457,11033
7543,14,State - MANIPUR,Urban,8,Literate,6432,6129,12561
7544,14,State - MANIPUR,Urban,9,Literate,6233,5854,12087
7545,14,State - MANIPUR,Urban,10,Literate,8057,7372,15429
7546,14,State - MANIPUR,Urban,11,Literate,7476,7122,14598
7547,14,State - MANIPUR,Urban,12,Literate,8036,7873,15909
7548,14,State - MANIPUR,Urban,13,Literate,7837,7834,15671
7549,14,State - MANIPUR,Urban,14,Literate,7937,7790,15727
7550,14,State - MANIPUR,Urban,15,Literate,7982,7767,15749
7551,14,State - MANIPUR,Urban,16,Literate,6980,6886,13866
7552,14,State - MANIPUR,Urban,17,Literate,6764,6631,13395
7553,14,State - MANIPUR,Urban,18,Literate,7555,7624,15179
7554,14,State - MANIPUR,Urban,19,Literate,6041,6256,12297
7555,14,State - MANIPUR,Urban,20-24,Literate,35994,36640,72634
7556,14,State - MANIPUR,Urban,25-29,Literate,37564,38114,75678
7557,14,State - MANIPUR,Urban,30-34,Literate,31901,31146,63047
7558,14,State - MANIPUR,Urban,35-39,Literate,28479,26933,55412
7559,14,State - MANIPUR,Urban,40-44,Literate,24461,21149,45610
7560,14,State - MANIPUR,Urban,45-49,Literate,21210,16754,37964
7561,14,State - MANIPUR,Urban,50-54,Literate,17536,13171,30707
7562,14,State - MANIPUR,Urban,55-59,Literate,13154,8848,22002
7563,14,State - MANIPUR,Urban,60-64,Literate,10018,5623,15641
7564,14,State - MANIPUR,Urban,65-69,Literate,6183,2833,9016
7565,14,State - MANIPUR,Urban,70-74,Literate,4019,1533,5552
7566,14,State - MANIPUR,Urban,75-79,Literate,2655,820,3475
7567,14,State - MANIPUR,Urban,80+,Literate,2751,978,3729
7568,14,State - MANIPUR,Urban,Age not stated,Literate,893,756,1649
7569,15,State - MIZORAM,Total,All ages,Literate,438529,409646,848175
7570,15,State - MIZORAM,Total,0-6,Literate,0,0,0
7571,15,State - MIZORAM,Total,7,Literate,9654,9391,19045
7572,15,State - MIZORAM,Total,8,Literate,10707,10106,20813
7573,15,State - MIZORAM,Total,9,Literate,10925,10230,21155
7574,15,State - MIZORAM,Total,10,Literate,11835,11402,23237
7575,15,State - MIZORAM,Total,11,Literate,11339,10659,21998
7576,15,State - MIZORAM,Total,12,Literate,11221,10605,21826
7577,15,State - MIZORAM,Total,13,Literate,11196,10496,21692
7578,15,State - MIZORAM,Total,14,Literate,11041,10529,21570
7579,15,State - MIZORAM,Total,15,Literate,10990,10258,21248
7580,15,State - MIZORAM,Total,16,Literate,10985,10316,21301
7581,15,State - MIZORAM,Total,17,Literate,10540,9957,20497
7582,15,State - MIZORAM,Total,18,Literate,10919,10410,21329
7583,15,State - MIZORAM,Total,19,Literate,10078,9695,19773
7584,15,State - MIZORAM,Total,20-24,Literate,52472,50771,103243
7585,15,State - MIZORAM,Total,25-29,Literate,48534,46122,94656
7586,15,State - MIZORAM,Total,30-34,Literate,41939,40202,82141
7587,15,State - MIZORAM,Total,35-39,Literate,34587,32059,66646
7588,15,State - MIZORAM,Total,40-44,Literate,27889,24822,52711
7589,15,State - MIZORAM,Total,45-49,Literate,25092,23053,48145
7590,15,State - MIZORAM,Total,50-54,Literate,20591,18703,39294
7591,15,State - MIZORAM,Total,55-59,Literate,14740,12888,27628
7592,15,State - MIZORAM,Total,60-64,Literate,11161,10158,21319
7593,15,State - MIZORAM,Total,65-69,Literate,7321,6527,13848
7594,15,State - MIZORAM,Total,70-74,Literate,5509,4511,10020
7595,15,State - MIZORAM,Total,75-79,Literate,3514,2791,6305
7596,15,State - MIZORAM,Total,80+,Literate,3417,2779,6196
7597,15,State - MIZORAM,Total,Age not stated,Literate,333,206,539
7598,15,State - MIZORAM,Rural,All ages,Literate,195400,167934,363334
7599,15,State - MIZORAM,Rural,0-6,Literate,0,0,0
7600,15,State - MIZORAM,Rural,7,Literate,4892,4674,9566
7601,15,State - MIZORAM,Rural,8,Literate,5595,5101,10696
7602,15,State - MIZORAM,Rural,9,Literate,5546,5050,10596
7603,15,State - MIZORAM,Rural,10,Literate,6058,5685,11743
7604,15,State - MIZORAM,Rural,11,Literate,5744,5104,10848
7605,15,State - MIZORAM,Rural,12,Literate,5594,5219,10813
7606,15,State - MIZORAM,Rural,13,Literate,5579,5034,10613
7607,15,State - MIZORAM,Rural,14,Literate,5361,4787,10148
7608,15,State - MIZORAM,Rural,15,Literate,5153,4453,9606
7609,15,State - MIZORAM,Rural,16,Literate,5020,4361,9381
7610,15,State - MIZORAM,Rural,17,Literate,4741,4000,8741
7611,15,State - MIZORAM,Rural,18,Literate,4742,4070,8812
7612,15,State - MIZORAM,Rural,19,Literate,4229,3847,8076
7613,15,State - MIZORAM,Rural,20-24,Literate,22668,20574,43242
7614,15,State - MIZORAM,Rural,25-29,Literate,20978,18477,39455
7615,15,State - MIZORAM,Rural,30-34,Literate,17800,15459,33259
7616,15,State - MIZORAM,Rural,35-39,Literate,14596,12022,26618
7617,15,State - MIZORAM,Rural,40-44,Literate,11205,8909,20114
7618,15,State - MIZORAM,Rural,45-49,Literate,10359,8421,18780
7619,15,State - MIZORAM,Rural,50-54,Literate,8901,7176,16077
7620,15,State - MIZORAM,Rural,55-59,Literate,6584,5085,11669
7621,15,State - MIZORAM,Rural,60-64,Literate,5078,4036,9114
7622,15,State - MIZORAM,Rural,65-69,Literate,3427,2589,6016
7623,15,State - MIZORAM,Rural,70-74,Literate,2419,1683,4102
7624,15,State - MIZORAM,Rural,75-79,Literate,1579,1014,2593
7625,15,State - MIZORAM,Rural,80+,Literate,1424,1010,2434
7626,15,State - MIZORAM,Rural,Age not stated,Literate,128,94,222
7627,15,State - MIZORAM,Urban,All ages,Literate,243129,241712,484841
7628,15,State - MIZORAM,Urban,0-6,Literate,0,0,0
7629,15,State - MIZORAM,Urban,7,Literate,4762,4717,9479
7630,15,State - MIZORAM,Urban,8,Literate,5112,5005,10117
7631,15,State - MIZORAM,Urban,9,Literate,5379,5180,10559
7632,15,State - MIZORAM,Urban,10,Literate,5777,5717,11494
7633,15,State - MIZORAM,Urban,11,Literate,5595,5555,11150
7634,15,State - MIZORAM,Urban,12,Literate,5627,5386,11013
7635,15,State - MIZORAM,Urban,13,Literate,5617,5462,11079
7636,15,State - MIZORAM,Urban,14,Literate,5680,5742,11422
7637,15,State - MIZORAM,Urban,15,Literate,5837,5805,11642
7638,15,State - MIZORAM,Urban,16,Literate,5965,5955,11920
7639,15,State - MIZORAM,Urban,17,Literate,5799,5957,11756
7640,15,State - MIZORAM,Urban,18,Literate,6177,6340,12517
7641,15,State - MIZORAM,Urban,19,Literate,5849,5848,11697
7642,15,State - MIZORAM,Urban,20-24,Literate,29804,30197,60001
7643,15,State - MIZORAM,Urban,25-29,Literate,27556,27645,55201
7644,15,State - MIZORAM,Urban,30-34,Literate,24139,24743,48882
7645,15,State - MIZORAM,Urban,35-39,Literate,19991,20037,40028
7646,15,State - MIZORAM,Urban,40-44,Literate,16684,15913,32597
7647,15,State - MIZORAM,Urban,45-49,Literate,14733,14632,29365
7648,15,State - MIZORAM,Urban,50-54,Literate,11690,11527,23217
7649,15,State - MIZORAM,Urban,55-59,Literate,8156,7803,15959
7650,15,State - MIZORAM,Urban,60-64,Literate,6083,6122,12205
7651,15,State - MIZORAM,Urban,65-69,Literate,3894,3938,7832
7652,15,State - MIZORAM,Urban,70-74,Literate,3090,2828,5918
7653,15,State - MIZORAM,Urban,75-79,Literate,1935,1777,3712
7654,15,State - MIZORAM,Urban,80+,Literate,1993,1769,3762
7655,15,State - MIZORAM,Urban,Age not stated,Literate,205,112,317
7656,16,State - TRIPURA,Total,All ages,Literate,1501369,1303414,2804783
7657,16,State - TRIPURA,Total,0-6,Literate,0,0,0
7658,16,State - TRIPURA,Total,7,Literate,27889,26587,54476
7659,16,State - TRIPURA,Total,8,Literate,32586,31056,63642
7660,16,State - TRIPURA,Total,9,Literate,32603,31576,64179
7661,16,State - TRIPURA,Total,10,Literate,36364,34167,70531
7662,16,State - TRIPURA,Total,11,Literate,34737,33030,67767
7663,16,State - TRIPURA,Total,12,Literate,36966,34774,71740
7664,16,State - TRIPURA,Total,13,Literate,34507,32862,67369
7665,16,State - TRIPURA,Total,14,Literate,34539,32673,67212
7666,16,State - TRIPURA,Total,15,Literate,35162,32927,68089
7667,16,State - TRIPURA,Total,16,Literate,35772,32818,68590
7668,16,State - TRIPURA,Total,17,Literate,34494,30045,64539
7669,16,State - TRIPURA,Total,18,Literate,37002,35866,72868
7670,16,State - TRIPURA,Total,19,Literate,32594,33836,66430
7671,16,State - TRIPURA,Total,20-24,Literate,175878,172953,348831
7672,16,State - TRIPURA,Total,25-29,Literate,165434,150418,315852
7673,16,State - TRIPURA,Total,30-34,Literate,140202,120271,260473
7674,16,State - TRIPURA,Total,35-39,Literate,132311,113604,245915
7675,16,State - TRIPURA,Total,40-44,Literate,111813,89815,201628
7676,16,State - TRIPURA,Total,45-49,Literate,93415,73359,166774
7677,16,State - TRIPURA,Total,50-54,Literate,74104,53239,127343
7678,16,State - TRIPURA,Total,55-59,Literate,52693,36047,88740
7679,16,State - TRIPURA,Total,60-64,Literate,40226,26809,67035
7680,16,State - TRIPURA,Total,65-69,Literate,27626,17876,45502
7681,16,State - TRIPURA,Total,70-74,Literate,19135,11770,30905
7682,16,State - TRIPURA,Total,75-79,Literate,10605,6536,17141
7683,16,State - TRIPURA,Total,80+,Literate,12015,7964,19979
7684,16,State - TRIPURA,Total,Age not stated,Literate,697,536,1233
7685,16,State - TRIPURA,Rural,All ages,Literate,1081503,911270,1992773
7686,16,State - TRIPURA,Rural,0-6,Literate,0,0,0
7687,16,State - TRIPURA,Rural,7,Literate,21610,20487,42097
7688,16,State - TRIPURA,Rural,8,Literate,25348,24168,49516
7689,16,State - TRIPURA,Rural,9,Literate,25403,24632,50035
7690,16,State - TRIPURA,Rural,10,Literate,28770,26994,55764
7691,16,State - TRIPURA,Rural,11,Literate,27116,25776,52892
7692,16,State - TRIPURA,Rural,12,Literate,29472,27576,57048
7693,16,State - TRIPURA,Rural,13,Literate,27404,25781,53185
7694,16,State - TRIPURA,Rural,14,Literate,27003,25426,52429
7695,16,State - TRIPURA,Rural,15,Literate,27483,25524,53007
7696,16,State - TRIPURA,Rural,16,Literate,27668,25029,52697
7697,16,State - TRIPURA,Rural,17,Literate,26465,22351,48816
7698,16,State - TRIPURA,Rural,18,Literate,28298,27310,55608
7699,16,State - TRIPURA,Rural,19,Literate,24199,25090,49289
7700,16,State - TRIPURA,Rural,20-24,Literate,131632,127444,259076
7701,16,State - TRIPURA,Rural,25-29,Literate,121019,106590,227609
7702,16,State - TRIPURA,Rural,30-34,Literate,99908,81507,181415
7703,16,State - TRIPURA,Rural,35-39,Literate,92474,74573,167047
7704,16,State - TRIPURA,Rural,40-44,Literate,75230,56954,132184
7705,16,State - TRIPURA,Rural,45-49,Literate,61436,44754,106190
7706,16,State - TRIPURA,Rural,50-54,Literate,47354,31284,78638
7707,16,State - TRIPURA,Rural,55-59,Literate,32297,20643,52940
7708,16,State - TRIPURA,Rural,60-64,Literate,25886,15841,41727
7709,16,State - TRIPURA,Rural,65-69,Literate,18648,10591,29239
7710,16,State - TRIPURA,Rural,70-74,Literate,13167,6741,19908
7711,16,State - TRIPURA,Rural,75-79,Literate,7143,3458,10601
7712,16,State - TRIPURA,Rural,80+,Literate,8634,4437,13071
7713,16,State - TRIPURA,Rural,Age not stated,Literate,436,309,745
7714,16,State - TRIPURA,Urban,All ages,Literate,419866,392144,812010
7715,16,State - TRIPURA,Urban,0-6,Literate,0,0,0
7716,16,State - TRIPURA,Urban,7,Literate,6279,6100,12379
7717,16,State - TRIPURA,Urban,8,Literate,7238,6888,14126
7718,16,State - TRIPURA,Urban,9,Literate,7200,6944,14144
7719,16,State - TRIPURA,Urban,10,Literate,7594,7173,14767
7720,16,State - TRIPURA,Urban,11,Literate,7621,7254,14875
7721,16,State - TRIPURA,Urban,12,Literate,7494,7198,14692
7722,16,State - TRIPURA,Urban,13,Literate,7103,7081,14184
7723,16,State - TRIPURA,Urban,14,Literate,7536,7247,14783
7724,16,State - TRIPURA,Urban,15,Literate,7679,7403,15082
7725,16,State - TRIPURA,Urban,16,Literate,8104,7789,15893
7726,16,State - TRIPURA,Urban,17,Literate,8029,7694,15723
7727,16,State - TRIPURA,Urban,18,Literate,8704,8556,17260
7728,16,State - TRIPURA,Urban,19,Literate,8395,8746,17141
7729,16,State - TRIPURA,Urban,20-24,Literate,44246,45509,89755
7730,16,State - TRIPURA,Urban,25-29,Literate,44415,43828,88243
7731,16,State - TRIPURA,Urban,30-34,Literate,40294,38764,79058
7732,16,State - TRIPURA,Urban,35-39,Literate,39837,39031,78868
7733,16,State - TRIPURA,Urban,40-44,Literate,36583,32861,69444
7734,16,State - TRIPURA,Urban,45-49,Literate,31979,28605,60584
7735,16,State - TRIPURA,Urban,50-54,Literate,26750,21955,48705
7736,16,State - TRIPURA,Urban,55-59,Literate,20396,15404,35800
7737,16,State - TRIPURA,Urban,60-64,Literate,14340,10968,25308
7738,16,State - TRIPURA,Urban,65-69,Literate,8978,7285,16263
7739,16,State - TRIPURA,Urban,70-74,Literate,5968,5029,10997
7740,16,State - TRIPURA,Urban,75-79,Literate,3462,3078,6540
7741,16,State - TRIPURA,Urban,80+,Literate,3381,3527,6908
7742,16,State - TRIPURA,Urban,Age not stated,Literate,261,227,488
7743,17,State - MEGHALAYA,Total,All ages,Literate,913879,871126,1785005
7744,17,State - MEGHALAYA,Total,0-6,Literate,0,0,0
7745,17,State - MEGHALAYA,Total,7,Literate,21161,21494,42655
7746,17,State - MEGHALAYA,Total,8,Literate,26629,27193,53822
7747,17,State - MEGHALAYA,Total,9,Literate,28000,27994,55994
7748,17,State - MEGHALAYA,Total,10,Literate,33731,33739,67470
7749,17,State - MEGHALAYA,Total,11,Literate,32863,32567,65430
7750,17,State - MEGHALAYA,Total,12,Literate,33906,34240,68146
7751,17,State - MEGHALAYA,Total,13,Literate,31569,32708,64277
7752,17,State - MEGHALAYA,Total,14,Literate,31628,32679,64307
7753,17,State - MEGHALAYA,Total,15,Literate,31081,31480,62561
7754,17,State - MEGHALAYA,Total,16,Literate,30449,30829,61278
7755,17,State - MEGHALAYA,Total,17,Literate,27317,27290,54607
7756,17,State - MEGHALAYA,Total,18,Literate,28776,28919,57695
7757,17,State - MEGHALAYA,Total,19,Literate,23766,24481,48247
7758,17,State - MEGHALAYA,Total,20-24,Literate,113940,119732,233672
7759,17,State - MEGHALAYA,Total,25-29,Literate,97883,96971,194854
7760,17,State - MEGHALAYA,Total,30-34,Literate,72875,68365,141240
7761,17,State - MEGHALAYA,Total,35-39,Literate,63406,57944,121350
7762,17,State - MEGHALAYA,Total,40-44,Literate,51621,43840,95461
7763,17,State - MEGHALAYA,Total,45-49,Literate,42918,33038,75956
7764,17,State - MEGHALAYA,Total,50-54,Literate,29815,22315,52130
7765,17,State - MEGHALAYA,Total,55-59,Literate,19907,14122,34029
7766,17,State - MEGHALAYA,Total,60-64,Literate,15318,10899,26217
7767,17,State - MEGHALAYA,Total,65-69,Literate,10185,7183,17368
7768,17,State - MEGHALAYA,Total,70-74,Literate,5884,4258,10142
7769,17,State - MEGHALAYA,Total,75-79,Literate,3162,2312,5474
7770,17,State - MEGHALAYA,Total,80+,Literate,3789,3069,6858
7771,17,State - MEGHALAYA,Total,Age not stated,Literate,2300,1465,3765
7772,17,State - MEGHALAYA,Rural,All ages,Literate,675636,639518,1315154
7773,17,State - MEGHALAYA,Rural,0-6,Literate,0,0,0
7774,17,State - MEGHALAYA,Rural,7,Literate,16760,17131,33891
7775,17,State - MEGHALAYA,Rural,8,Literate,21484,22033,43517
7776,17,State - MEGHALAYA,Rural,9,Literate,22620,22792,45412
7777,17,State - MEGHALAYA,Rural,10,Literate,27303,27531,54834
7778,17,State - MEGHALAYA,Rural,11,Literate,26398,26336,52734
7779,17,State - MEGHALAYA,Rural,12,Literate,27430,27745,55175
7780,17,State - MEGHALAYA,Rural,13,Literate,25121,26239,51360
7781,17,State - MEGHALAYA,Rural,14,Literate,25000,25702,50702
7782,17,State - MEGHALAYA,Rural,15,Literate,24472,24293,48765
7783,17,State - MEGHALAYA,Rural,16,Literate,23402,23382,46784
7784,17,State - MEGHALAYA,Rural,17,Literate,20747,20351,41098
7785,17,State - MEGHALAYA,Rural,18,Literate,21392,21662,43054
7786,17,State - MEGHALAYA,Rural,19,Literate,17072,18164,35236
7787,17,State - MEGHALAYA,Rural,20-24,Literate,81762,87952,169714
7788,17,State - MEGHALAYA,Rural,25-29,Literate,69959,69497,139456
7789,17,State - MEGHALAYA,Rural,30-34,Literate,50772,47458,98230
7790,17,State - MEGHALAYA,Rural,35-39,Literate,44820,39443,84263
7791,17,State - MEGHALAYA,Rural,40-44,Literate,35993,29302,65295
7792,17,State - MEGHALAYA,Rural,45-49,Literate,29843,21644,51487
7793,17,State - MEGHALAYA,Rural,50-54,Literate,20504,13965,34469
7794,17,State - MEGHALAYA,Rural,55-59,Literate,13521,8650,22171
7795,17,State - MEGHALAYA,Rural,60-64,Literate,10931,6833,17764
7796,17,State - MEGHALAYA,Rural,65-69,Literate,7568,4620,12188
7797,17,State - MEGHALAYA,Rural,70-74,Literate,4245,2522,6767
7798,17,State - MEGHALAYA,Rural,75-79,Literate,2203,1261,3464
7799,17,State - MEGHALAYA,Rural,80+,Literate,2690,1749,4439
7800,17,State - MEGHALAYA,Rural,Age not stated,Literate,1624,1261,2885
7801,17,State - MEGHALAYA,Urban,All ages,Literate,238243,231608,469851
7802,17,State - MEGHALAYA,Urban,0-6,Literate,0,0,0
7803,17,State - MEGHALAYA,Urban,7,Literate,4401,4363,8764
7804,17,State - MEGHALAYA,Urban,8,Literate,5145,5160,10305
7805,17,State - MEGHALAYA,Urban,9,Literate,5380,5202,10582
7806,17,State - MEGHALAYA,Urban,10,Literate,6428,6208,12636
7807,17,State - MEGHALAYA,Urban,11,Literate,6465,6231,12696
7808,17,State - MEGHALAYA,Urban,12,Literate,6476,6495,12971
7809,17,State - MEGHALAYA,Urban,13,Literate,6448,6469,12917
7810,17,State - MEGHALAYA,Urban,14,Literate,6628,6977,13605
7811,17,State - MEGHALAYA,Urban,15,Literate,6609,7187,13796
7812,17,State - MEGHALAYA,Urban,16,Literate,7047,7447,14494
7813,17,State - MEGHALAYA,Urban,17,Literate,6570,6939,13509
7814,17,State - MEGHALAYA,Urban,18,Literate,7384,7257,14641
7815,17,State - MEGHALAYA,Urban,19,Literate,6694,6317,13011
7816,17,State - MEGHALAYA,Urban,20-24,Literate,32178,31780,63958
7817,17,State - MEGHALAYA,Urban,25-29,Literate,27924,27474,55398
7818,17,State - MEGHALAYA,Urban,30-34,Literate,22103,20907,43010
7819,17,State - MEGHALAYA,Urban,35-39,Literate,18586,18501,37087
7820,17,State - MEGHALAYA,Urban,40-44,Literate,15628,14538,30166
7821,17,State - MEGHALAYA,Urban,45-49,Literate,13075,11394,24469
7822,17,State - MEGHALAYA,Urban,50-54,Literate,9311,8350,17661
7823,17,State - MEGHALAYA,Urban,55-59,Literate,6386,5472,11858
7824,17,State - MEGHALAYA,Urban,60-64,Literate,4387,4066,8453
7825,17,State - MEGHALAYA,Urban,65-69,Literate,2617,2563,5180
7826,17,State - MEGHALAYA,Urban,70-74,Literate,1639,1736,3375
7827,17,State - MEGHALAYA,Urban,75-79,Literate,959,1051,2010
7828,17,State - MEGHALAYA,Urban,80+,Literate,1099,1320,2419
7829,17,State - MEGHALAYA,Urban,Age not stated,Literate,676,204,880
7830,18,State - ASSAM,Total,All ages,Literate,10568639,8609338,19177977
7831,18,State - ASSAM,Total,0-6,Literate,0,0,0
7832,18,State - ASSAM,Total,7,Literate,261407,249807,511214
7833,18,State - ASSAM,Total,8,Literate,302423,287545,589968
7834,18,State - ASSAM,Total,9,Literate,280371,270214,550585
7835,18,State - ASSAM,Total,10,Literate,338524,315884,654408
7836,18,State - ASSAM,Total,11,Literate,294979,281551,576530
7837,18,State - ASSAM,Total,12,Literate,339100,319554,658654
7838,18,State - ASSAM,Total,13,Literate,301717,291102,592819
7839,18,State - ASSAM,Total,14,Literate,304354,289789,594143
7840,18,State - ASSAM,Total,15,Literate,306678,279907,586585
7841,18,State - ASSAM,Total,16,Literate,290029,253814,543843
7842,18,State - ASSAM,Total,17,Literate,247841,209664,457505
7843,18,State - ASSAM,Total,18,Literate,305398,267726,573124
7844,18,State - ASSAM,Total,19,Literate,230057,226531,456588
7845,18,State - ASSAM,Total,20-24,Literate,1185596,1123067,2308663
7846,18,State - ASSAM,Total,25-29,Literate,1110055,985523,2095578
7847,18,State - ASSAM,Total,30-34,Literate,910438,751102,1661540
7848,18,State - ASSAM,Total,35-39,Literate,858916,654703,1513619
7849,18,State - ASSAM,Total,40-44,Literate,686895,456212,1143107
7850,18,State - ASSAM,Total,45-49,Literate,585430,365364,950794
7851,18,State - ASSAM,Total,50-54,Literate,436216,243245,679461
7852,18,State - ASSAM,Total,55-59,Literate,318838,166603,485441
7853,18,State - ASSAM,Total,60-64,Literate,257008,132817,389825
7854,18,State - ASSAM,Total,65-69,Literate,169315,82021,251336
7855,18,State - ASSAM,Total,70-74,Literate,117383,48439,165822
7856,18,State - ASSAM,Total,75-79,Literate,59916,23607,83523
7857,18,State - ASSAM,Total,80+,Literate,63004,28645,91649
7858,18,State - ASSAM,Total,Age not stated,Literate,6751,4902,11653
7859,18,State - ASSAM,Rural,All ages,Literate,8706193,6979243,15685436
7860,18,State - ASSAM,Rural,0-6,Literate,0,0,0
7861,18,State - ASSAM,Rural,7,Literate,229563,219981,449544
7862,18,State - ASSAM,Rural,8,Literate,268426,255427,523853
7863,18,State - ASSAM,Rural,9,Literate,247165,238682,485847
7864,18,State - ASSAM,Rural,10,Literate,299240,279800,579040
7865,18,State - ASSAM,Rural,11,Literate,257970,246661,504631
7866,18,State - ASSAM,Rural,12,Literate,299299,282514,581813
7867,18,State - ASSAM,Rural,13,Literate,264257,255513,519770
7868,18,State - ASSAM,Rural,14,Literate,265595,253124,518719
7869,18,State - ASSAM,Rural,15,Literate,267500,243166,510666
7870,18,State - ASSAM,Rural,16,Literate,251334,217948,469282
7871,18,State - ASSAM,Rural,17,Literate,210461,175454,385915
7872,18,State - ASSAM,Rural,18,Literate,261151,227130,488281
7873,18,State - ASSAM,Rural,19,Literate,192709,189243,381952
7874,18,State - ASSAM,Rural,20-24,Literate,984831,923380,1908211
7875,18,State - ASSAM,Rural,25-29,Literate,914037,790954,1704991
7876,18,State - ASSAM,Rural,30-34,Literate,734826,584811,1319637
7877,18,State - ASSAM,Rural,35-39,Literate,684277,496088,1180365
7878,18,State - ASSAM,Rural,40-44,Literate,532221,332728,864949
7879,18,State - ASSAM,Rural,45-49,Literate,448957,261282,710239
7880,18,State - ASSAM,Rural,50-54,Literate,326814,170816,497630
7881,18,State - ASSAM,Rural,55-59,Literate,240640,115765,356405
7882,18,State - ASSAM,Rural,60-64,Literate,198214,92518,290732
7883,18,State - ASSAM,Rural,65-69,Literate,132335,56504,188839
7884,18,State - ASSAM,Rural,70-74,Literate,92735,32624,125359
7885,18,State - ASSAM,Rural,75-79,Literate,46459,14486,60945
7886,18,State - ASSAM,Rural,80+,Literate,50191,19091,69282
7887,18,State - ASSAM,Rural,Age not stated,Literate,4986,3553,8539
7888,18,State - ASSAM,Urban,All ages,Literate,1862446,1630095,3492541
7889,18,State - ASSAM,Urban,0-6,Literate,0,0,0
7890,18,State - ASSAM,Urban,7,Literate,31844,29826,61670
7891,18,State - ASSAM,Urban,8,Literate,33997,32118,66115
7892,18,State - ASSAM,Urban,9,Literate,33206,31532,64738
7893,18,State - ASSAM,Urban,10,Literate,39284,36084,75368
7894,18,State - ASSAM,Urban,11,Literate,37009,34890,71899
7895,18,State - ASSAM,Urban,12,Literate,39801,37040,76841
7896,18,State - ASSAM,Urban,13,Literate,37460,35589,73049
7897,18,State - ASSAM,Urban,14,Literate,38759,36665,75424
7898,18,State - ASSAM,Urban,15,Literate,39178,36741,75919
7899,18,State - ASSAM,Urban,16,Literate,38695,35866,74561
7900,18,State - ASSAM,Urban,17,Literate,37380,34210,71590
7901,18,State - ASSAM,Urban,18,Literate,44247,40596,84843
7902,18,State - ASSAM,Urban,19,Literate,37348,37288,74636
7903,18,State - ASSAM,Urban,20-24,Literate,200765,199687,400452
7904,18,State - ASSAM,Urban,25-29,Literate,196018,194569,390587
7905,18,State - ASSAM,Urban,30-34,Literate,175612,166291,341903
7906,18,State - ASSAM,Urban,35-39,Literate,174639,158615,333254
7907,18,State - ASSAM,Urban,40-44,Literate,154674,123484,278158
7908,18,State - ASSAM,Urban,45-49,Literate,136473,104082,240555
7909,18,State - ASSAM,Urban,50-54,Literate,109402,72429,181831
7910,18,State - ASSAM,Urban,55-59,Literate,78198,50838,129036
7911,18,State - ASSAM,Urban,60-64,Literate,58794,40299,99093
7912,18,State - ASSAM,Urban,65-69,Literate,36980,25517,62497
7913,18,State - ASSAM,Urban,70-74,Literate,24648,15815,40463
7914,18,State - ASSAM,Urban,75-79,Literate,13457,9121,22578
7915,18,State - ASSAM,Urban,80+,Literate,12813,9554,22367
7916,18,State - ASSAM,Urban,Age not stated,Literate,1765,1349,3114
7917,19,State - WEST BENGAL,Total,All ages,Literate,33818810,27719471,61538281
7918,19,State - WEST BENGAL,Total,0-6,Literate,0,0,0
7919,19,State - WEST BENGAL,Total,7,Literate,661071,633939,1295010
7920,19,State - WEST BENGAL,Total,8,Literate,779865,740621,1520486
7921,19,State - WEST BENGAL,Total,9,Literate,750865,728439,1479304
7922,19,State - WEST BENGAL,Total,10,Literate,921164,870821,1791985
7923,19,State - WEST BENGAL,Total,11,Literate,807505,773615,1581120
7924,19,State - WEST BENGAL,Total,12,Literate,912548,860503,1773051
7925,19,State - WEST BENGAL,Total,13,Literate,828683,817504,1646187
7926,19,State - WEST BENGAL,Total,14,Literate,862359,837716,1700075
7927,19,State - WEST BENGAL,Total,15,Literate,877955,818938,1696893
7928,19,State - WEST BENGAL,Total,16,Literate,854727,766866,1621593
7929,19,State - WEST BENGAL,Total,17,Literate,797552,673081,1470633
7930,19,State - WEST BENGAL,Total,18,Literate,988111,879559,1867670
7931,19,State - WEST BENGAL,Total,19,Literate,750383,730447,1480830
7932,19,State - WEST BENGAL,Total,20-24,Literate,3868832,3537677,7406509
7933,19,State - WEST BENGAL,Total,25-29,Literate,3396230,3012248,6408478
7934,19,State - WEST BENGAL,Total,30-34,Literate,2825383,2418561,5243944
7935,19,State - WEST BENGAL,Total,35-39,Literate,2762160,2264352,5026512
7936,19,State - WEST BENGAL,Total,40-44,Literate,2400613,1724394,4125007
7937,19,State - WEST BENGAL,Total,45-49,Literate,2052143,1401711,3453854
7938,19,State - WEST BENGAL,Total,50-54,Literate,1677567,1010235,2687802
7939,19,State - WEST BENGAL,Total,55-59,Literate,1295736,742629,2038365
7940,19,State - WEST BENGAL,Total,60-64,Literate,989915,545236,1535151
7941,19,State - WEST BENGAL,Total,65-69,Literate,701512,369244,1070756
7942,19,State - WEST BENGAL,Total,70-74,Literate,473487,230783,704270
7943,19,State - WEST BENGAL,Total,75-79,Literate,254386,128985,383371
7944,19,State - WEST BENGAL,Total,80+,Literate,277175,168400,445575
7945,19,State - WEST BENGAL,Total,Age not stated,Literate,50883,32967,83850
7946,19,State - WEST BENGAL,Rural,All ages,Literate,21848197,17365582,39213779
7947,19,State - WEST BENGAL,Rural,0-6,Literate,0,0,0
7948,19,State - WEST BENGAL,Rural,7,Literate,470006,453235,923241
7949,19,State - WEST BENGAL,Rural,8,Literate,568207,542558,1110765
7950,19,State - WEST BENGAL,Rural,9,Literate,542849,530411,1073260
7951,19,State - WEST BENGAL,Rural,10,Literate,665837,632448,1298285
7952,19,State - WEST BENGAL,Rural,11,Literate,577872,558779,1136651
7953,19,State - WEST BENGAL,Rural,12,Literate,664154,630446,1294600
7954,19,State - WEST BENGAL,Rural,13,Literate,603211,598523,1201734
7955,19,State - WEST BENGAL,Rural,14,Literate,625464,610142,1235606
7956,19,State - WEST BENGAL,Rural,15,Literate,631850,588823,1220673
7957,19,State - WEST BENGAL,Rural,16,Literate,613691,541949,1155640
7958,19,State - WEST BENGAL,Rural,17,Literate,563116,460924,1024040
7959,19,State - WEST BENGAL,Rural,18,Literate,700455,611871,1312326
7960,19,State - WEST BENGAL,Rural,19,Literate,516617,499594,1016211
7961,19,State - WEST BENGAL,Rural,20-24,Literate,2629706,2343817,4973523
7962,19,State - WEST BENGAL,Rural,25-29,Literate,2209518,1880423,4089941
7963,19,State - WEST BENGAL,Rural,30-34,Literate,1749072,1433131,3182203
7964,19,State - WEST BENGAL,Rural,35-39,Literate,1700466,1313684,3014150
7965,19,State - WEST BENGAL,Rural,40-44,Literate,1445395,958343,2403738
7966,19,State - WEST BENGAL,Rural,45-49,Literate,1198465,731532,1929997
7967,19,State - WEST BENGAL,Rural,50-54,Literate,956788,492576,1449364
7968,19,State - WEST BENGAL,Rural,55-59,Literate,725089,345619,1070708
7969,19,State - WEST BENGAL,Rural,60-64,Literate,549599,237091,786690
7970,19,State - WEST BENGAL,Rural,65-69,Literate,391639,157952,549591
7971,19,State - WEST BENGAL,Rural,70-74,Literate,252455,88701,341156
7972,19,State - WEST BENGAL,Rural,75-79,Literate,132600,46048,178648
7973,19,State - WEST BENGAL,Rural,80+,Literate,145021,64644,209665
7974,19,State - WEST BENGAL,Rural,Age not stated,Literate,19055,12318,31373
7975,19,State - WEST BENGAL,Urban,All ages,Literate,11970613,10353889,22324502
7976,19,State - WEST BENGAL,Urban,0-6,Literate,0,0,0
7977,19,State - WEST BENGAL,Urban,7,Literate,191065,180704,371769
7978,19,State - WEST BENGAL,Urban,8,Literate,211658,198063,409721
7979,19,State - WEST BENGAL,Urban,9,Literate,208016,198028,406044
7980,19,State - WEST BENGAL,Urban,10,Literate,255327,238373,493700
7981,19,State - WEST BENGAL,Urban,11,Literate,229633,214836,444469
7982,19,State - WEST BENGAL,Urban,12,Literate,248394,230057,478451
7983,19,State - WEST BENGAL,Urban,13,Literate,225472,218981,444453
7984,19,State - WEST BENGAL,Urban,14,Literate,236895,227574,464469
7985,19,State - WEST BENGAL,Urban,15,Literate,246105,230115,476220
7986,19,State - WEST BENGAL,Urban,16,Literate,241036,224917,465953
7987,19,State - WEST BENGAL,Urban,17,Literate,234436,212157,446593
7988,19,State - WEST BENGAL,Urban,18,Literate,287656,267688,555344
7989,19,State - WEST BENGAL,Urban,19,Literate,233766,230853,464619
7990,19,State - WEST BENGAL,Urban,20-24,Literate,1239126,1193860,2432986
7991,19,State - WEST BENGAL,Urban,25-29,Literate,1186712,1131825,2318537
7992,19,State - WEST BENGAL,Urban,30-34,Literate,1076311,985430,2061741
7993,19,State - WEST BENGAL,Urban,35-39,Literate,1061694,950668,2012362
7994,19,State - WEST BENGAL,Urban,40-44,Literate,955218,766051,1721269
7995,19,State - WEST BENGAL,Urban,45-49,Literate,853678,670179,1523857
7996,19,State - WEST BENGAL,Urban,50-54,Literate,720779,517659,1238438
7997,19,State - WEST BENGAL,Urban,55-59,Literate,570647,397010,967657
7998,19,State - WEST BENGAL,Urban,60-64,Literate,440316,308145,748461
7999,19,State - WEST BENGAL,Urban,65-69,Literate,309873,211292,521165
8000,19,State - WEST BENGAL,Urban,70-74,Literate,221032,142082,363114
8001,19,State - WEST BENGAL,Urban,75-79,Literate,121786,82937,204723
8002,19,State - WEST BENGAL,Urban,80+,Literate,132154,103756,235910
8003,19,State - WEST BENGAL,Urban,Age not stated,Literate,31828,20649,52477
8004,20,State - JHARKHAND,Total,All ages,Literate,10882519,7445550,18328069
8005,20,State - JHARKHAND,Total,0-6,Literate,0,0,0
8006,20,State - JHARKHAND,Total,7,Literate,281783,261498,543281
8007,20,State - JHARKHAND,Total,8,Literate,393510,362887,756397
8008,20,State - JHARKHAND,Total,9,Literate,307462,289085,596547
8009,20,State - JHARKHAND,Total,10,Literate,464409,417610,882019
8010,20,State - JHARKHAND,Total,11,Literate,328484,301024,629508
8011,20,State - JHARKHAND,Total,12,Literate,447035,402678,849713
8012,20,State - JHARKHAND,Total,13,Literate,338785,319549,658334
8013,20,State - JHARKHAND,Total,14,Literate,354847,320424,675271
8014,20,State - JHARKHAND,Total,15,Literate,368348,299894,668242
8015,20,State - JHARKHAND,Total,16,Literate,326129,258270,584399
8016,20,State - JHARKHAND,Total,17,Literate,252047,190472,442519
8017,20,State - JHARKHAND,Total,18,Literate,362608,254407,617015
8018,20,State - JHARKHAND,Total,19,Literate,223032,177197,400229
8019,20,State - JHARKHAND,Total,20-24,Literate,1211588,879684,2091272
8020,20,State - JHARKHAND,Total,25-29,Literate,1071002,713393,1784395
8021,20,State - JHARKHAND,Total,30-34,Literate,887115,537411,1424526
8022,20,State - JHARKHAND,Total,35-39,Literate,787539,422961,1210500
8023,20,State - JHARKHAND,Total,40-44,Literate,626073,296223,922296
8024,20,State - JHARKHAND,Total,45-49,Literate,508358,223581,731939
8025,20,State - JHARKHAND,Total,50-54,Literate,375404,157958,533362
8026,20,State - JHARKHAND,Total,55-59,Literate,301699,120013,421712
8027,20,State - JHARKHAND,Total,60-64,Literate,258994,93744,352738
8028,20,State - JHARKHAND,Total,65-69,Literate,169625,54184,223809
8029,20,State - JHARKHAND,Total,70-74,Literate,102294,29341,131635
8030,20,State - JHARKHAND,Total,75-79,Literate,43465,14021,57486
8031,20,State - JHARKHAND,Total,80+,Literate,46017,17647,63664
8032,20,State - JHARKHAND,Total,Age not stated,Literate,44867,30394,75261
8033,20,State - JHARKHAND,Rural,All ages,Literate,7682731,4960347,12643078
8034,20,State - JHARKHAND,Rural,0-6,Literate,0,0,0
8035,20,State - JHARKHAND,Rural,7,Literate,215053,201500,416553
8036,20,State - JHARKHAND,Rural,8,Literate,313306,290873,604179
8037,20,State - JHARKHAND,Rural,9,Literate,239724,227621,467345
8038,20,State - JHARKHAND,Rural,10,Literate,369868,334036,703904
8039,20,State - JHARKHAND,Rural,11,Literate,253024,232972,485996
8040,20,State - JHARKHAND,Rural,12,Literate,354742,319275,674017
8041,20,State - JHARKHAND,Rural,13,Literate,260642,244620,505262
8042,20,State - JHARKHAND,Rural,14,Literate,270925,242092,513017
8043,20,State - JHARKHAND,Rural,15,Literate,281472,221832,503304
8044,20,State - JHARKHAND,Rural,16,Literate,240477,182012,422489
8045,20,State - JHARKHAND,Rural,17,Literate,176436,125313,301749
8046,20,State - JHARKHAND,Rural,18,Literate,263897,173230,437127
8047,20,State - JHARKHAND,Rural,19,Literate,152622,115309,267931
8048,20,State - JHARKHAND,Rural,20-24,Literate,842913,561424,1404337
8049,20,State - JHARKHAND,Rural,25-29,Literate,740478,437521,1177999
8050,20,State - JHARKHAND,Rural,30-34,Literate,605321,317694,923015
8051,20,State - JHARKHAND,Rural,35-39,Literate,533226,234597,767823
8052,20,State - JHARKHAND,Rural,40-44,Literate,410637,154239,564876
8053,20,State - JHARKHAND,Rural,45-49,Literate,325260,107671,432931
8054,20,State - JHARKHAND,Rural,50-54,Literate,232045,71587,303632
8055,20,State - JHARKHAND,Rural,55-59,Literate,179618,55595,235213
8056,20,State - JHARKHAND,Rural,60-64,Literate,166437,44504,210941
8057,20,State - JHARKHAND,Rural,65-69,Literate,112344,25875,138219
8058,20,State - JHARKHAND,Rural,70-74,Literate,65850,12895,78745
8059,20,State - JHARKHAND,Rural,75-79,Literate,26786,5625,32411
8060,20,State - JHARKHAND,Rural,80+,Literate,29647,8333,37980
8061,20,State - JHARKHAND,Rural,Age not stated,Literate,19981,12102,32083
8062,20,State - JHARKHAND,Urban,All ages,Literate,3199788,2485203,5684991
8063,20,State - JHARKHAND,Urban,0-6,Literate,0,0,0
8064,20,State - JHARKHAND,Urban,7,Literate,66730,59998,126728
8065,20,State - JHARKHAND,Urban,8,Literate,80204,72014,152218
8066,20,State - JHARKHAND,Urban,9,Literate,67738,61464,129202
8067,20,State - JHARKHAND,Urban,10,Literate,94541,83574,178115
8068,20,State - JHARKHAND,Urban,11,Literate,75460,68052,143512
8069,20,State - JHARKHAND,Urban,12,Literate,92293,83403,175696
8070,20,State - JHARKHAND,Urban,13,Literate,78143,74929,153072
8071,20,State - JHARKHAND,Urban,14,Literate,83922,78332,162254
8072,20,State - JHARKHAND,Urban,15,Literate,86876,78062,164938
8073,20,State - JHARKHAND,Urban,16,Literate,85652,76258,161910
8074,20,State - JHARKHAND,Urban,17,Literate,75611,65159,140770
8075,20,State - JHARKHAND,Urban,18,Literate,98711,81177,179888
8076,20,State - JHARKHAND,Urban,19,Literate,70410,61888,132298
8077,20,State - JHARKHAND,Urban,20-24,Literate,368675,318260,686935
8078,20,State - JHARKHAND,Urban,25-29,Literate,330524,275872,606396
8079,20,State - JHARKHAND,Urban,30-34,Literate,281794,219717,501511
8080,20,State - JHARKHAND,Urban,35-39,Literate,254313,188364,442677
8081,20,State - JHARKHAND,Urban,40-44,Literate,215436,141984,357420
8082,20,State - JHARKHAND,Urban,45-49,Literate,183098,115910,299008
8083,20,State - JHARKHAND,Urban,50-54,Literate,143359,86371,229730
8084,20,State - JHARKHAND,Urban,55-59,Literate,122081,64418,186499
8085,20,State - JHARKHAND,Urban,60-64,Literate,92557,49240,141797
8086,20,State - JHARKHAND,Urban,65-69,Literate,57281,28309,85590
8087,20,State - JHARKHAND,Urban,70-74,Literate,36444,16446,52890
8088,20,State - JHARKHAND,Urban,75-79,Literate,16679,8396,25075
8089,20,State - JHARKHAND,Urban,80+,Literate,16370,9314,25684
8090,20,State - JHARKHAND,Urban,Age not stated,Literate,24886,18292,43178
8091,21,State - ODISHA,Total,All ages,Literate,15089681,11652914,26742595
8092,21,State - ODISHA,Total,0-6,Literate,0,0,0
8093,21,State - ODISHA,Total,7,Literate,299540,285440,584980
8094,21,State - ODISHA,Total,8,Literate,370520,349673,720193
8095,21,State - ODISHA,Total,9,Literate,358698,341738,700436
8096,21,State - ODISHA,Total,10,Literate,422825,393734,816559
8097,21,State - ODISHA,Total,11,Literate,402066,378317,780383
8098,21,State - ODISHA,Total,12,Literate,434748,406781,841529
8099,21,State - ODISHA,Total,13,Literate,396020,383953,779973
8100,21,State - ODISHA,Total,14,Literate,393844,379803,773647
8101,21,State - ODISHA,Total,15,Literate,401676,377371,779047
8102,21,State - ODISHA,Total,16,Literate,357163,333438,690601
8103,21,State - ODISHA,Total,17,Literate,321101,297248,618349
8104,21,State - ODISHA,Total,18,Literate,418212,361538,779750
8105,21,State - ODISHA,Total,19,Literate,313729,281713,595442
8106,21,State - ODISHA,Total,20-24,Literate,1683088,1485650,3168738
8107,21,State - ODISHA,Total,25-29,Literate,1536826,1302133,2838959
8108,21,State - ODISHA,Total,30-34,Literate,1292985,1025915,2318900
8109,21,State - ODISHA,Total,35-39,Literate,1222070,886659,2108729
8110,21,State - ODISHA,Total,40-44,Literate,1053802,670271,1724073
8111,21,State - ODISHA,Total,45-49,Literate,883731,526110,1409841
8112,21,State - ODISHA,Total,50-54,Literate,684165,385149,1069314
8113,21,State - ODISHA,Total,55-59,Literate,540157,284015,824172
8114,21,State - ODISHA,Total,60-64,Literate,481821,207286,689107
8115,21,State - ODISHA,Total,65-69,Literate,311625,119929,431554
8116,21,State - ODISHA,Total,70-74,Literate,228149,78423,306572
8117,21,State - ODISHA,Total,75-79,Literate,115594,37971,153565
8118,21,State - ODISHA,Total,80+,Literate,120951,39927,160878
8119,21,State - ODISHA,Total,Age not stated,Literate,44575,32729,77304
8120,21,State - ODISHA,Rural,All ages,Literate,12154552,9223363,21377915
8121,21,State - ODISHA,Rural,0-6,Literate,0,0,0
8122,21,State - ODISHA,Rural,7,Literate,249217,238915,488132
8123,21,State - ODISHA,Rural,8,Literate,314144,298446,612590
8124,21,State - ODISHA,Rural,9,Literate,304528,292645,597173
8125,21,State - ODISHA,Rural,10,Literate,358725,335869,694594
8126,21,State - ODISHA,Rural,11,Literate,340467,321463,661930
8127,21,State - ODISHA,Rural,12,Literate,369421,345909,715330
8128,21,State - ODISHA,Rural,13,Literate,334575,324795,659370
8129,21,State - ODISHA,Rural,14,Literate,331206,320092,651298
8130,21,State - ODISHA,Rural,15,Literate,334859,315259,650118
8131,21,State - ODISHA,Rural,16,Literate,293309,274805,568114
8132,21,State - ODISHA,Rural,17,Literate,259182,241159,500341
8133,21,State - ODISHA,Rural,18,Literate,338350,293096,631446
8134,21,State - ODISHA,Rural,19,Literate,248481,222715,471196
8135,21,State - ODISHA,Rural,20-24,Literate,1346435,1176275,2522710
8136,21,State - ODISHA,Rural,25-29,Literate,1233929,1019415,2253344
8137,21,State - ODISHA,Rural,30-34,Literate,1021950,786110,1808060
8138,21,State - ODISHA,Rural,35-39,Literate,963215,666914,1630129
8139,21,State - ODISHA,Rural,40-44,Literate,821083,494185,1315268
8140,21,State - ODISHA,Rural,45-49,Literate,681167,382562,1063729
8141,21,State - ODISHA,Rural,50-54,Literate,525481,282610,808091
8142,21,State - ODISHA,Rural,55-59,Literate,419288,211888,631176
8143,21,State - ODISHA,Rural,60-64,Literate,393738,154994,548732
8144,21,State - ODISHA,Rural,65-69,Literate,256720,88800,345520
8145,21,State - ODISHA,Rural,70-74,Literate,188165,56851,245016
8146,21,State - ODISHA,Rural,75-79,Literate,94731,26381,121112
8147,21,State - ODISHA,Rural,80+,Literate,98439,26733,125172
8148,21,State - ODISHA,Rural,Age not stated,Literate,33747,24477,58224
8149,21,State - ODISHA,Urban,All ages,Literate,2935129,2429551,5364680
8150,21,State - ODISHA,Urban,0-6,Literate,0,0,0
8151,21,State - ODISHA,Urban,7,Literate,50323,46525,96848
8152,21,State - ODISHA,Urban,8,Literate,56376,51227,107603
8153,21,State - ODISHA,Urban,9,Literate,54170,49093,103263
8154,21,State - ODISHA,Urban,10,Literate,64100,57865,121965
8155,21,State - ODISHA,Urban,11,Literate,61599,56854,118453
8156,21,State - ODISHA,Urban,12,Literate,65327,60872,126199
8157,21,State - ODISHA,Urban,13,Literate,61445,59158,120603
8158,21,State - ODISHA,Urban,14,Literate,62638,59711,122349
8159,21,State - ODISHA,Urban,15,Literate,66817,62112,128929
8160,21,State - ODISHA,Urban,16,Literate,63854,58633,122487
8161,21,State - ODISHA,Urban,17,Literate,61919,56089,118008
8162,21,State - ODISHA,Urban,18,Literate,79862,68442,148304
8163,21,State - ODISHA,Urban,19,Literate,65248,58998,124246
8164,21,State - ODISHA,Urban,20-24,Literate,336653,309375,646028
8165,21,State - ODISHA,Urban,25-29,Literate,302897,282718,585615
8166,21,State - ODISHA,Urban,30-34,Literate,271035,239805,510840
8167,21,State - ODISHA,Urban,35-39,Literate,258855,219745,478600
8168,21,State - ODISHA,Urban,40-44,Literate,232719,176086,408805
8169,21,State - ODISHA,Urban,45-49,Literate,202564,143548,346112
8170,21,State - ODISHA,Urban,50-54,Literate,158684,102539,261223
8171,21,State - ODISHA,Urban,55-59,Literate,120869,72127,192996
8172,21,State - ODISHA,Urban,60-64,Literate,88083,52292,140375
8173,21,State - ODISHA,Urban,65-69,Literate,54905,31129,86034
8174,21,State - ODISHA,Urban,70-74,Literate,39984,21572,61556
8175,21,State - ODISHA,Urban,75-79,Literate,20863,11590,32453
8176,21,State - ODISHA,Urban,80+,Literate,22512,13194,35706
8177,21,State - ODISHA,Urban,Age not stated,Literate,10828,8252,19080
8178,22,State - CHHATTISGARH,Total,All ages,Literate,8807893,6572029,15379922
8179,22,State - CHHATTISGARH,Total,0-6,Literate,0,0,0
8180,22,State - CHHATTISGARH,Total,7,Literate,188410,180678,369088
8181,22,State - CHHATTISGARH,Total,8,Literate,253722,240289,494011
8182,22,State - CHHATTISGARH,Total,9,Literate,244732,236301,481033
8183,22,State - CHHATTISGARH,Total,10,Literate,302057,285401,587458
8184,22,State - CHHATTISGARH,Total,11,Literate,276461,263712,540173
8185,22,State - CHHATTISGARH,Total,12,Literate,282413,269087,551500
8186,22,State - CHHATTISGARH,Total,13,Literate,254904,248542,503446
8187,22,State - CHHATTISGARH,Total,14,Literate,260388,249739,510127
8188,22,State - CHHATTISGARH,Total,15,Literate,260123,240737,500860
8189,22,State - CHHATTISGARH,Total,16,Literate,255089,238621,493710
8190,22,State - CHHATTISGARH,Total,17,Literate,226555,207214,433769
8191,22,State - CHHATTISGARH,Total,18,Literate,277491,240605,518096
8192,22,State - CHHATTISGARH,Total,19,Literate,208123,191408,399531
8193,22,State - CHHATTISGARH,Total,20-24,Literate,1084497,932905,2017402
8194,22,State - CHHATTISGARH,Total,25-29,Literate,907566,692286,1599852
8195,22,State - CHHATTISGARH,Total,30-34,Literate,741890,529292,1271182
8196,22,State - CHHATTISGARH,Total,35-39,Literate,688932,412826,1101758
8197,22,State - CHHATTISGARH,Total,40-44,Literate,564879,291245,856124
8198,22,State - CHHATTISGARH,Total,45-49,Literate,452395,204757,657152
8199,22,State - CHHATTISGARH,Total,50-54,Literate,322823,138812,461635
8200,22,State - CHHATTISGARH,Total,55-59,Literate,249834,98793,348627
8201,22,State - CHHATTISGARH,Total,60-64,Literate,201410,74804,276214
8202,22,State - CHHATTISGARH,Total,65-69,Literate,133446,45101,178547
8203,22,State - CHHATTISGARH,Total,70-74,Literate,84284,24854,109138
8204,22,State - CHHATTISGARH,Total,75-79,Literate,37671,11595,49266
8205,22,State - CHHATTISGARH,Total,80+,Literate,39060,16228,55288
8206,22,State - CHHATTISGARH,Total,Age not stated,Literate,8738,6197,14935
8207,22,State - CHHATTISGARH,Rural,All ages,Literate,6403012,4605944,11008956
8208,22,State - CHHATTISGARH,Rural,0-6,Literate,0,0,0
8209,22,State - CHHATTISGARH,Rural,7,Literate,142742,137474,280216
8210,22,State - CHHATTISGARH,Rural,8,Literate,199768,190694,390462
8211,22,State - CHHATTISGARH,Rural,9,Literate,193863,188958,382821
8212,22,State - CHHATTISGARH,Rural,10,Literate,239535,228207,467742
8213,22,State - CHHATTISGARH,Rural,11,Literate,218534,209849,428383
8214,22,State - CHHATTISGARH,Rural,12,Literate,222321,213156,435477
8215,22,State - CHHATTISGARH,Rural,13,Literate,198461,194397,392858
8216,22,State - CHHATTISGARH,Rural,14,Literate,202347,193832,396179
8217,22,State - CHHATTISGARH,Rural,15,Literate,200334,185296,385630
8218,22,State - CHHATTISGARH,Rural,16,Literate,195703,182936,378639
8219,22,State - CHHATTISGARH,Rural,17,Literate,170376,155263,325639
8220,22,State - CHHATTISGARH,Rural,18,Literate,209567,180265,389832
8221,22,State - CHHATTISGARH,Rural,19,Literate,153393,139617,293010
8222,22,State - CHHATTISGARH,Rural,20-24,Literate,790400,655403,1445803
8223,22,State - CHHATTISGARH,Rural,25-29,Literate,646257,461270,1107527
8224,22,State - CHHATTISGARH,Rural,30-34,Literate,518905,344791,863696
8225,22,State - CHHATTISGARH,Rural,35-39,Literate,484578,254264,738842
8226,22,State - CHHATTISGARH,Rural,40-44,Literate,385480,166657,552137
8227,22,State - CHHATTISGARH,Rural,45-49,Literate,302962,108338,411300
8228,22,State - CHHATTISGARH,Rural,50-54,Literate,210145,72307,282452
8229,22,State - CHHATTISGARH,Rural,55-59,Literate,166529,52765,219294
8230,22,State - CHHATTISGARH,Rural,60-64,Literate,140803,39212,180015
8231,22,State - CHHATTISGARH,Rural,65-69,Literate,94953,22629,117582
8232,22,State - CHHATTISGARH,Rural,70-74,Literate,58125,11537,69662
8233,22,State - CHHATTISGARH,Rural,75-79,Literate,24790,4948,29738
8234,22,State - CHHATTISGARH,Rural,80+,Literate,27256,8583,35839
8235,22,State - CHHATTISGARH,Rural,Age not stated,Literate,4885,3296,8181
8236,22,State - CHHATTISGARH,Urban,All ages,Literate,2404881,1966085,4370966
8237,22,State - CHHATTISGARH,Urban,0-6,Literate,0,0,0
8238,22,State - CHHATTISGARH,Urban,7,Literate,45668,43204,88872
8239,22,State - CHHATTISGARH,Urban,8,Literate,53954,49595,103549
8240,22,State - CHHATTISGARH,Urban,9,Literate,50869,47343,98212
8241,22,State - CHHATTISGARH,Urban,10,Literate,62522,57194,119716
8242,22,State - CHHATTISGARH,Urban,11,Literate,57927,53863,111790
8243,22,State - CHHATTISGARH,Urban,12,Literate,60092,55931,116023
8244,22,State - CHHATTISGARH,Urban,13,Literate,56443,54145,110588
8245,22,State - CHHATTISGARH,Urban,14,Literate,58041,55907,113948
8246,22,State - CHHATTISGARH,Urban,15,Literate,59789,55441,115230
8247,22,State - CHHATTISGARH,Urban,16,Literate,59386,55685,115071
8248,22,State - CHHATTISGARH,Urban,17,Literate,56179,51951,108130
8249,22,State - CHHATTISGARH,Urban,18,Literate,67924,60340,128264
8250,22,State - CHHATTISGARH,Urban,19,Literate,54730,51791,106521
8251,22,State - CHHATTISGARH,Urban,20-24,Literate,294097,277502,571599
8252,22,State - CHHATTISGARH,Urban,25-29,Literate,261309,231016,492325
8253,22,State - CHHATTISGARH,Urban,30-34,Literate,222985,184501,407486
8254,22,State - CHHATTISGARH,Urban,35-39,Literate,204354,158562,362916
8255,22,State - CHHATTISGARH,Urban,40-44,Literate,179399,124588,303987
8256,22,State - CHHATTISGARH,Urban,45-49,Literate,149433,96419,245852
8257,22,State - CHHATTISGARH,Urban,50-54,Literate,112678,66505,179183
8258,22,State - CHHATTISGARH,Urban,55-59,Literate,83305,46028,129333
8259,22,State - CHHATTISGARH,Urban,60-64,Literate,60607,35592,96199
8260,22,State - CHHATTISGARH,Urban,65-69,Literate,38493,22472,60965
8261,22,State - CHHATTISGARH,Urban,70-74,Literate,26159,13317,39476
8262,22,State - CHHATTISGARH,Urban,75-79,Literate,12881,6647,19528
8263,22,State - CHHATTISGARH,Urban,80+,Literate,11804,7645,19449
8264,22,State - CHHATTISGARH,Urban,Age not stated,Literate,3853,2901,6754
8265,23,State - MADHYA PRADESH,Total,All ages,Literate,25174328,17676841,42851169
8266,23,State - MADHYA PRADESH,Total,0-6,Literate,0,0,0
8267,23,State - MADHYA PRADESH,Total,7,Literate,602144,557775,1159919
8268,23,State - MADHYA PRADESH,Total,8,Literate,801462,737586,1539048
8269,23,State - MADHYA PRADESH,Total,9,Literate,712215,664432,1376647
8270,23,State - MADHYA PRADESH,Total,10,Literate,930778,850686,1781464
8271,23,State - MADHYA PRADESH,Total,11,Literate,781308,726301,1507609
8272,23,State - MADHYA PRADESH,Total,12,Literate,881353,797481,1678834
8273,23,State - MADHYA PRADESH,Total,13,Literate,749138,694014,1443152
8274,23,State - MADHYA PRADESH,Total,14,Literate,768263,695804,1464067
8275,23,State - MADHYA PRADESH,Total,15,Literate,782418,666150,1448568
8276,23,State - MADHYA PRADESH,Total,16,Literate,752521,630401,1382922
8277,23,State - MADHYA PRADESH,Total,17,Literate,637166,518703,1155869
8278,23,State - MADHYA PRADESH,Total,18,Literate,842498,636027,1478525
8279,23,State - MADHYA PRADESH,Total,19,Literate,596973,468067,1065040
8280,23,State - MADHYA PRADESH,Total,20-24,Literate,3100279,2233782,5334061
8281,23,State - MADHYA PRADESH,Total,25-29,Literate,2454205,1699138,4153343
8282,23,State - MADHYA PRADESH,Total,30-34,Literate,2070737,1348398,3419135
8283,23,State - MADHYA PRADESH,Total,35-39,Literate,1848089,1071509,2919598
8284,23,State - MADHYA PRADESH,Total,40-44,Literate,1534378,801585,2335963
8285,23,State - MADHYA PRADESH,Total,45-49,Literate,1233372,596226,1829598
8286,23,State - MADHYA PRADESH,Total,50-54,Literate,936065,410621,1346686
8287,23,State - MADHYA PRADESH,Total,55-59,Literate,670318,287521,957839
8288,23,State - MADHYA PRADESH,Total,60-64,Literate,568757,227556,796313
8289,23,State - MADHYA PRADESH,Total,65-69,Literate,372259,142684,514943
8290,23,State - MADHYA PRADESH,Total,70-74,Literate,256337,86839,343176
8291,23,State - MADHYA PRADESH,Total,75-79,Literate,120264,43867,164131
8292,23,State - MADHYA PRADESH,Total,80+,Literate,141552,61780,203332
8293,23,State - MADHYA PRADESH,Total,Age not stated,Literate,29479,21908,51387
8294,23,State - MADHYA PRADESH,Rural,All ages,Literate,17054982,11227004,28281986
8295,23,State - MADHYA PRADESH,Rural,0-6,Literate,0,0,0
8296,23,State - MADHYA PRADESH,Rural,7,Literate,444563,415654,860217
8297,23,State - MADHYA PRADESH,Rural,8,Literate,612155,570456,1182611
8298,23,State - MADHYA PRADESH,Rural,9,Literate,536553,508821,1045374
8299,23,State - MADHYA PRADESH,Rural,10,Literate,705746,654705,1360451
8300,23,State - MADHYA PRADESH,Rural,11,Literate,582556,549887,1132443
8301,23,State - MADHYA PRADESH,Rural,12,Literate,664631,608376,1273007
8302,23,State - MADHYA PRADESH,Rural,13,Literate,553862,515652,1069514
8303,23,State - MADHYA PRADESH,Rural,14,Literate,565200,511934,1077134
8304,23,State - MADHYA PRADESH,Rural,15,Literate,570741,481858,1052599
8305,23,State - MADHYA PRADESH,Rural,16,Literate,545293,449999,995292
8306,23,State - MADHYA PRADESH,Rural,17,Literate,445328,352589,797917
8307,23,State - MADHYA PRADESH,Rural,18,Literate,599035,434402,1033437
8308,23,State - MADHYA PRADESH,Rural,19,Literate,405215,305097,710312
8309,23,State - MADHYA PRADESH,Rural,20-24,Literate,2107771,1381783,3489554
8310,23,State - MADHYA PRADESH,Rural,25-29,Literate,1616821,979559,2596380
8311,23,State - MADHYA PRADESH,Rural,30-34,Literate,1348186,759012,2107198
8312,23,State - MADHYA PRADESH,Rural,35-39,Literate,1200829,564665,1765494
8313,23,State - MADHYA PRADESH,Rural,40-44,Literate,964137,390399,1354536
8314,23,State - MADHYA PRADESH,Rural,45-49,Literate,741708,262975,1004683
8315,23,State - MADHYA PRADESH,Rural,50-54,Literate,548556,171935,720491
8316,23,State - MADHYA PRADESH,Rural,55-59,Literate,392284,119111,511395
8317,23,State - MADHYA PRADESH,Rural,60-64,Literate,345908,93271,439179
8318,23,State - MADHYA PRADESH,Rural,65-69,Literate,229044,58158,287202
8319,23,State - MADHYA PRADESH,Rural,70-74,Literate,156523,33800,190323
8320,23,State - MADHYA PRADESH,Rural,75-79,Literate,70018,15694,85712
8321,23,State - MADHYA PRADESH,Rural,80+,Literate,86991,26872,113863
8322,23,State - MADHYA PRADESH,Rural,Age not stated,Literate,15328,10340,25668
8323,23,State - MADHYA PRADESH,Urban,All ages,Literate,8119346,6449837,14569183
8324,23,State - MADHYA PRADESH,Urban,0-6,Literate,0,0,0
8325,23,State - MADHYA PRADESH,Urban,7,Literate,157581,142121,299702
8326,23,State - MADHYA PRADESH,Urban,8,Literate,189307,167130,356437
8327,23,State - MADHYA PRADESH,Urban,9,Literate,175662,155611,331273
8328,23,State - MADHYA PRADESH,Urban,10,Literate,225032,195981,421013
8329,23,State - MADHYA PRADESH,Urban,11,Literate,198752,176414,375166
8330,23,State - MADHYA PRADESH,Urban,12,Literate,216722,189105,405827
8331,23,State - MADHYA PRADESH,Urban,13,Literate,195276,178362,373638
8332,23,State - MADHYA PRADESH,Urban,14,Literate,203063,183870,386933
8333,23,State - MADHYA PRADESH,Urban,15,Literate,211677,184292,395969
8334,23,State - MADHYA PRADESH,Urban,16,Literate,207228,180402,387630
8335,23,State - MADHYA PRADESH,Urban,17,Literate,191838,166114,357952
8336,23,State - MADHYA PRADESH,Urban,18,Literate,243463,201625,445088
8337,23,State - MADHYA PRADESH,Urban,19,Literate,191758,162970,354728
8338,23,State - MADHYA PRADESH,Urban,20-24,Literate,992508,851999,1844507
8339,23,State - MADHYA PRADESH,Urban,25-29,Literate,837384,719579,1556963
8340,23,State - MADHYA PRADESH,Urban,30-34,Literate,722551,589386,1311937
8341,23,State - MADHYA PRADESH,Urban,35-39,Literate,647260,506844,1154104
8342,23,State - MADHYA PRADESH,Urban,40-44,Literate,570241,411186,981427
8343,23,State - MADHYA PRADESH,Urban,45-49,Literate,491664,333251,824915
8344,23,State - MADHYA PRADESH,Urban,50-54,Literate,387509,238686,626195
8345,23,State - MADHYA PRADESH,Urban,55-59,Literate,278034,168410,446444
8346,23,State - MADHYA PRADESH,Urban,60-64,Literate,222849,134285,357134
8347,23,State - MADHYA PRADESH,Urban,65-69,Literate,143215,84526,227741
8348,23,State - MADHYA PRADESH,Urban,70-74,Literate,99814,53039,152853
8349,23,State - MADHYA PRADESH,Urban,75-79,Literate,50246,28173,78419
8350,23,State - MADHYA PRADESH,Urban,80+,Literate,54561,34908,89469
8351,23,State - MADHYA PRADESH,Urban,Age not stated,Literate,14151,11568,25719
8352,24,State - GUJARAT,Total,All ages,Literate,23474873,17618485,41093358
8353,24,State - GUJARAT,Total,0-6,Literate,0,0,0
8354,24,State - GUJARAT,Total,7,Literate,516153,440599,956752
8355,24,State - GUJARAT,Total,8,Literate,571912,488580,1060492
8356,24,State - GUJARAT,Total,9,Literate,574103,483322,1057425
8357,24,State - GUJARAT,Total,10,Literate,658400,557728,1216128
8358,24,State - GUJARAT,Total,11,Literate,634403,537261,1171664
8359,24,State - GUJARAT,Total,12,Literate,632286,540360,1172646
8360,24,State - GUJARAT,Total,13,Literate,600656,516069,1116725
8361,24,State - GUJARAT,Total,14,Literate,597427,508295,1105722
8362,24,State - GUJARAT,Total,15,Literate,618322,510821,1129143
8363,24,State - GUJARAT,Total,16,Literate,578223,483422,1061645
8364,24,State - GUJARAT,Total,17,Literate,559623,458254,1017877
8365,24,State - GUJARAT,Total,18,Literate,652267,514078,1166345
8366,24,State - GUJARAT,Total,19,Literate,545878,446373,992251
8367,24,State - GUJARAT,Total,20-24,Literate,2794746,2223080,5017826
8368,24,State - GUJARAT,Total,25-29,Literate,2487345,1913884,4401229
8369,24,State - GUJARAT,Total,30-34,Literate,2153737,1615173,3768910
8370,24,State - GUJARAT,Total,35-39,Literate,1891035,1335327,3226362
8371,24,State - GUJARAT,Total,40-44,Literate,1606322,1085284,2691606
8372,24,State - GUJARAT,Total,45-49,Literate,1345343,861693,2207036
8373,24,State - GUJARAT,Total,50-54,Literate,1073862,643530,1717392
8374,24,State - GUJARAT,Total,55-59,Literate,793823,475619,1269442
8375,24,State - GUJARAT,Total,60-64,Literate,598173,349981,948154
8376,24,State - GUJARAT,Total,65-69,Literate,375120,223121,598241
8377,24,State - GUJARAT,Total,70-74,Literate,258213,153371,411584
8378,24,State - GUJARAT,Total,75-79,Literate,127055,82047,209102
8379,24,State - GUJARAT,Total,80+,Literate,131865,96168,228033
8380,24,State - GUJARAT,Total,Age not stated,Literate,98581,75045,173626
8381,24,State - GUJARAT,Rural,All ages,Literate,12467643,8953199,21420842
8382,24,State - GUJARAT,Rural,0-6,Literate,0,0,0
8383,24,State - GUJARAT,Rural,7,Literate,304717,269549,574266
8384,24,State - GUJARAT,Rural,8,Literate,351224,310181,661405
8385,24,State - GUJARAT,Rural,9,Literate,350938,306490,657428
8386,24,State - GUJARAT,Rural,10,Literate,398906,352021,750927
8387,24,State - GUJARAT,Rural,11,Literate,384010,336616,720626
8388,24,State - GUJARAT,Rural,12,Literate,384557,339778,724335
8389,24,State - GUJARAT,Rural,13,Literate,363772,319847,683619
8390,24,State - GUJARAT,Rural,14,Literate,356547,309868,666415
8391,24,State - GUJARAT,Rural,15,Literate,366820,311166,677986
8392,24,State - GUJARAT,Rural,16,Literate,337743,288286,626029
8393,24,State - GUJARAT,Rural,17,Literate,315185,266114,581299
8394,24,State - GUJARAT,Rural,18,Literate,358908,295309,654217
8395,24,State - GUJARAT,Rural,19,Literate,285556,244515,530071
8396,24,State - GUJARAT,Rural,20-24,Literate,1455631,1146534,2602165
8397,24,State - GUJARAT,Rural,25-29,Literate,1253758,895983,2149741
8398,24,State - GUJARAT,Rural,30-34,Literate,1092043,750136,1842179
8399,24,State - GUJARAT,Rural,35-39,Literate,966021,595798,1561819
8400,24,State - GUJARAT,Rural,40-44,Literate,810609,467168,1277777
8401,24,State - GUJARAT,Rural,45-49,Literate,662208,341962,1004170
8402,24,State - GUJARAT,Rural,50-54,Literate,516267,249274,765541
8403,24,State - GUJARAT,Rural,55-59,Literate,378199,181032,559231
8404,24,State - GUJARAT,Rural,60-64,Literate,296600,134444,431044
8405,24,State - GUJARAT,Rural,65-69,Literate,184839,85731,270570
8406,24,State - GUJARAT,Rural,70-74,Literate,128622,58502,187124
8407,24,State - GUJARAT,Rural,75-79,Literate,57863,28572,86435
8408,24,State - GUJARAT,Rural,80+,Literate,62214,35486,97700
8409,24,State - GUJARAT,Rural,Age not stated,Literate,43886,32837,76723
8410,24,State - GUJARAT,Urban,All ages,Literate,11007230,8665286,19672516
8411,24,State - GUJARAT,Urban,0-6,Literate,0,0,0
8412,24,State - GUJARAT,Urban,7,Literate,211436,171050,382486
8413,24,State - GUJARAT,Urban,8,Literate,220688,178399,399087
8414,24,State - GUJARAT,Urban,9,Literate,223165,176832,399997
8415,24,State - GUJARAT,Urban,10,Literate,259494,205707,465201
8416,24,State - GUJARAT,Urban,11,Literate,250393,200645,451038
8417,24,State - GUJARAT,Urban,12,Literate,247729,200582,448311
8418,24,State - GUJARAT,Urban,13,Literate,236884,196222,433106
8419,24,State - GUJARAT,Urban,14,Literate,240880,198427,439307
8420,24,State - GUJARAT,Urban,15,Literate,251502,199655,451157
8421,24,State - GUJARAT,Urban,16,Literate,240480,195136,435616
8422,24,State - GUJARAT,Urban,17,Literate,244438,192140,436578
8423,24,State - GUJARAT,Urban,18,Literate,293359,218769,512128
8424,24,State - GUJARAT,Urban,19,Literate,260322,201858,462180
8425,24,State - GUJARAT,Urban,20-24,Literate,1339115,1076546,2415661
8426,24,State - GUJARAT,Urban,25-29,Literate,1233587,1017901,2251488
8427,24,State - GUJARAT,Urban,30-34,Literate,1061694,865037,1926731
8428,24,State - GUJARAT,Urban,35-39,Literate,925014,739529,1664543
8429,24,State - GUJARAT,Urban,40-44,Literate,795713,618116,1413829
8430,24,State - GUJARAT,Urban,45-49,Literate,683135,519731,1202866
8431,24,State - GUJARAT,Urban,50-54,Literate,557595,394256,951851
8432,24,State - GUJARAT,Urban,55-59,Literate,415624,294587,710211
8433,24,State - GUJARAT,Urban,60-64,Literate,301573,215537,517110
8434,24,State - GUJARAT,Urban,65-69,Literate,190281,137390,327671
8435,24,State - GUJARAT,Urban,70-74,Literate,129591,94869,224460
8436,24,State - GUJARAT,Urban,75-79,Literate,69192,53475,122667
8437,24,State - GUJARAT,Urban,80+,Literate,69651,60682,130333
8438,24,State - GUJARAT,Urban,Age not stated,Literate,54695,42208,96903
8439,25,State - DAMAN & DIU,Total,All ages,Literate,124643,63763,188406
8440,25,State - DAMAN & DIU,Total,0-6,Literate,0,0,0
8441,25,State - DAMAN & DIU,Total,7,Literate,1628,1459,3087
8442,25,State - DAMAN & DIU,Total,8,Literate,1801,1586,3387
8443,25,State - DAMAN & DIU,Total,9,Literate,1699,1465,3164
8444,25,State - DAMAN & DIU,Total,10,Literate,1896,1655,3551
8445,25,State - DAMAN & DIU,Total,11,Literate,1892,1591,3483
8446,25,State - DAMAN & DIU,Total,12,Literate,1774,1513,3287
8447,25,State - DAMAN & DIU,Total,13,Literate,1705,1508,3213
8448,25,State - DAMAN & DIU,Total,14,Literate,1746,1462,3208
8449,25,State - DAMAN & DIU,Total,15,Literate,1957,1423,3380
8450,25,State - DAMAN & DIU,Total,16,Literate,2301,1392,3693
8451,25,State - DAMAN & DIU,Total,17,Literate,2838,1396,4234
8452,25,State - DAMAN & DIU,Total,18,Literate,5275,1687,6962
8453,25,State - DAMAN & DIU,Total,19,Literate,4590,1727,6317
8454,25,State - DAMAN & DIU,Total,20-24,Literate,26016,9430,35446
8455,25,State - DAMAN & DIU,Total,25-29,Literate,20502,9464,29966
8456,25,State - DAMAN & DIU,Total,30-34,Literate,14151,7181,21332
8457,25,State - DAMAN & DIU,Total,35-39,Literate,11175,5688,16863
8458,25,State - DAMAN & DIU,Total,40-44,Literate,7501,3824,11325
8459,25,State - DAMAN & DIU,Total,45-49,Literate,4922,2638,7560
8460,25,State - DAMAN & DIU,Total,50-54,Literate,3148,1788,4936
8461,25,State - DAMAN & DIU,Total,55-59,Literate,2189,1388,3577
8462,25,State - DAMAN & DIU,Total,60-64,Literate,1573,1039,2612
8463,25,State - DAMAN & DIU,Total,65-69,Literate,910,609,1519
8464,25,State - DAMAN & DIU,Total,70-74,Literate,604,403,1007
8465,25,State - DAMAN & DIU,Total,75-79,Literate,324,186,510
8466,25,State - DAMAN & DIU,Total,80+,Literate,307,184,491
8467,25,State - DAMAN & DIU,Total,Age not stated,Literate,219,77,296
8468,25,State - DAMAN & DIU,Rural,All ages,Literate,25529,17560,43089
8469,25,State - DAMAN & DIU,Rural,0-6,Literate,0,0,0
8470,25,State - DAMAN & DIU,Rural,7,Literate,493,472,965
8471,25,State - DAMAN & DIU,Rural,8,Literate,592,550,1142
8472,25,State - DAMAN & DIU,Rural,9,Literate,568,540,1108
8473,25,State - DAMAN & DIU,Rural,10,Literate,648,638,1286
8474,25,State - DAMAN & DIU,Rural,11,Literate,712,597,1309
8475,25,State - DAMAN & DIU,Rural,12,Literate,664,582,1246
8476,25,State - DAMAN & DIU,Rural,13,Literate,611,604,1215
8477,25,State - DAMAN & DIU,Rural,14,Literate,610,562,1172
8478,25,State - DAMAN & DIU,Rural,15,Literate,648,553,1201
8479,25,State - DAMAN & DIU,Rural,16,Literate,670,529,1199
8480,25,State - DAMAN & DIU,Rural,17,Literate,678,578,1256
8481,25,State - DAMAN & DIU,Rural,18,Literate,864,560,1424
8482,25,State - DAMAN & DIU,Rural,19,Literate,783,598,1381
8483,25,State - DAMAN & DIU,Rural,20-24,Literate,3940,2642,6582
8484,25,State - DAMAN & DIU,Rural,25-29,Literate,3206,2284,5490
8485,25,State - DAMAN & DIU,Rural,30-34,Literate,2555,1666,4221
8486,25,State - DAMAN & DIU,Rural,35-39,Literate,2283,1269,3552
8487,25,State - DAMAN & DIU,Rural,40-44,Literate,1602,825,2427
8488,25,State - DAMAN & DIU,Rural,45-49,Literate,1191,551,1742
8489,25,State - DAMAN & DIU,Rural,50-54,Literate,827,371,1198
8490,25,State - DAMAN & DIU,Rural,55-59,Literate,531,210,741
8491,25,State - DAMAN & DIU,Rural,60-64,Literate,370,160,530
8492,25,State - DAMAN & DIU,Rural,65-69,Literate,214,88,302
8493,25,State - DAMAN & DIU,Rural,70-74,Literate,128,52,180
8494,25,State - DAMAN & DIU,Rural,75-79,Literate,52,20,72
8495,25,State - DAMAN & DIU,Rural,80+,Literate,53,33,86
8496,25,State - DAMAN & DIU,Rural,Age not stated,Literate,36,26,62
8497,25,State - DAMAN & DIU,Urban,All ages,Literate,99114,46203,145317
8498,25,State - DAMAN & DIU,Urban,0-6,Literate,0,0,0
8499,25,State - DAMAN & DIU,Urban,7,Literate,1135,987,2122
8500,25,State - DAMAN & DIU,Urban,8,Literate,1209,1036,2245
8501,25,State - DAMAN & DIU,Urban,9,Literate,1131,925,2056
8502,25,State - DAMAN & DIU,Urban,10,Literate,1248,1017,2265
8503,25,State - DAMAN & DIU,Urban,11,Literate,1180,994,2174
8504,25,State - DAMAN & DIU,Urban,12,Literate,1110,931,2041
8505,25,State - DAMAN & DIU,Urban,13,Literate,1094,904,1998
8506,25,State - DAMAN & DIU,Urban,14,Literate,1136,900,2036
8507,25,State - DAMAN & DIU,Urban,15,Literate,1309,870,2179
8508,25,State - DAMAN & DIU,Urban,16,Literate,1631,863,2494
8509,25,State - DAMAN & DIU,Urban,17,Literate,2160,818,2978
8510,25,State - DAMAN & DIU,Urban,18,Literate,4411,1127,5538
8511,25,State - DAMAN & DIU,Urban,19,Literate,3807,1129,4936
8512,25,State - DAMAN & DIU,Urban,20-24,Literate,22076,6788,28864
8513,25,State - DAMAN & DIU,Urban,25-29,Literate,17296,7180,24476
8514,25,State - DAMAN & DIU,Urban,30-34,Literate,11596,5515,17111
8515,25,State - DAMAN & DIU,Urban,35-39,Literate,8892,4419,13311
8516,25,State - DAMAN & DIU,Urban,40-44,Literate,5899,2999,8898
8517,25,State - DAMAN & DIU,Urban,45-49,Literate,3731,2087,5818
8518,25,State - DAMAN & DIU,Urban,50-54,Literate,2321,1417,3738
8519,25,State - DAMAN & DIU,Urban,55-59,Literate,1658,1178,2836
8520,25,State - DAMAN & DIU,Urban,60-64,Literate,1203,879,2082
8521,25,State - DAMAN & DIU,Urban,65-69,Literate,696,521,1217
8522,25,State - DAMAN & DIU,Urban,70-74,Literate,476,351,827
8523,25,State - DAMAN & DIU,Urban,75-79,Literate,272,166,438
8524,25,State - DAMAN & DIU,Urban,80+,Literate,254,151,405
8525,25,State - DAMAN & DIU,Urban,Age not stated,Literate,183,51,234
8526,26,State - DADRA & NAGAR HAVELI,Total,All ages,Literate,142521,80709,223230
8527,26,State - DADRA & NAGAR HAVELI,Total,0-6,Literate,0,0,0
8528,26,State - DADRA & NAGAR HAVELI,Total,7,Literate,3351,2932,6283
8529,26,State - DADRA & NAGAR HAVELI,Total,8,Literate,3681,3326,7007
8530,26,State - DADRA & NAGAR HAVELI,Total,9,Literate,3513,3103,6616
8531,26,State - DADRA & NAGAR HAVELI,Total,10,Literate,3858,3539,7397
8532,26,State - DADRA & NAGAR HAVELI,Total,11,Literate,3797,3339,7136
8533,26,State - DADRA & NAGAR HAVELI,Total,12,Literate,3470,3082,6552
8534,26,State - DADRA & NAGAR HAVELI,Total,13,Literate,3489,2950,6439
8535,26,State - DADRA & NAGAR HAVELI,Total,14,Literate,3210,2641,5851
8536,26,State - DADRA & NAGAR HAVELI,Total,15,Literate,3142,2446,5588
8537,26,State - DADRA & NAGAR HAVELI,Total,16,Literate,2919,2157,5076
8538,26,State - DADRA & NAGAR HAVELI,Total,17,Literate,3199,1910,5109
8539,26,State - DADRA & NAGAR HAVELI,Total,18,Literate,4841,2197,7038
8540,26,State - DADRA & NAGAR HAVELI,Total,19,Literate,4691,2063,6754
8541,26,State - DADRA & NAGAR HAVELI,Total,20-24,Literate,25602,12004,37606
8542,26,State - DADRA & NAGAR HAVELI,Total,25-29,Literate,21015,11045,32060
8543,26,State - DADRA & NAGAR HAVELI,Total,30-34,Literate,15526,7829,23355
8544,26,State - DADRA & NAGAR HAVELI,Total,35-39,Literate,12151,5518,17669
8545,26,State - DADRA & NAGAR HAVELI,Total,40-44,Literate,7804,3034,10838
8546,26,State - DADRA & NAGAR HAVELI,Total,45-49,Literate,5119,2036,7155
8547,26,State - DADRA & NAGAR HAVELI,Total,50-54,Literate,3150,1228,4378
8548,26,State - DADRA & NAGAR HAVELI,Total,55-59,Literate,1976,856,2832
8549,26,State - DADRA & NAGAR HAVELI,Total,60-64,Literate,1340,581,1921
8550,26,State - DADRA & NAGAR HAVELI,Total,65-69,Literate,771,356,1127
8551,26,State - DADRA & NAGAR HAVELI,Total,70-74,Literate,367,176,543
8552,26,State - DADRA & NAGAR HAVELI,Total,75-79,Literate,161,110,271
8553,26,State - DADRA & NAGAR HAVELI,Total,80+,Literate,228,162,390
8554,26,State - DADRA & NAGAR HAVELI,Total,Age not stated,Literate,150,89,239
8555,26,State - DADRA & NAGAR HAVELI,Rural,All ages,Literate,64050,35092,99142
8556,26,State - DADRA & NAGAR HAVELI,Rural,0-6,Literate,0,0,0
8557,26,State - DADRA & NAGAR HAVELI,Rural,7,Literate,1897,1722,3619
8558,26,State - DADRA & NAGAR HAVELI,Rural,8,Literate,2246,2073,4319
8559,26,State - DADRA & NAGAR HAVELI,Rural,9,Literate,2053,1972,4025
8560,26,State - DADRA & NAGAR HAVELI,Rural,10,Literate,2417,2231,4648
8561,26,State - DADRA & NAGAR HAVELI,Rural,11,Literate,2425,2177,4602
8562,26,State - DADRA & NAGAR HAVELI,Rural,12,Literate,2161,1977,4138
8563,26,State - DADRA & NAGAR HAVELI,Rural,13,Literate,2208,1914,4122
8564,26,State - DADRA & NAGAR HAVELI,Rural,14,Literate,1983,1628,3611
8565,26,State - DADRA & NAGAR HAVELI,Rural,15,Literate,1888,1503,3391
8566,26,State - DADRA & NAGAR HAVELI,Rural,16,Literate,1720,1297,3017
8567,26,State - DADRA & NAGAR HAVELI,Rural,17,Literate,1748,1055,2803
8568,26,State - DADRA & NAGAR HAVELI,Rural,18,Literate,2368,1206,3574
8569,26,State - DADRA & NAGAR HAVELI,Rural,19,Literate,2270,1095,3365
8570,26,State - DADRA & NAGAR HAVELI,Rural,20-24,Literate,11678,4924,16602
8571,26,State - DADRA & NAGAR HAVELI,Rural,25-29,Literate,8362,3233,11595
8572,26,State - DADRA & NAGAR HAVELI,Rural,30-34,Literate,5362,1978,7340
8573,26,State - DADRA & NAGAR HAVELI,Rural,35-39,Literate,3984,1261,5245
8574,26,State - DADRA & NAGAR HAVELI,Rural,40-44,Literate,2564,705,3269
8575,26,State - DADRA & NAGAR HAVELI,Rural,45-49,Literate,1860,459,2319
8576,26,State - DADRA & NAGAR HAVELI,Rural,50-54,Literate,1181,242,1423
8577,26,State - DADRA & NAGAR HAVELI,Rural,55-59,Literate,697,172,869
8578,26,State - DADRA & NAGAR HAVELI,Rural,60-64,Literate,461,99,560
8579,26,State - DADRA & NAGAR HAVELI,Rural,65-69,Literate,260,73,333
8580,26,State - DADRA & NAGAR HAVELI,Rural,70-74,Literate,106,15,121
8581,26,State - DADRA & NAGAR HAVELI,Rural,75-79,Literate,25,18,43
8582,26,State - DADRA & NAGAR HAVELI,Rural,80+,Literate,53,22,75
8583,26,State - DADRA & NAGAR HAVELI,Rural,Age not stated,Literate,73,41,114
8584,26,State - DADRA & NAGAR HAVELI,Urban,All ages,Literate,78471,45617,124088
8585,26,State - DADRA & NAGAR HAVELI,Urban,0-6,Literate,0,0,0
8586,26,State - DADRA & NAGAR HAVELI,Urban,7,Literate,1454,1210,2664
8587,26,State - DADRA & NAGAR HAVELI,Urban,8,Literate,1435,1253,2688
8588,26,State - DADRA & NAGAR HAVELI,Urban,9,Literate,1460,1131,2591
8589,26,State - DADRA & NAGAR HAVELI,Urban,10,Literate,1441,1308,2749
8590,26,State - DADRA & NAGAR HAVELI,Urban,11,Literate,1372,1162,2534
8591,26,State - DADRA & NAGAR HAVELI,Urban,12,Literate,1309,1105,2414
8592,26,State - DADRA & NAGAR HAVELI,Urban,13,Literate,1281,1036,2317
8593,26,State - DADRA & NAGAR HAVELI,Urban,14,Literate,1227,1013,2240
8594,26,State - DADRA & NAGAR HAVELI,Urban,15,Literate,1254,943,2197
8595,26,State - DADRA & NAGAR HAVELI,Urban,16,Literate,1199,860,2059
8596,26,State - DADRA & NAGAR HAVELI,Urban,17,Literate,1451,855,2306
8597,26,State - DADRA & NAGAR HAVELI,Urban,18,Literate,2473,991,3464
8598,26,State - DADRA & NAGAR HAVELI,Urban,19,Literate,2421,968,3389
8599,26,State - DADRA & NAGAR HAVELI,Urban,20-24,Literate,13924,7080,21004
8600,26,State - DADRA & NAGAR HAVELI,Urban,25-29,Literate,12653,7812,20465
8601,26,State - DADRA & NAGAR HAVELI,Urban,30-34,Literate,10164,5851,16015
8602,26,State - DADRA & NAGAR HAVELI,Urban,35-39,Literate,8167,4257,12424
8603,26,State - DADRA & NAGAR HAVELI,Urban,40-44,Literate,5240,2329,7569
8604,26,State - DADRA & NAGAR HAVELI,Urban,45-49,Literate,3259,1577,4836
8605,26,State - DADRA & NAGAR HAVELI,Urban,50-54,Literate,1969,986,2955
8606,26,State - DADRA & NAGAR HAVELI,Urban,55-59,Literate,1279,684,1963
8607,26,State - DADRA & NAGAR HAVELI,Urban,60-64,Literate,879,482,1361
8608,26,State - DADRA & NAGAR HAVELI,Urban,65-69,Literate,511,283,794
8609,26,State - DADRA & NAGAR HAVELI,Urban,70-74,Literate,261,161,422
8610,26,State - DADRA & NAGAR HAVELI,Urban,75-79,Literate,136,92,228
8611,26,State - DADRA & NAGAR HAVELI,Urban,80+,Literate,175,140,315
8612,26,State - DADRA & NAGAR HAVELI,Urban,Age not stated,Literate,77,48,125
8613,27,State - MAHARASHTRA,Total,All ages,Literate,45257584,36296706,81554290
8614,27,State - MAHARASHTRA,Total,0-6,Literate,0,0,0
8615,27,State - MAHARASHTRA,Total,7,Literate,801141,723082,1524223
8616,27,State - MAHARASHTRA,Total,8,Literate,935674,834686,1770360
8617,27,State - MAHARASHTRA,Total,9,Literate,980220,868742,1848962
8618,27,State - MAHARASHTRA,Total,10,Literate,1155586,1017864,2173450
8619,27,State - MAHARASHTRA,Total,11,Literate,1097768,976318,2074086
8620,27,State - MAHARASHTRA,Total,12,Literate,1070517,944243,2014760
8621,27,State - MAHARASHTRA,Total,13,Literate,1051225,946208,1997433
8622,27,State - MAHARASHTRA,Total,14,Literate,1056525,941145,1997670
8623,27,State - MAHARASHTRA,Total,15,Literate,1079634,936921,2016555
8624,27,State - MAHARASHTRA,Total,16,Literate,1071596,920033,1991629
8625,27,State - MAHARASHTRA,Total,17,Literate,1029962,867267,1897229
8626,27,State - MAHARASHTRA,Total,18,Literate,1231720,1004836,2236556
8627,27,State - MAHARASHTRA,Total,19,Literate,1046153,895740,1941893
8628,27,State - MAHARASHTRA,Total,20-24,Literate,5519824,4738391,10258215
8629,27,State - MAHARASHTRA,Total,25-29,Literate,4894121,4211882,9106003
8630,27,State - MAHARASHTRA,Total,30-34,Literate,4124002,3445826,7569828
8631,27,State - MAHARASHTRA,Total,35-39,Literate,3725098,3005570,6730668
8632,27,State - MAHARASHTRA,Total,40-44,Literate,3198356,2347453,5545809
8633,27,State - MAHARASHTRA,Total,45-49,Literate,2597093,1845287,4442380
8634,27,State - MAHARASHTRA,Total,50-54,Literate,2117902,1393140,3511042
8635,27,State - MAHARASHTRA,Total,55-59,Literate,1617267,1055229,2672496
8636,27,State - MAHARASHTRA,Total,60-64,Literate,1304749,860525,2165274
8637,27,State - MAHARASHTRA,Total,65-69,Literate,1019058,619665,1638723
8638,27,State - MAHARASHTRA,Total,70-74,Literate,673226,361510,1034736
8639,27,State - MAHARASHTRA,Total,75-79,Literate,342963,190221,533184
8640,27,State - MAHARASHTRA,Total,80+,Literate,339950,214786,554736
8641,27,State - MAHARASHTRA,Total,Age not stated,Literate,176254,130136,306390
8642,27,State - MAHARASHTRA,Rural,All ages,Literate,23391475,18091286,41482761
8643,27,State - MAHARASHTRA,Rural,0-6,Literate,0,0,0
8644,27,State - MAHARASHTRA,Rural,7,Literate,439180,397611,836791
8645,27,State - MAHARASHTRA,Rural,8,Literate,539557,483455,1023012
8646,27,State - MAHARASHTRA,Rural,9,Literate,574756,511571,1086327
8647,27,State - MAHARASHTRA,Rural,10,Literate,669805,593071,1262876
8648,27,State - MAHARASHTRA,Rural,11,Literate,639151,570243,1209394
8649,27,State - MAHARASHTRA,Rural,12,Literate,619588,549502,1169090
8650,27,State - MAHARASHTRA,Rural,13,Literate,610205,551738,1161943
8651,27,State - MAHARASHTRA,Rural,14,Literate,613307,546156,1159463
8652,27,State - MAHARASHTRA,Rural,15,Literate,624995,540031,1165026
8653,27,State - MAHARASHTRA,Rural,16,Literate,624243,528978,1153221
8654,27,State - MAHARASHTRA,Rural,17,Literate,580593,480150,1060743
8655,27,State - MAHARASHTRA,Rural,18,Literate,681435,550235,1231670
8656,27,State - MAHARASHTRA,Rural,19,Literate,554252,475517,1029769
8657,27,State - MAHARASHTRA,Rural,20-24,Literate,2841186,2410748,5251934
8658,27,State - MAHARASHTRA,Rural,25-29,Literate,2372331,2000414,4372745
8659,27,State - MAHARASHTRA,Rural,30-34,Literate,1966557,1617326,3583883
8660,27,State - MAHARASHTRA,Rural,35-39,Literate,1798101,1387719,3185820
8661,27,State - MAHARASHTRA,Rural,40-44,Literate,1551418,1046058,2597476
8662,27,State - MAHARASHTRA,Rural,45-49,Literate,1241717,790058,2031775
8663,27,State - MAHARASHTRA,Rural,50-54,Literate,1013112,587173,1600285
8664,27,State - MAHARASHTRA,Rural,55-59,Literate,775997,437175,1213172
8665,27,State - MAHARASHTRA,Rural,60-64,Literate,658301,375723,1034024
8666,27,State - MAHARASHTRA,Rural,65-69,Literate,576530,289625,866155
8667,27,State - MAHARASHTRA,Rural,70-74,Literate,382585,155740,538325
8668,27,State - MAHARASHTRA,Rural,75-79,Literate,181835,70443,252278
8669,27,State - MAHARASHTRA,Rural,80+,Literate,177522,84113,261635
8670,27,State - MAHARASHTRA,Rural,Age not stated,Literate,83216,60713,143929
8671,27,State - MAHARASHTRA,Urban,All ages,Literate,21866109,18205420,40071529
8672,27,State - MAHARASHTRA,Urban,0-6,Literate,0,0,0
8673,27,State - MAHARASHTRA,Urban,7,Literate,361961,325471,687432
8674,27,State - MAHARASHTRA,Urban,8,Literate,396117,351231,747348
8675,27,State - MAHARASHTRA,Urban,9,Literate,405464,357171,762635
8676,27,State - MAHARASHTRA,Urban,10,Literate,485781,424793,910574
8677,27,State - MAHARASHTRA,Urban,11,Literate,458617,406075,864692
8678,27,State - MAHARASHTRA,Urban,12,Literate,450929,394741,845670
8679,27,State - MAHARASHTRA,Urban,13,Literate,441020,394470,835490
8680,27,State - MAHARASHTRA,Urban,14,Literate,443218,394989,838207
8681,27,State - MAHARASHTRA,Urban,15,Literate,454639,396890,851529
8682,27,State - MAHARASHTRA,Urban,16,Literate,447353,391055,838408
8683,27,State - MAHARASHTRA,Urban,17,Literate,449369,387117,836486
8684,27,State - MAHARASHTRA,Urban,18,Literate,550285,454601,1004886
8685,27,State - MAHARASHTRA,Urban,19,Literate,491901,420223,912124
8686,27,State - MAHARASHTRA,Urban,20-24,Literate,2678638,2327643,5006281
8687,27,State - MAHARASHTRA,Urban,25-29,Literate,2521790,2211468,4733258
8688,27,State - MAHARASHTRA,Urban,30-34,Literate,2157445,1828500,3985945
8689,27,State - MAHARASHTRA,Urban,35-39,Literate,1926997,1617851,3544848
8690,27,State - MAHARASHTRA,Urban,40-44,Literate,1646938,1301395,2948333
8691,27,State - MAHARASHTRA,Urban,45-49,Literate,1355376,1055229,2410605
8692,27,State - MAHARASHTRA,Urban,50-54,Literate,1104790,805967,1910757
8693,27,State - MAHARASHTRA,Urban,55-59,Literate,841270,618054,1459324
8694,27,State - MAHARASHTRA,Urban,60-64,Literate,646448,484802,1131250
8695,27,State - MAHARASHTRA,Urban,65-69,Literate,442528,330040,772568
8696,27,State - MAHARASHTRA,Urban,70-74,Literate,290641,205770,496411
8697,27,State - MAHARASHTRA,Urban,75-79,Literate,161128,119778,280906
8698,27,State - MAHARASHTRA,Urban,80+,Literate,162428,130673,293101
8699,27,State - MAHARASHTRA,Urban,Age not stated,Literate,93038,69423,162461
8700,28,State - ANDHRA PRADESH,Total,All ages,Literate,28251243,22305517,50556760
8701,28,State - ANDHRA PRADESH,Total,0-6,Literate,0,0,0
8702,28,State - ANDHRA PRADESH,Total,7,Literate,558580,524018,1082598
8703,28,State - ANDHRA PRADESH,Total,8,Literate,672762,637915,1310677
8704,28,State - ANDHRA PRADESH,Total,9,Literate,694443,657222,1351665
8705,28,State - ANDHRA PRADESH,Total,10,Literate,852843,788417,1641260
8706,28,State - ANDHRA PRADESH,Total,11,Literate,759156,719939,1479095
8707,28,State - ANDHRA PRADESH,Total,12,Literate,819123,763296,1582419
8708,28,State - ANDHRA PRADESH,Total,13,Literate,775822,729794,1505616
8709,28,State - ANDHRA PRADESH,Total,14,Literate,791516,728127,1519643
8710,28,State - ANDHRA PRADESH,Total,15,Literate,806987,723038,1530025
8711,28,State - ANDHRA PRADESH,Total,16,Literate,772673,687054,1459727
8712,28,State - ANDHRA PRADESH,Total,17,Literate,733635,625067,1358702
8713,28,State - ANDHRA PRADESH,Total,18,Literate,881138,787524,1668662
8714,28,State - ANDHRA PRADESH,Total,19,Literate,709932,644693,1354625
8715,28,State - ANDHRA PRADESH,Total,20-24,Literate,3585781,3162951,6748732
8716,28,State - ANDHRA PRADESH,Total,25-29,Literate,3104465,2631656,5736121
8717,28,State - ANDHRA PRADESH,Total,30-34,Literate,2504207,1876258,4380465
8718,28,State - ANDHRA PRADESH,Total,35-39,Literate,2245854,1578406,3824260
8719,28,State - ANDHRA PRADESH,Total,40-44,Literate,1758827,1061815,2820642
8720,28,State - ANDHRA PRADESH,Total,45-49,Literate,1385632,821823,2207455
8721,28,State - ANDHRA PRADESH,Total,50-54,Literate,1025021,575924,1600945
8722,28,State - ANDHRA PRADESH,Total,55-59,Literate,763612,448601,1212213
8723,28,State - ANDHRA PRADESH,Total,60-64,Literate,700525,376588,1077113
8724,28,State - ANDHRA PRADESH,Total,65-69,Literate,467273,230943,698216
8725,28,State - ANDHRA PRADESH,Total,70-74,Literate,305950,133946,439896
8726,28,State - ANDHRA PRADESH,Total,75-79,Literate,141105,67200,208305
8727,28,State - ANDHRA PRADESH,Total,80+,Literate,146999,90877,237876
8728,28,State - ANDHRA PRADESH,Total,Age not stated,Literate,287382,232425,519807
8729,28,State - ANDHRA PRADESH,Rural,All ages,Literate,17395600,12955465,30351065
8730,28,State - ANDHRA PRADESH,Rural,0-6,Literate,0,0,0
8731,28,State - ANDHRA PRADESH,Rural,7,Literate,367413,346061,713474
8732,28,State - ANDHRA PRADESH,Rural,8,Literate,459295,436829,896124
8733,28,State - ANDHRA PRADESH,Rural,9,Literate,470037,446885,916922
8734,28,State - ANDHRA PRADESH,Rural,10,Literate,576981,532726,1109707
8735,28,State - ANDHRA PRADESH,Rural,11,Literate,507711,479728,987439
8736,28,State - ANDHRA PRADESH,Rural,12,Literate,562198,518325,1080523
8737,28,State - ANDHRA PRADESH,Rural,13,Literate,528339,492756,1021095
8738,28,State - ANDHRA PRADESH,Rural,14,Literate,537269,487876,1025145
8739,28,State - ANDHRA PRADESH,Rural,15,Literate,538185,473967,1012152
8740,28,State - ANDHRA PRADESH,Rural,16,Literate,506165,437691,943856
8741,28,State - ANDHRA PRADESH,Rural,17,Literate,476702,387346,864048
8742,28,State - ANDHRA PRADESH,Rural,18,Literate,598612,508337,1106949
8743,28,State - ANDHRA PRADESH,Rural,19,Literate,463837,393865,857702
8744,28,State - ANDHRA PRADESH,Rural,20-24,Literate,2323983,1863393,4187376
8745,28,State - ANDHRA PRADESH,Rural,25-29,Literate,1898704,1463904,3362608
8746,28,State - ANDHRA PRADESH,Rural,30-34,Literate,1468280,999209,2467489
8747,28,State - ANDHRA PRADESH,Rural,35-39,Literate,1297834,810656,2108490
8748,28,State - ANDHRA PRADESH,Rural,40-44,Literate,975925,503561,1479486
8749,28,State - ANDHRA PRADESH,Rural,45-49,Literate,743254,375886,1119140
8750,28,State - ANDHRA PRADESH,Rural,50-54,Literate,540189,255194,795383
8751,28,State - ANDHRA PRADESH,Rural,55-59,Literate,393700,206298,599998
8752,28,State - ANDHRA PRADESH,Rural,60-64,Literate,394602,185363,579965
8753,28,State - ANDHRA PRADESH,Rural,65-69,Literate,280826,113721,394547
8754,28,State - ANDHRA PRADESH,Rural,70-74,Literate,183765,63496,247261
8755,28,State - ANDHRA PRADESH,Rural,75-79,Literate,81070,29825,110895
8756,28,State - ANDHRA PRADESH,Rural,80+,Literate,83134,39854,122988
8757,28,State - ANDHRA PRADESH,Rural,Age not stated,Literate,137590,102713,240303
8758,28,State - ANDHRA PRADESH,Urban,All ages,Literate,10855643,9350052,20205695
8759,28,State - ANDHRA PRADESH,Urban,0-6,Literate,0,0,0
8760,28,State - ANDHRA PRADESH,Urban,7,Literate,191167,177957,369124
8761,28,State - ANDHRA PRADESH,Urban,8,Literate,213467,201086,414553
8762,28,State - ANDHRA PRADESH,Urban,9,Literate,224406,210337,434743
8763,28,State - ANDHRA PRADESH,Urban,10,Literate,275862,255691,531553
8764,28,State - ANDHRA PRADESH,Urban,11,Literate,251445,240211,491656
8765,28,State - ANDHRA PRADESH,Urban,12,Literate,256925,244971,501896
8766,28,State - ANDHRA PRADESH,Urban,13,Literate,247483,237038,484521
8767,28,State - ANDHRA PRADESH,Urban,14,Literate,254247,240251,494498
8768,28,State - ANDHRA PRADESH,Urban,15,Literate,268802,249071,517873
8769,28,State - ANDHRA PRADESH,Urban,16,Literate,266508,249363,515871
8770,28,State - ANDHRA PRADESH,Urban,17,Literate,256933,237721,494654
8771,28,State - ANDHRA PRADESH,Urban,18,Literate,282526,279187,561713
8772,28,State - ANDHRA PRADESH,Urban,19,Literate,246095,250828,496923
8773,28,State - ANDHRA PRADESH,Urban,20-24,Literate,1261798,1299558,2561356
8774,28,State - ANDHRA PRADESH,Urban,25-29,Literate,1205761,1167752,2373513
8775,28,State - ANDHRA PRADESH,Urban,30-34,Literate,1035927,877049,1912976
8776,28,State - ANDHRA PRADESH,Urban,35-39,Literate,948020,767750,1715770
8777,28,State - ANDHRA PRADESH,Urban,40-44,Literate,782902,558254,1341156
8778,28,State - ANDHRA PRADESH,Urban,45-49,Literate,642378,445937,1088315
8779,28,State - ANDHRA PRADESH,Urban,50-54,Literate,484832,320730,805562
8780,28,State - ANDHRA PRADESH,Urban,55-59,Literate,369912,242303,612215
8781,28,State - ANDHRA PRADESH,Urban,60-64,Literate,305923,191225,497148
8782,28,State - ANDHRA PRADESH,Urban,65-69,Literate,186447,117222,303669
8783,28,State - ANDHRA PRADESH,Urban,70-74,Literate,122185,70450,192635
8784,28,State - ANDHRA PRADESH,Urban,75-79,Literate,60035,37375,97410
8785,28,State - ANDHRA PRADESH,Urban,80+,Literate,63865,51023,114888
8786,28,State - ANDHRA PRADESH,Urban,Age not stated,Literate,149792,129712,279504
8787,29,State - KARNATAKA,Total,All ages,Literate,22508471,18138851,40647322
8788,29,State - KARNATAKA,Total,0-6,Literate,0,0,0
8789,29,State - KARNATAKA,Total,7,Literate,416464,390350,806814
8790,29,State - KARNATAKA,Total,8,Literate,502595,472842,975437
8791,29,State - KARNATAKA,Total,9,Literate,514680,485874,1000554
8792,29,State - KARNATAKA,Total,10,Literate,596302,555507,1151809
8793,29,State - KARNATAKA,Total,11,Literate,556446,524881,1081327
8794,29,State - KARNATAKA,Total,12,Literate,573963,533173,1107136
8795,29,State - KARNATAKA,Total,13,Literate,544184,503757,1047941
8796,29,State - KARNATAKA,Total,14,Literate,568236,513068,1081304
8797,29,State - KARNATAKA,Total,15,Literate,572645,505662,1078307
8798,29,State - KARNATAKA,Total,16,Literate,561827,498719,1060546
8799,29,State - KARNATAKA,Total,17,Literate,524896,463252,988148
8800,29,State - KARNATAKA,Total,18,Literate,673287,586286,1259573
8801,29,State - KARNATAKA,Total,19,Literate,536539,494310,1030849
8802,29,State - KARNATAKA,Total,20-24,Literate,2859584,2508880,5368464
8803,29,State - KARNATAKA,Total,25-29,Literate,2542298,2248419,4790717
8804,29,State - KARNATAKA,Total,30-34,Literate,2024843,1626672,3651515
8805,29,State - KARNATAKA,Total,35-39,Literate,1846429,1440365,3286794
8806,29,State - KARNATAKA,Total,40-44,Literate,1473245,996641,2469886
8807,29,State - KARNATAKA,Total,45-49,Literate,1278147,837281,2115428
8808,29,State - KARNATAKA,Total,50-54,Literate,949237,591562,1540799
8809,29,State - KARNATAKA,Total,55-59,Literate,739486,456616,1196102
8810,29,State - KARNATAKA,Total,60-64,Literate,620251,352230,972481
8811,29,State - KARNATAKA,Total,65-69,Literate,433068,236365,669433
8812,29,State - KARNATAKA,Total,70-74,Literate,283504,139038,422542
8813,29,State - KARNATAKA,Total,75-79,Literate,147252,75681,222933
8814,29,State - KARNATAKA,Total,80+,Literate,149044,88213,237257
8815,29,State - KARNATAKA,Total,Age not stated,Literate,20019,13207,33226
8816,29,State - KARNATAKA,Rural,All ages,Literate,12893437,9755739,22649176
8817,29,State - KARNATAKA,Rural,0-6,Literate,0,0,0
8818,29,State - KARNATAKA,Rural,7,Literate,252324,235148,487472
8819,29,State - KARNATAKA,Rural,8,Literate,316180,297359,613539
8820,29,State - KARNATAKA,Rural,9,Literate,327130,309688,636818
8821,29,State - KARNATAKA,Rural,10,Literate,376347,351503,727850
8822,29,State - KARNATAKA,Rural,11,Literate,351133,329324,680457
8823,29,State - KARNATAKA,Rural,12,Literate,367310,338349,705659
8824,29,State - KARNATAKA,Rural,13,Literate,347397,317534,664931
8825,29,State - KARNATAKA,Rural,14,Literate,367848,325664,693512
8826,29,State - KARNATAKA,Rural,15,Literate,371240,319706,690946
8827,29,State - KARNATAKA,Rural,16,Literate,361253,310731,671984
8828,29,State - KARNATAKA,Rural,17,Literate,326984,275693,602677
8829,29,State - KARNATAKA,Rural,18,Literate,429857,354450,784307
8830,29,State - KARNATAKA,Rural,19,Literate,318954,282475,601429
8831,29,State - KARNATAKA,Rural,20-24,Literate,1670887,1371532,3042419
8832,29,State - KARNATAKA,Rural,25-29,Literate,1400166,1147372,2547538
8833,29,State - KARNATAKA,Rural,30-34,Literate,1060419,796990,1857409
8834,29,State - KARNATAKA,Rural,35-39,Literate,979004,707241,1686245
8835,29,State - KARNATAKA,Rural,40-44,Literate,787263,468126,1255389
8836,29,State - KARNATAKA,Rural,45-49,Literate,686007,381647,1067654
8837,29,State - KARNATAKA,Rural,50-54,Literate,496687,256012,752699
8838,29,State - KARNATAKA,Rural,55-59,Literate,381144,194256,575400
8839,29,State - KARNATAKA,Rural,60-64,Literate,334524,150749,485273
8840,29,State - KARNATAKA,Rural,65-69,Literate,249355,104988,354343
8841,29,State - KARNATAKA,Rural,70-74,Literate,161775,58236,220011
8842,29,State - KARNATAKA,Rural,75-79,Literate,80943,29601,110544
8843,29,State - KARNATAKA,Rural,80+,Literate,80860,34367,115227
8844,29,State - KARNATAKA,Rural,Age not stated,Literate,10446,6998,17444
8845,29,State - KARNATAKA,Urban,All ages,Literate,9615034,8383112,17998146
8846,29,State - KARNATAKA,Urban,0-6,Literate,0,0,0
8847,29,State - KARNATAKA,Urban,7,Literate,164140,155202,319342
8848,29,State - KARNATAKA,Urban,8,Literate,186415,175483,361898
8849,29,State - KARNATAKA,Urban,9,Literate,187550,176186,363736
8850,29,State - KARNATAKA,Urban,10,Literate,219955,204004,423959
8851,29,State - KARNATAKA,Urban,11,Literate,205313,195557,400870
8852,29,State - KARNATAKA,Urban,12,Literate,206653,194824,401477
8853,29,State - KARNATAKA,Urban,13,Literate,196787,186223,383010
8854,29,State - KARNATAKA,Urban,14,Literate,200388,187404,387792
8855,29,State - KARNATAKA,Urban,15,Literate,201405,185956,387361
8856,29,State - KARNATAKA,Urban,16,Literate,200574,187988,388562
8857,29,State - KARNATAKA,Urban,17,Literate,197912,187559,385471
8858,29,State - KARNATAKA,Urban,18,Literate,243430,231836,475266
8859,29,State - KARNATAKA,Urban,19,Literate,217585,211835,429420
8860,29,State - KARNATAKA,Urban,20-24,Literate,1188697,1137348,2326045
8861,29,State - KARNATAKA,Urban,25-29,Literate,1142132,1101047,2243179
8862,29,State - KARNATAKA,Urban,30-34,Literate,964424,829682,1794106
8863,29,State - KARNATAKA,Urban,35-39,Literate,867425,733124,1600549
8864,29,State - KARNATAKA,Urban,40-44,Literate,685982,528515,1214497
8865,29,State - KARNATAKA,Urban,45-49,Literate,592140,455634,1047774
8866,29,State - KARNATAKA,Urban,50-54,Literate,452550,335550,788100
8867,29,State - KARNATAKA,Urban,55-59,Literate,358342,262360,620702
8868,29,State - KARNATAKA,Urban,60-64,Literate,285727,201481,487208
8869,29,State - KARNATAKA,Urban,65-69,Literate,183713,131377,315090
8870,29,State - KARNATAKA,Urban,70-74,Literate,121729,80802,202531
8871,29,State - KARNATAKA,Urban,75-79,Literate,66309,46080,112389
8872,29,State - KARNATAKA,Urban,80+,Literate,68184,53846,122030
8873,29,State - KARNATAKA,Urban,Age not stated,Literate,9573,6209,15782
8874,30,State - GOA,Total,All ages,Literate,615823,549664,1165487
8875,30,State - GOA,Total,0-6,Literate,0,0,0
8876,30,State - GOA,Total,7,Literate,9186,8584,17770
8877,30,State - GOA,Total,8,Literate,9958,9171,19129
8878,30,State - GOA,Total,9,Literate,10255,9864,20119
8879,30,State - GOA,Total,10,Literate,11824,11020,22844
8880,30,State - GOA,Total,11,Literate,11540,10664,22204
8881,30,State - GOA,Total,12,Literate,10965,9895,20860
8882,30,State - GOA,Total,13,Literate,10805,10209,21014
8883,30,State - GOA,Total,14,Literate,10956,10203,21159
8884,30,State - GOA,Total,15,Literate,11123,10219,21342
8885,30,State - GOA,Total,16,Literate,10779,9767,20546
8886,30,State - GOA,Total,17,Literate,10586,9919,20505
8887,30,State - GOA,Total,18,Literate,12933,11059,23992
8888,30,State - GOA,Total,19,Literate,13083,11107,24190
8889,30,State - GOA,Total,20-24,Literate,67805,56816,124621
8890,30,State - GOA,Total,25-29,Literate,64541,60068,124609
8891,30,State - GOA,Total,30-34,Literate,60235,57239,117474
8892,30,State - GOA,Total,35-39,Literate,59658,55956,115614
8893,30,State - GOA,Total,40-44,Literate,51469,45285,96754
8894,30,State - GOA,Total,45-49,Literate,43600,38057,81657
8895,30,State - GOA,Total,50-54,Literate,35039,29048,64087
8896,30,State - GOA,Total,55-59,Literate,28548,24167,52715
8897,30,State - GOA,Total,60-64,Literate,24382,19552,43934
8898,30,State - GOA,Total,65-69,Literate,15290,12377,27667
8899,30,State - GOA,Total,70-74,Literate,9963,8433,18396
8900,30,State - GOA,Total,75-79,Literate,5741,5187,10928
8901,30,State - GOA,Total,80+,Literate,4609,5060,9669
8902,30,State - GOA,Total,Age not stated,Literate,950,738,1688
8903,30,State - GOA,Rural,All ages,Literate,227143,204128,431271
8904,30,State - GOA,Rural,0-6,Literate,0,0,0
8905,30,State - GOA,Rural,7,Literate,3381,3208,6589
8906,30,State - GOA,Rural,8,Literate,3627,3457,7084
8907,30,State - GOA,Rural,9,Literate,3797,3744,7541
8908,30,State - GOA,Rural,10,Literate,4365,4286,8651
8909,30,State - GOA,Rural,11,Literate,4202,4113,8315
8910,30,State - GOA,Rural,12,Literate,4082,3700,7782
8911,30,State - GOA,Rural,13,Literate,4099,3840,7939
8912,30,State - GOA,Rural,14,Literate,4131,3922,8053
8913,30,State - GOA,Rural,15,Literate,4065,3901,7966
8914,30,State - GOA,Rural,16,Literate,4048,3698,7746
8915,30,State - GOA,Rural,17,Literate,4054,3827,7881
8916,30,State - GOA,Rural,18,Literate,4685,4152,8837
8917,30,State - GOA,Rural,19,Literate,4622,4233,8855
8918,30,State - GOA,Rural,20-24,Literate,23759,21642,45401
8919,30,State - GOA,Rural,25-29,Literate,24266,23057,47323
8920,30,State - GOA,Rural,30-34,Literate,23166,22165,45331
8921,30,State - GOA,Rural,35-39,Literate,22927,21271,44198
8922,30,State - GOA,Rural,40-44,Literate,18990,16298,35288
8923,30,State - GOA,Rural,45-49,Literate,16011,13501,29512
8924,30,State - GOA,Rural,50-54,Literate,12532,10198,22730
8925,30,State - GOA,Rural,55-59,Literate,10413,8274,18687
8926,30,State - GOA,Rural,60-64,Literate,8889,6692,15581
8927,30,State - GOA,Rural,65-69,Literate,5547,4354,9901
8928,30,State - GOA,Rural,70-74,Literate,3460,2868,6328
8929,30,State - GOA,Rural,75-79,Literate,1980,1667,3647
8930,30,State - GOA,Rural,80+,Literate,1623,1739,3362
8931,30,State - GOA,Rural,Age not stated,Literate,422,321,743
8932,30,State - GOA,Urban,All ages,Literate,388680,345536,734216
8933,30,State - GOA,Urban,0-6,Literate,0,0,0
8934,30,State - GOA,Urban,7,Literate,5805,5376,11181
8935,30,State - GOA,Urban,8,Literate,6331,5714,12045
8936,30,State - GOA,Urban,9,Literate,6458,6120,12578
8937,30,State - GOA,Urban,10,Literate,7459,6734,14193
8938,30,State - GOA,Urban,11,Literate,7338,6551,13889
8939,30,State - GOA,Urban,12,Literate,6883,6195,13078
8940,30,State - GOA,Urban,13,Literate,6706,6369,13075
8941,30,State - GOA,Urban,14,Literate,6825,6281,13106
8942,30,State - GOA,Urban,15,Literate,7058,6318,13376
8943,30,State - GOA,Urban,16,Literate,6731,6069,12800
8944,30,State - GOA,Urban,17,Literate,6532,6092,12624
8945,30,State - GOA,Urban,18,Literate,8248,6907,15155
8946,30,State - GOA,Urban,19,Literate,8461,6874,15335
8947,30,State - GOA,Urban,20-24,Literate,44046,35174,79220
8948,30,State - GOA,Urban,25-29,Literate,40275,37011,77286
8949,30,State - GOA,Urban,30-34,Literate,37069,35074,72143
8950,30,State - GOA,Urban,35-39,Literate,36731,34685,71416
8951,30,State - GOA,Urban,40-44,Literate,32479,28987,61466
8952,30,State - GOA,Urban,45-49,Literate,27589,24556,52145
8953,30,State - GOA,Urban,50-54,Literate,22507,18850,41357
8954,30,State - GOA,Urban,55-59,Literate,18135,15893,34028
8955,30,State - GOA,Urban,60-64,Literate,15493,12860,28353
8956,30,State - GOA,Urban,65-69,Literate,9743,8023,17766
8957,30,State - GOA,Urban,70-74,Literate,6503,5565,12068
8958,30,State - GOA,Urban,75-79,Literate,3761,3520,7281
8959,30,State - GOA,Urban,80+,Literate,2986,3321,6307
8960,30,State - GOA,Urban,Age not stated,Literate,528,417,945
8961,31,State - LAKSHADWEEP,Total,All ages,Literate,28023,24530,52553
8962,31,State - LAKSHADWEEP,Total,0-6,Literate,0,0,0
8963,31,State - LAKSHADWEEP,Total,7,Literate,398,378,776
8964,31,State - LAKSHADWEEP,Total,8,Literate,411,415,826
8965,31,State - LAKSHADWEEP,Total,9,Literate,560,552,1112
8966,31,State - LAKSHADWEEP,Total,10,Literate,610,637,1247
8967,31,State - LAKSHADWEEP,Total,11,Literate,580,625,1205
8968,31,State - LAKSHADWEEP,Total,12,Literate,532,616,1148
8969,31,State - LAKSHADWEEP,Total,13,Literate,516,629,1145
8970,31,State - LAKSHADWEEP,Total,14,Literate,548,559,1107
8971,31,State - LAKSHADWEEP,Total,15,Literate,581,570,1151
8972,31,State - LAKSHADWEEP,Total,16,Literate,526,595,1121
8973,31,State - LAKSHADWEEP,Total,17,Literate,556,578,1134
8974,31,State - LAKSHADWEEP,Total,18,Literate,570,551,1121
8975,31,State - LAKSHADWEEP,Total,19,Literate,534,481,1015
8976,31,State - LAKSHADWEEP,Total,20-24,Literate,3011,2705,5716
8977,31,State - LAKSHADWEEP,Total,25-29,Literate,3068,2778,5846
8978,31,State - LAKSHADWEEP,Total,30-34,Literate,2724,2583,5307
8979,31,State - LAKSHADWEEP,Total,35-39,Literate,2699,2517,5216
8980,31,State - LAKSHADWEEP,Total,40-44,Literate,2384,1979,4363
8981,31,State - LAKSHADWEEP,Total,45-49,Literate,1916,1609,3525
8982,31,State - LAKSHADWEEP,Total,50-54,Literate,1577,1122,2699
8983,31,State - LAKSHADWEEP,Total,55-59,Literate,1448,956,2404
8984,31,State - LAKSHADWEEP,Total,60-64,Literate,953,533,1486
8985,31,State - LAKSHADWEEP,Total,65-69,Literate,636,248,884
8986,31,State - LAKSHADWEEP,Total,70-74,Literate,305,125,430
8987,31,State - LAKSHADWEEP,Total,75-79,Literate,164,87,251
8988,31,State - LAKSHADWEEP,Total,80+,Literate,160,74,234
8989,31,State - LAKSHADWEEP,Total,Age not stated,Literate,56,28,84
8990,31,State - LAKSHADWEEP,Rural,All ages,Literate,5949,5339,11288
8991,31,State - LAKSHADWEEP,Rural,0-6,Literate,0,0,0
8992,31,State - LAKSHADWEEP,Rural,7,Literate,75,75,150
8993,31,State - LAKSHADWEEP,Rural,8,Literate,93,101,194
8994,31,State - LAKSHADWEEP,Rural,9,Literate,143,125,268
8995,31,State - LAKSHADWEEP,Rural,10,Literate,146,150,296
8996,31,State - LAKSHADWEEP,Rural,11,Literate,140,163,303
8997,31,State - LAKSHADWEEP,Rural,12,Literate,118,134,252
8998,31,State - LAKSHADWEEP,Rural,13,Literate,98,163,261
8999,31,State - LAKSHADWEEP,Rural,14,Literate,90,148,238
9000,31,State - LAKSHADWEEP,Rural,15,Literate,110,124,234
9001,31,State - LAKSHADWEEP,Rural,16,Literate,81,133,214
9002,31,State - LAKSHADWEEP,Rural,17,Literate,108,120,228
9003,31,State - LAKSHADWEEP,Rural,18,Literate,115,128,243
9004,31,State - LAKSHADWEEP,Rural,19,Literate,105,108,213
9005,31,State - LAKSHADWEEP,Rural,20-24,Literate,665,587,1252
9006,31,State - LAKSHADWEEP,Rural,25-29,Literate,665,615,1280
9007,31,State - LAKSHADWEEP,Rural,30-34,Literate,629,576,1205
9008,31,State - LAKSHADWEEP,Rural,35-39,Literate,579,505,1084
9009,31,State - LAKSHADWEEP,Rural,40-44,Literate,466,417,883
9010,31,State - LAKSHADWEEP,Rural,45-49,Literate,390,333,723
9011,31,State - LAKSHADWEEP,Rural,50-54,Literate,357,261,618
9012,31,State - LAKSHADWEEP,Rural,55-59,Literate,285,198,483
9013,31,State - LAKSHADWEEP,Rural,60-64,Literate,207,105,312
9014,31,State - LAKSHADWEEP,Rural,65-69,Literate,149,35,184
9015,31,State - LAKSHADWEEP,Rural,70-74,Literate,49,13,62
9016,31,State - LAKSHADWEEP,Rural,75-79,Literate,28,9,37
9017,31,State - LAKSHADWEEP,Rural,80+,Literate,40,7,47
9018,31,State - LAKSHADWEEP,Rural,Age not stated,Literate,18,6,24
9019,31,State - LAKSHADWEEP,Urban,All ages,Literate,22074,19191,41265
9020,31,State - LAKSHADWEEP,Urban,0-6,Literate,0,0,0
9021,31,State - LAKSHADWEEP,Urban,7,Literate,323,303,626
9022,31,State - LAKSHADWEEP,Urban,8,Literate,318,314,632
9023,31,State - LAKSHADWEEP,Urban,9,Literate,417,427,844
9024,31,State - LAKSHADWEEP,Urban,10,Literate,464,487,951
9025,31,State - LAKSHADWEEP,Urban,11,Literate,440,462,902
9026,31,State - LAKSHADWEEP,Urban,12,Literate,414,482,896
9027,31,State - LAKSHADWEEP,Urban,13,Literate,418,466,884
9028,31,State - LAKSHADWEEP,Urban,14,Literate,458,411,869
9029,31,State - LAKSHADWEEP,Urban,15,Literate,471,446,917
9030,31,State - LAKSHADWEEP,Urban,16,Literate,445,462,907
9031,31,State - LAKSHADWEEP,Urban,17,Literate,448,458,906
9032,31,State - LAKSHADWEEP,Urban,18,Literate,455,423,878
9033,31,State - LAKSHADWEEP,Urban,19,Literate,429,373,802
9034,31,State - LAKSHADWEEP,Urban,20-24,Literate,2346,2118,4464
9035,31,State - LAKSHADWEEP,Urban,25-29,Literate,2403,2163,4566
9036,31,State - LAKSHADWEEP,Urban,30-34,Literate,2095,2007,4102
9037,31,State - LAKSHADWEEP,Urban,35-39,Literate,2120,2012,4132
9038,31,State - LAKSHADWEEP,Urban,40-44,Literate,1918,1562,3480
9039,31,State - LAKSHADWEEP,Urban,45-49,Literate,1526,1276,2802
9040,31,State - LAKSHADWEEP,Urban,50-54,Literate,1220,861,2081
9041,31,State - LAKSHADWEEP,Urban,55-59,Literate,1163,758,1921
9042,31,State - LAKSHADWEEP,Urban,60-64,Literate,746,428,1174
9043,31,State - LAKSHADWEEP,Urban,65-69,Literate,487,213,700
9044,31,State - LAKSHADWEEP,Urban,70-74,Literate,256,112,368
9045,31,State - LAKSHADWEEP,Urban,75-79,Literate,136,78,214
9046,31,State - LAKSHADWEEP,Urban,80+,Literate,120,67,187
9047,31,State - LAKSHADWEEP,Urban,Age not stated,Literate,38,22,60
9048,32,State - KERALA,Total,All ages,Literate,13704903,14430921,28135824
9049,32,State - KERALA,Total,0-6,Literate,0,0,0
9050,32,State - KERALA,Total,7,Literate,225252,216537,441789
9051,32,State - KERALA,Total,8,Literate,249264,240496,489760
9052,32,State - KERALA,Total,9,Literate,260014,250741,510755
9053,32,State - KERALA,Total,10,Literate,290532,278212,568744
9054,32,State - KERALA,Total,11,Literate,285663,275657,561320
9055,32,State - KERALA,Total,12,Literate,274726,262603,537329
9056,32,State - KERALA,Total,13,Literate,291271,282929,574200
9057,32,State - KERALA,Total,14,Literate,280342,268757,549099
9058,32,State - KERALA,Total,15,Literate,273741,263296,537037
9059,32,State - KERALA,Total,16,Literate,259657,251459,511116
9060,32,State - KERALA,Total,17,Literate,261240,252334,513574
9061,32,State - KERALA,Total,18,Literate,267144,255808,522952
9062,32,State - KERALA,Total,19,Literate,255696,248759,504455
9063,32,State - KERALA,Total,20-24,Literate,1284451,1351880,2636331
9064,32,State - KERALA,Total,25-29,Literate,1186651,1378880,2565531
9065,32,State - KERALA,Total,30-34,Literate,1109140,1300156,2409296
9066,32,State - KERALA,Total,35-39,Literate,1134600,1368136,2502736
9067,32,State - KERALA,Total,40-44,Literate,1083445,1228677,2312122
9068,32,State - KERALA,Total,45-49,Literate,1058291,1141719,2200010
9069,32,State - KERALA,Total,50-54,Literate,885669,890594,1776263
9070,32,State - KERALA,Total,55-59,Literate,809381,751906,1561287
9071,32,State - KERALA,Total,60-64,Literate,629760,582466,1212226
9072,32,State - KERALA,Total,65-69,Literate,407578,393005,800583
9073,32,State - KERALA,Total,70-74,Literate,283492,280174,563666
9074,32,State - KERALA,Total,75-79,Literate,175917,193942,369859
9075,32,State - KERALA,Total,80+,Literate,167697,208252,375949
9076,32,State - KERALA,Total,Age not stated,Literate,14289,13546,27835
9077,32,State - KERALA,Rural,All ages,Literate,7132430,7416890,14549320
9078,32,State - KERALA,Rural,0-6,Literate,0,0,0
9079,32,State - KERALA,Rural,7,Literate,117458,113801,231259
9080,32,State - KERALA,Rural,8,Literate,130997,126624,257621
9081,32,State - KERALA,Rural,9,Literate,137317,132413,269730
9082,32,State - KERALA,Rural,10,Literate,154207,147888,302095
9083,32,State - KERALA,Rural,11,Literate,150905,145958,296863
9084,32,State - KERALA,Rural,12,Literate,146407,140305,286712
9085,32,State - KERALA,Rural,13,Literate,154013,150673,304686
9086,32,State - KERALA,Rural,14,Literate,148257,142924,291181
9087,32,State - KERALA,Rural,15,Literate,144263,139022,283285
9088,32,State - KERALA,Rural,16,Literate,136508,132357,268865
9089,32,State - KERALA,Rural,17,Literate,136283,131335,267618
9090,32,State - KERALA,Rural,18,Literate,139649,132668,272317
9091,32,State - KERALA,Rural,19,Literate,133489,128152,261641
9092,32,State - KERALA,Rural,20-24,Literate,672162,696415,1368577
9093,32,State - KERALA,Rural,25-29,Literate,628517,716087,1344604
9094,32,State - KERALA,Rural,30-34,Literate,581243,667283,1248526
9095,32,State - KERALA,Rural,35-39,Literate,590783,702226,1293009
9096,32,State - KERALA,Rural,40-44,Literate,556330,623770,1180100
9097,32,State - KERALA,Rural,45-49,Literate,547131,582728,1129859
9098,32,State - KERALA,Rural,50-54,Literate,455252,449280,904532
9099,32,State - KERALA,Rural,55-59,Literate,412911,377398,790309
9100,32,State - KERALA,Rural,60-64,Literate,315823,286434,602257
9101,32,State - KERALA,Rural,65-69,Literate,207514,197145,404659
9102,32,State - KERALA,Rural,70-74,Literate,143599,139477,283076
9103,32,State - KERALA,Rural,75-79,Literate,91619,98556,190175
9104,32,State - KERALA,Rural,80+,Literate,92565,109196,201761
9105,32,State - KERALA,Rural,Age not stated,Literate,7228,6775,14003
9106,32,State - KERALA,Urban,All ages,Literate,6572473,7014031,13586504
9107,32,State - KERALA,Urban,0-6,Literate,0,0,0
9108,32,State - KERALA,Urban,7,Literate,107794,102736,210530
9109,32,State - KERALA,Urban,8,Literate,118267,113872,232139
9110,32,State - KERALA,Urban,9,Literate,122697,118328,241025
9111,32,State - KERALA,Urban,10,Literate,136325,130324,266649
9112,32,State - KERALA,Urban,11,Literate,134758,129699,264457
9113,32,State - KERALA,Urban,12,Literate,128319,122298,250617
9114,32,State - KERALA,Urban,13,Literate,137258,132256,269514
9115,32,State - KERALA,Urban,14,Literate,132085,125833,257918
9116,32,State - KERALA,Urban,15,Literate,129478,124274,253752
9117,32,State - KERALA,Urban,16,Literate,123149,119102,242251
9118,32,State - KERALA,Urban,17,Literate,124957,120999,245956
9119,32,State - KERALA,Urban,18,Literate,127495,123140,250635
9120,32,State - KERALA,Urban,19,Literate,122207,120607,242814
9121,32,State - KERALA,Urban,20-24,Literate,612289,655465,1267754
9122,32,State - KERALA,Urban,25-29,Literate,558134,662793,1220927
9123,32,State - KERALA,Urban,30-34,Literate,527897,632873,1160770
9124,32,State - KERALA,Urban,35-39,Literate,543817,665910,1209727
9125,32,State - KERALA,Urban,40-44,Literate,527115,604907,1132022
9126,32,State - KERALA,Urban,45-49,Literate,511160,558991,1070151
9127,32,State - KERALA,Urban,50-54,Literate,430417,441314,871731
9128,32,State - KERALA,Urban,55-59,Literate,396470,374508,770978
9129,32,State - KERALA,Urban,60-64,Literate,313937,296032,609969
9130,32,State - KERALA,Urban,65-69,Literate,200064,195860,395924
9131,32,State - KERALA,Urban,70-74,Literate,139893,140697,280590
9132,32,State - KERALA,Urban,75-79,Literate,84298,95386,179684
9133,32,State - KERALA,Urban,80+,Literate,75132,99056,174188
9134,32,State - KERALA,Urban,Age not stated,Literate,7061,6771,13832
9135,33,State - TAMIL NADU,Total,All ages,Literate,28040491,23797016,51837507
9136,33,State - TAMIL NADU,Total,0-6,Literate,0,0,0
9137,33,State - TAMIL NADU,Total,7,Literate,480539,454884,935423
9138,33,State - TAMIL NADU,Total,8,Literate,535971,512543,1048514
9139,33,State - TAMIL NADU,Total,9,Literate,563683,532737,1096420
9140,33,State - TAMIL NADU,Total,10,Literate,645011,602274,1247285
9141,33,State - TAMIL NADU,Total,11,Literate,617194,575257,1192451
9142,33,State - TAMIL NADU,Total,12,Literate,613463,573471,1186934
9143,33,State - TAMIL NADU,Total,13,Literate,626441,590510,1216951
9144,33,State - TAMIL NADU,Total,14,Literate,625378,579153,1204531
9145,33,State - TAMIL NADU,Total,15,Literate,651930,600892,1252822
9146,33,State - TAMIL NADU,Total,16,Literate,600382,554101,1154483
9147,33,State - TAMIL NADU,Total,17,Literate,611675,558153,1169828
9148,33,State - TAMIL NADU,Total,18,Literate,667321,619957,1287278
9149,33,State - TAMIL NADU,Total,19,Literate,631945,601189,1233134
9150,33,State - TAMIL NADU,Total,20-24,Literate,3040096,3031981,6072077
9151,33,State - TAMIL NADU,Total,25-29,Literate,3035873,2981993,6017866
9152,33,State - TAMIL NADU,Total,30-34,Literate,2657780,2334895,4992675
9153,33,State - TAMIL NADU,Total,35-39,Literate,2431439,2089730,4521169
9154,33,State - TAMIL NADU,Total,40-44,Literate,2091513,1586971,3678484
9155,33,State - TAMIL NADU,Total,45-49,Literate,1857031,1334558,3191589
9156,33,State - TAMIL NADU,Total,50-54,Literate,1449177,976088,2425265
9157,33,State - TAMIL NADU,Total,55-59,Literate,1168427,751804,1920231
9158,33,State - TAMIL NADU,Total,60-64,Literate,962418,555042,1517460
9159,33,State - TAMIL NADU,Total,65-69,Literate,590869,333986,924855
9160,33,State - TAMIL NADU,Total,70-74,Literate,430687,215903,646590
9161,33,State - TAMIL NADU,Total,75-79,Literate,225253,115254,340507
9162,33,State - TAMIL NADU,Total,80+,Literate,200692,111635,312327
9163,33,State - TAMIL NADU,Total,Age not stated,Literate,28303,22055,50358
9164,33,State - TAMIL NADU,Rural,All ages,Literate,13665839,10836356,24502195
9165,33,State - TAMIL NADU,Rural,0-6,Literate,0,0,0
9166,33,State - TAMIL NADU,Rural,7,Literate,255058,240991,496049
9167,33,State - TAMIL NADU,Rural,8,Literate,289979,276068,566047
9168,33,State - TAMIL NADU,Rural,9,Literate,304325,285182,589507
9169,33,State - TAMIL NADU,Rural,10,Literate,346820,321612,668432
9170,33,State - TAMIL NADU,Rural,11,Literate,329923,304560,634483
9171,33,State - TAMIL NADU,Rural,12,Literate,335421,308574,643995
9172,33,State - TAMIL NADU,Rural,13,Literate,339740,315942,655682
9173,33,State - TAMIL NADU,Rural,14,Literate,338711,308306,647017
9174,33,State - TAMIL NADU,Rural,15,Literate,356410,321899,678309
9175,33,State - TAMIL NADU,Rural,16,Literate,326939,293497,620436
9176,33,State - TAMIL NADU,Rural,17,Literate,334084,293756,627840
9177,33,State - TAMIL NADU,Rural,18,Literate,366218,327966,694184
9178,33,State - TAMIL NADU,Rural,19,Literate,340078,312285,652363
9179,33,State - TAMIL NADU,Rural,20-24,Literate,1585942,1503677,3089619
9180,33,State - TAMIL NADU,Rural,25-29,Literate,1520383,1400297,2920680
9181,33,State - TAMIL NADU,Rural,30-34,Literate,1250780,1009365,2260145
9182,33,State - TAMIL NADU,Rural,35-39,Literate,1111890,872912,1984802
9183,33,State - TAMIL NADU,Rural,40-44,Literate,921783,609718,1531501
9184,33,State - TAMIL NADU,Rural,45-49,Literate,820784,502824,1323608
9185,33,State - TAMIL NADU,Rural,50-54,Literate,619774,347141,966915
9186,33,State - TAMIL NADU,Rural,55-59,Literate,497781,260632,758413
9187,33,State - TAMIL NADU,Rural,60-64,Literate,420605,179300,599905
9188,33,State - TAMIL NADU,Rural,65-69,Literate,265139,105981,371120
9189,33,State - TAMIL NADU,Rural,70-74,Literate,190758,62824,253582
9190,33,State - TAMIL NADU,Rural,75-79,Literate,94796,30437,125233
9191,33,State - TAMIL NADU,Rural,80+,Literate,87084,29595,116679
9192,33,State - TAMIL NADU,Rural,Age not stated,Literate,14634,11015,25649
9193,33,State - TAMIL NADU,Urban,All ages,Literate,14374652,12960660,27335312
9194,33,State - TAMIL NADU,Urban,0-6,Literate,0,0,0
9195,33,State - TAMIL NADU,Urban,7,Literate,225481,213893,439374
9196,33,State - TAMIL NADU,Urban,8,Literate,245992,236475,482467
9197,33,State - TAMIL NADU,Urban,9,Literate,259358,247555,506913
9198,33,State - TAMIL NADU,Urban,10,Literate,298191,280662,578853
9199,33,State - TAMIL NADU,Urban,11,Literate,287271,270697,557968
9200,33,State - TAMIL NADU,Urban,12,Literate,278042,264897,542939
9201,33,State - TAMIL NADU,Urban,13,Literate,286701,274568,561269
9202,33,State - TAMIL NADU,Urban,14,Literate,286667,270847,557514
9203,33,State - TAMIL NADU,Urban,15,Literate,295520,278993,574513
9204,33,State - TAMIL NADU,Urban,16,Literate,273443,260604,534047
9205,33,State - TAMIL NADU,Urban,17,Literate,277591,264397,541988
9206,33,State - TAMIL NADU,Urban,18,Literate,301103,291991,593094
9207,33,State - TAMIL NADU,Urban,19,Literate,291867,288904,580771
9208,33,State - TAMIL NADU,Urban,20-24,Literate,1454154,1528304,2982458
9209,33,State - TAMIL NADU,Urban,25-29,Literate,1515490,1581696,3097186
9210,33,State - TAMIL NADU,Urban,30-34,Literate,1407000,1325530,2732530
9211,33,State - TAMIL NADU,Urban,35-39,Literate,1319549,1216818,2536367
9212,33,State - TAMIL NADU,Urban,40-44,Literate,1169730,977253,2146983
9213,33,State - TAMIL NADU,Urban,45-49,Literate,1036247,831734,1867981
9214,33,State - TAMIL NADU,Urban,50-54,Literate,829403,628947,1458350
9215,33,State - TAMIL NADU,Urban,55-59,Literate,670646,491172,1161818
9216,33,State - TAMIL NADU,Urban,60-64,Literate,541813,375742,917555
9217,33,State - TAMIL NADU,Urban,65-69,Literate,325730,228005,553735
9218,33,State - TAMIL NADU,Urban,70-74,Literate,239929,153079,393008
9219,33,State - TAMIL NADU,Urban,75-79,Literate,130457,84817,215274
9220,33,State - TAMIL NADU,Urban,80+,Literate,113608,82040,195648
9221,33,State - TAMIL NADU,Urban,Age not stated,Literate,13669,11040,24709
9222,34,State - PUDUCHERRY,Total,All ages,Literate,497378,459931,957309
9223,34,State - PUDUCHERRY,Total,0-6,Literate,0,0,0
9224,34,State - PUDUCHERRY,Total,7,Literate,8005,7693,15698
9225,34,State - PUDUCHERRY,Total,8,Literate,9080,8673,17753
9226,34,State - PUDUCHERRY,Total,9,Literate,9696,9333,19029
9227,34,State - PUDUCHERRY,Total,10,Literate,10919,10545,21464
9228,34,State - PUDUCHERRY,Total,11,Literate,10778,10330,21108
9229,34,State - PUDUCHERRY,Total,12,Literate,10133,9800,19933
9230,34,State - PUDUCHERRY,Total,13,Literate,10553,10042,20595
9231,34,State - PUDUCHERRY,Total,14,Literate,10354,9935,20289
9232,34,State - PUDUCHERRY,Total,15,Literate,10668,9952,20620
9233,34,State - PUDUCHERRY,Total,16,Literate,9834,9320,19154
9234,34,State - PUDUCHERRY,Total,17,Literate,9981,9261,19242
9235,34,State - PUDUCHERRY,Total,18,Literate,10528,10325,20853
9236,34,State - PUDUCHERRY,Total,19,Literate,10417,10290,20707
9237,34,State - PUDUCHERRY,Total,20-24,Literate,49931,55325,105256
9238,34,State - PUDUCHERRY,Total,25-29,Literate,52839,58907,111746
9239,34,State - PUDUCHERRY,Total,30-34,Literate,50702,51066,101768
9240,34,State - PUDUCHERRY,Total,35-39,Literate,48307,44475,92782
9241,34,State - PUDUCHERRY,Total,40-44,Literate,40689,33234,73923
9242,34,State - PUDUCHERRY,Total,45-49,Literate,35418,26567,61985
9243,34,State - PUDUCHERRY,Total,50-54,Literate,26745,20121,46866
9244,34,State - PUDUCHERRY,Total,55-59,Literate,20896,15509,36405
9245,34,State - PUDUCHERRY,Total,60-64,Literate,16501,11775,28276
9246,34,State - PUDUCHERRY,Total,65-69,Literate,9190,6768,15958
9247,34,State - PUDUCHERRY,Total,70-74,Literate,7186,4830,12016
9248,34,State - PUDUCHERRY,Total,75-79,Literate,3936,2815,6751
9249,34,State - PUDUCHERRY,Total,80+,Literate,3649,2683,6332
9250,34,State - PUDUCHERRY,Total,Age not stated,Literate,443,357,800
9251,34,State - PUDUCHERRY,Rural,All ages,Literate,150490,130392,280882
9252,34,State - PUDUCHERRY,Rural,0-6,Literate,0,0,0
9253,34,State - PUDUCHERRY,Rural,7,Literate,2456,2494,4950
9254,34,State - PUDUCHERRY,Rural,8,Literate,2971,2780,5751
9255,34,State - PUDUCHERRY,Rural,9,Literate,3188,3086,6274
9256,34,State - PUDUCHERRY,Rural,10,Literate,3550,3520,7070
9257,34,State - PUDUCHERRY,Rural,11,Literate,3604,3424,7028
9258,34,State - PUDUCHERRY,Rural,12,Literate,3402,3287,6689
9259,34,State - PUDUCHERRY,Rural,13,Literate,3528,3422,6950
9260,34,State - PUDUCHERRY,Rural,14,Literate,3454,3253,6707
9261,34,State - PUDUCHERRY,Rural,15,Literate,3473,3339,6812
9262,34,State - PUDUCHERRY,Rural,16,Literate,3228,3068,6296
9263,34,State - PUDUCHERRY,Rural,17,Literate,3300,2978,6278
9264,34,State - PUDUCHERRY,Rural,18,Literate,3555,3474,7029
9265,34,State - PUDUCHERRY,Rural,19,Literate,3575,3429,7004
9266,34,State - PUDUCHERRY,Rural,20-24,Literate,16698,18288,34986
9267,34,State - PUDUCHERRY,Rural,25-29,Literate,17696,18657,36353
9268,34,State - PUDUCHERRY,Rural,30-34,Literate,15774,14543,30317
9269,34,State - PUDUCHERRY,Rural,35-39,Literate,14377,11900,26277
9270,34,State - PUDUCHERRY,Rural,40-44,Literate,11225,7763,18988
9271,34,State - PUDUCHERRY,Rural,45-49,Literate,9712,5826,15538
9272,34,State - PUDUCHERRY,Rural,50-54,Literate,6760,3960,10720
9273,34,State - PUDUCHERRY,Rural,55-59,Literate,5177,3051,8228
9274,34,State - PUDUCHERRY,Rural,60-64,Literate,3912,2067,5979
9275,34,State - PUDUCHERRY,Rural,65-69,Literate,2212,1169,3381
9276,34,State - PUDUCHERRY,Rural,70-74,Literate,1726,687,2413
9277,34,State - PUDUCHERRY,Rural,75-79,Literate,851,396,1247
9278,34,State - PUDUCHERRY,Rural,80+,Literate,893,379,1272
9279,34,State - PUDUCHERRY,Rural,Age not stated,Literate,193,152,345
9280,34,State - PUDUCHERRY,Urban,All ages,Literate,346888,329539,676427
9281,34,State - PUDUCHERRY,Urban,0-6,Literate,0,0,0
9282,34,State - PUDUCHERRY,Urban,7,Literate,5549,5199,10748
9283,34,State - PUDUCHERRY,Urban,8,Literate,6109,5893,12002
9284,34,State - PUDUCHERRY,Urban,9,Literate,6508,6247,12755
9285,34,State - PUDUCHERRY,Urban,10,Literate,7369,7025,14394
9286,34,State - PUDUCHERRY,Urban,11,Literate,7174,6906,14080
9287,34,State - PUDUCHERRY,Urban,12,Literate,6731,6513,13244
9288,34,State - PUDUCHERRY,Urban,13,Literate,7025,6620,13645
9289,34,State - PUDUCHERRY,Urban,14,Literate,6900,6682,13582
9290,34,State - PUDUCHERRY,Urban,15,Literate,7195,6613,13808
9291,34,State - PUDUCHERRY,Urban,16,Literate,6606,6252,12858
9292,34,State - PUDUCHERRY,Urban,17,Literate,6681,6283,12964
9293,34,State - PUDUCHERRY,Urban,18,Literate,6973,6851,13824
9294,34,State - PUDUCHERRY,Urban,19,Literate,6842,6861,13703
9295,34,State - PUDUCHERRY,Urban,20-24,Literate,33233,37037,70270
9296,34,State - PUDUCHERRY,Urban,25-29,Literate,35143,40250,75393
9297,34,State - PUDUCHERRY,Urban,30-34,Literate,34928,36523,71451
9298,34,State - PUDUCHERRY,Urban,35-39,Literate,33930,32575,66505
9299,34,State - PUDUCHERRY,Urban,40-44,Literate,29464,25471,54935
9300,34,State - PUDUCHERRY,Urban,45-49,Literate,25706,20741,46447
9301,34,State - PUDUCHERRY,Urban,50-54,Literate,19985,16161,36146
9302,34,State - PUDUCHERRY,Urban,55-59,Literate,15719,12458,28177
9303,34,State - PUDUCHERRY,Urban,60-64,Literate,12589,9708,22297
9304,34,State - PUDUCHERRY,Urban,65-69,Literate,6978,5599,12577
9305,34,State - PUDUCHERRY,Urban,70-74,Literate,5460,4143,9603
9306,34,State - PUDUCHERRY,Urban,75-79,Literate,3085,2419,5504
9307,34,State - PUDUCHERRY,Urban,80+,Literate,2756,2304,5060
9308,34,State - PUDUCHERRY,Urban,Age not stated,Literate,250,205,455
9309,35,State - ANDAMAN & NICOBAR ISLANDS,Total,All ages,Literate,164377,129904,294281
9310,35,State - ANDAMAN & NICOBAR ISLANDS,Total,0-6,Literate,0,0,0
9311,35,State - ANDAMAN & NICOBAR ISLANDS,Total,7,Literate,2663,2529,5192
9312,35,State - ANDAMAN & NICOBAR ISLANDS,Total,8,Literate,2914,2722,5636
9313,35,State - ANDAMAN & NICOBAR ISLANDS,Total,9,Literate,2967,2916,5883
9314,35,State - ANDAMAN & NICOBAR ISLANDS,Total,10,Literate,3454,3315,6769
9315,35,State - ANDAMAN & NICOBAR ISLANDS,Total,11,Literate,3399,3342,6741
9316,35,State - ANDAMAN & NICOBAR ISLANDS,Total,12,Literate,3226,3165,6391
9317,35,State - ANDAMAN & NICOBAR ISLANDS,Total,13,Literate,3329,3085,6414
9318,35,State - ANDAMAN & NICOBAR ISLANDS,Total,14,Literate,3332,3096,6428
9319,35,State - ANDAMAN & NICOBAR ISLANDS,Total,15,Literate,3426,3187,6613
9320,35,State - ANDAMAN & NICOBAR ISLANDS,Total,16,Literate,3349,3053,6402
9321,35,State - ANDAMAN & NICOBAR ISLANDS,Total,17,Literate,3355,2944,6299
9322,35,State - ANDAMAN & NICOBAR ISLANDS,Total,18,Literate,3498,3190,6688
9323,35,State - ANDAMAN & NICOBAR ISLANDS,Total,19,Literate,3294,3038,6332
9324,35,State - ANDAMAN & NICOBAR ISLANDS,Total,20-24,Literate,18793,16672,35465
9325,35,State - ANDAMAN & NICOBAR ISLANDS,Total,25-29,Literate,21179,17924,39103
9326,35,State - ANDAMAN & NICOBAR ISLANDS,Total,30-34,Literate,18247,14659,32906
9327,35,State - ANDAMAN & NICOBAR ISLANDS,Total,35-39,Literate,15725,13036,28761
9328,35,State - ANDAMAN & NICOBAR ISLANDS,Total,40-44,Literate,13001,8883,21884
9329,35,State - ANDAMAN & NICOBAR ISLANDS,Total,45-49,Literate,11230,7066,18296
9330,35,State - ANDAMAN & NICOBAR ISLANDS,Total,50-54,Literate,7920,4592,12512
9331,35,State - ANDAMAN & NICOBAR ISLANDS,Total,55-59,Literate,6206,3216,9422
9332,35,State - ANDAMAN & NICOBAR ISLANDS,Total,60-64,Literate,4178,1941,6119
9333,35,State - ANDAMAN & NICOBAR ISLANDS,Total,65-69,Literate,2339,1062,3401
9334,35,State - ANDAMAN & NICOBAR ISLANDS,Total,70-74,Literate,1573,527,2100
9335,35,State - ANDAMAN & NICOBAR ISLANDS,Total,75-79,Literate,839,298,1137
9336,35,State - ANDAMAN & NICOBAR ISLANDS,Total,80+,Literate,772,321,1093
9337,35,State - ANDAMAN & NICOBAR ISLANDS,Total,Age not stated,Literate,169,125,294
9338,35,State - ANDAMAN & NICOBAR ISLANDS,Rural,All ages,Literate,99960,78065,178025
9339,35,State - ANDAMAN & NICOBAR ISLANDS,Rural,0-6,Literate,0,0,0
9340,35,State - ANDAMAN & NICOBAR ISLANDS,Rural,7,Literate,1650,1499,3149
9341,35,State - ANDAMAN & NICOBAR ISLANDS,Rural,8,Literate,1814,1676,3490
9342,35,State - ANDAMAN & NICOBAR ISLANDS,Rural,9,Literate,1850,1824,3674
9343,35,State - ANDAMAN & NICOBAR ISLANDS,Rural,10,Literate,2172,2071,4243
9344,35,State - ANDAMAN & NICOBAR ISLANDS,Rural,11,Literate,2084,2149,4233
9345,35,State - ANDAMAN & NICOBAR ISLANDS,Rural,12,Literate,2007,2028,4035
9346,35,State - ANDAMAN & NICOBAR ISLANDS,Rural,13,Literate,2091,2023,4114
9347,35,State - ANDAMAN & NICOBAR ISLANDS,Rural,14,Literate,2115,1972,4087
9348,35,State - ANDAMAN & NICOBAR ISLANDS,Rural,15,Literate,2136,1956,4092
9349,35,State - ANDAMAN & NICOBAR ISLANDS,Rural,16,Literate,2075,1867,3942
9350,35,State - ANDAMAN & NICOBAR ISLANDS,Rural,17,Literate,2043,1803,3846
9351,35,State - ANDAMAN & NICOBAR ISLANDS,Rural,18,Literate,2175,1990,4165
9352,35,State - ANDAMAN & NICOBAR ISLANDS,Rural,19,Literate,1997,1867,3864
9353,35,State - ANDAMAN & NICOBAR ISLANDS,Rural,20-24,Literate,11167,10246,21413
9354,35,State - ANDAMAN & NICOBAR ISLANDS,Rural,25-29,Literate,12993,10821,23814
9355,35,State - ANDAMAN & NICOBAR ISLANDS,Rural,30-34,Literate,11210,8740,19950
9356,35,State - ANDAMAN & NICOBAR ISLANDS,Rural,35-39,Literate,9462,7653,17115
9357,35,State - ANDAMAN & NICOBAR ISLANDS,Rural,40-44,Literate,7646,4963,12609
9358,35,State - ANDAMAN & NICOBAR ISLANDS,Rural,45-49,Literate,6516,3995,10511
9359,35,State - ANDAMAN & NICOBAR ISLANDS,Rural,50-54,Literate,4660,2560,7220
9360,35,State - ANDAMAN & NICOBAR ISLANDS,Rural,55-59,Literate,3622,1828,5450
9361,35,State - ANDAMAN & NICOBAR ISLANDS,Rural,60-64,Literate,2657,1187,3844
9362,35,State - ANDAMAN & NICOBAR ISLANDS,Rural,65-69,Literate,1581,649,2230
9363,35,State - ANDAMAN & NICOBAR ISLANDS,Rural,70-74,Literate,1022,304,1326
9364,35,State - ANDAMAN & NICOBAR ISLANDS,Rural,75-79,Literate,576,150,726
9365,35,State - ANDAMAN & NICOBAR ISLANDS,Rural,80+,Literate,553,188,741
9366,35,State - ANDAMAN & NICOBAR ISLANDS,Rural,Age not stated,Literate,86,56,142
9367,35,State - ANDAMAN & NICOBAR ISLANDS,Urban,All ages,Literate,64417,51839,116256
9368,35,State - ANDAMAN & NICOBAR ISLANDS,Urban,0-6,Literate,0,0,0
9369,35,State - ANDAMAN & NICOBAR ISLANDS,Urban,7,Literate,1013,1030,2043
9370,35,State - ANDAMAN & NICOBAR ISLANDS,Urban,8,Literate,1100,1046,2146
9371,35,State - ANDAMAN & NICOBAR ISLANDS,Urban,9,Literate,1117,1092,2209
9372,35,State - ANDAMAN & NICOBAR ISLANDS,Urban,10,Literate,1282,1244,2526
9373,35,State - ANDAMAN & NICOBAR ISLANDS,Urban,11,Literate,1315,1193,2508
9374,35,State - ANDAMAN & NICOBAR ISLANDS,Urban,12,Literate,1219,1137,2356
9375,35,State - ANDAMAN & NICOBAR ISLANDS,Urban,13,Literate,1238,1062,2300
9376,35,State - ANDAMAN & NICOBAR ISLANDS,Urban,14,Literate,1217,1124,2341
9377,35,State - ANDAMAN & NICOBAR ISLANDS,Urban,15,Literate,1290,1231,2521
9378,35,State - ANDAMAN & NICOBAR ISLANDS,Urban,16,Literate,1274,1186,2460
9379,35,State - ANDAMAN & NICOBAR ISLANDS,Urban,17,Literate,1312,1141,2453
9380,35,State - ANDAMAN & NICOBAR ISLANDS,Urban,18,Literate,1323,1200,2523
9381,35,State - ANDAMAN & NICOBAR ISLANDS,Urban,19,Literate,1297,1171,2468
9382,35,State - ANDAMAN & NICOBAR ISLANDS,Urban,20-24,Literate,7626,6426,14052
9383,35,State - ANDAMAN & NICOBAR ISLANDS,Urban,25-29,Literate,8186,7103,15289
9384,35,State - ANDAMAN & NICOBAR ISLANDS,Urban,30-34,Literate,7037,5919,12956
9385,35,State - ANDAMAN & NICOBAR ISLANDS,Urban,35-39,Literate,6263,5383,11646
9386,35,State - ANDAMAN & NICOBAR ISLANDS,Urban,40-44,Literate,5355,3920,9275
9387,35,State - ANDAMAN & NICOBAR ISLANDS,Urban,45-49,Literate,4714,3071,7785
9388,35,State - ANDAMAN & NICOBAR ISLANDS,Urban,50-54,Literate,3260,2032,5292
9389,35,State - ANDAMAN & NICOBAR ISLANDS,Urban,55-59,Literate,2584,1388,3972
9390,35,State - ANDAMAN & NICOBAR ISLANDS,Urban,60-64,Literate,1521,754,2275
9391,35,State - ANDAMAN & NICOBAR ISLANDS,Urban,65-69,Literate,758,413,1171
9392,35,State - ANDAMAN & NICOBAR ISLANDS,Urban,70-74,Literate,551,223,774
9393,35,State - ANDAMAN & NICOBAR ISLANDS,Urban,75-79,Literate,263,148,411
9394,35,State - ANDAMAN & NICOBAR ISLANDS,Urban,80+,Literate,219,133,352
9395,35,State - ANDAMAN & NICOBAR ISLANDS,Urban,Age not stated,Literate,83,69,152
9396,0,INDIA,Total,All ages,Literate with No Education,19278416,15874815,35153231
9397,0,INDIA,Total,0-6,Literate with No Education,0,0,0
9398,0,INDIA,Total,7,Literate with No Education,248229,175976,424205
9399,0,INDIA,Total,8,Literate with No Education,202220,149060,351280
9400,0,INDIA,Total,9,Literate with No Education,167048,124233,291281
9401,0,INDIA,Total,10,Literate with No Education,224853,163861,388714
9402,0,INDIA,Total,11,Literate with No Education,174586,131798,306384
9403,0,INDIA,Total,12,Literate with No Education,200632,155461,356093
9404,0,INDIA,Total,13,Literate with No Education,175409,143844,319253
9405,0,INDIA,Total,14,Literate with No Education,207650,171719,379369
9406,0,INDIA,Total,15,Literate with No Education,258954,205692,464646
9407,0,INDIA,Total,16,Literate with No Education,277973,225155,503128
9408,0,INDIA,Total,17,Literate with No Education,274115,221247,495362
9409,0,INDIA,Total,18,Literate with No Education,436615,354474,791089
9410,0,INDIA,Total,19,Literate with No Education,343463,306552,650015
9411,0,INDIA,Total,20-24,Literate with No Education,2207378,1940027,4147405
9412,0,INDIA,Total,25-29,Literate with No Education,2422465,2107396,4529861
9413,0,INDIA,Total,30-34,Literate with No Education,2048723,1776635,3825358
9414,0,INDIA,Total,35-39,Literate with No Education,1919984,1636630,3556614
9415,0,INDIA,Total,40-44,Literate with No Education,1629614,1298297,2927911
9416,0,INDIA,Total,45-49,Literate with No Education,1370272,1093326,2463598
9417,0,INDIA,Total,50-54,Literate with No Education,1084287,822893,1907180
9418,0,INDIA,Total,55-59,Literate with No Education,820129,672356,1492485
9419,0,INDIA,Total,60-64,Literate with No Education,773664,616058,1389722
9420,0,INDIA,Total,65-69,Literate with No Education,545793,441179,986972
9421,0,INDIA,Total,70-74,Literate with No Education,403035,310487,713522
9422,0,INDIA,Total,75-79,Literate with No Education,196435,164475,360910
9423,0,INDIA,Total,80+,Literate with No Education,244450,215069,459519
9424,0,INDIA,Total,Age not stated,Literate with No Education,420440,250915,671355
9425,0,INDIA,Rural,All ages,Literate with No Education,12879121,10025495,22904616
9426,0,INDIA,Rural,0-6,Literate with No Education,0,0,0
9427,0,INDIA,Rural,7,Literate with No Education,174459,123652,298111
9428,0,INDIA,Rural,8,Literate with No Education,147111,109511,256622
9429,0,INDIA,Rural,9,Literate with No Education,118391,88917,207308
9430,0,INDIA,Rural,10,Literate with No Education,161787,119018,280805
9431,0,INDIA,Rural,11,Literate with No Education,123029,94005,217034
9432,0,INDIA,Rural,12,Literate with No Education,146219,115188,261407
9433,0,INDIA,Rural,13,Literate with No Education,126132,105637,231769
9434,0,INDIA,Rural,14,Literate with No Education,150989,127141,278130
9435,0,INDIA,Rural,15,Literate with No Education,191553,154301,345854
9436,0,INDIA,Rural,16,Literate with No Education,204689,167731,372420
9437,0,INDIA,Rural,17,Literate with No Education,194672,159029,353701
9438,0,INDIA,Rural,18,Literate with No Education,315396,258483,573879
9439,0,INDIA,Rural,19,Literate with No Education,235359,214328,449687
9440,0,INDIA,Rural,20-24,Literate with No Education,1499010,1289432,2788442
9441,0,INDIA,Rural,25-29,Literate with No Education,1581292,1315404,2896696
9442,0,INDIA,Rural,30-34,Literate with No Education,1332435,1101985,2434420
9443,0,INDIA,Rural,35-39,Literate with No Education,1258690,998985,2257675
9444,0,INDIA,Rural,40-44,Literate with No Education,1062412,775514,1837926
9445,0,INDIA,Rural,45-49,Literate with No Education,885498,636961,1522459
9446,0,INDIA,Rural,50-54,Literate with No Education,696430,472427,1168857
9447,0,INDIA,Rural,55-59,Literate with No Education,524111,391758,915869
9448,0,INDIA,Rural,60-64,Literate with No Education,523285,373014,896299
9449,0,INDIA,Rural,65-69,Literate with No Education,380604,273794,654398
9450,0,INDIA,Rural,70-74,Literate with No Education,282595,188479,471074
9451,0,INDIA,Rural,75-79,Literate with No Education,132687,94542,227229
9452,0,INDIA,Rural,80+,Literate with No Education,166639,123286,289925
9453,0,INDIA,Rural,Age not stated,Literate with No Education,263647,152973,416620
9454,0,INDIA,Urban,All ages,Literate with No Education,6399295,5849320,12248615
9455,0,INDIA,Urban,0-6,Literate with No Education,0,0,0
9456,0,INDIA,Urban,7,Literate with No Education,73770,52324,126094
9457,0,INDIA,Urban,8,Literate with No Education,55109,39549,94658
9458,0,INDIA,Urban,9,Literate with No Education,48657,35316,83973
9459,0,INDIA,Urban,10,Literate with No Education,63066,44843,107909
9460,0,INDIA,Urban,11,Literate with No Education,51557,37793,89350
9461,0,INDIA,Urban,12,Literate with No Education,54413,40273,94686
9462,0,INDIA,Urban,13,Literate with No Education,49277,38207,87484
9463,0,INDIA,Urban,14,Literate with No Education,56661,44578,101239
9464,0,INDIA,Urban,15,Literate with No Education,67401,51391,118792
9465,0,INDIA,Urban,16,Literate with No Education,73284,57424,130708
9466,0,INDIA,Urban,17,Literate with No Education,79443,62218,141661
9467,0,INDIA,Urban,18,Literate with No Education,121219,95991,217210
9468,0,INDIA,Urban,19,Literate with No Education,108104,92224,200328
9469,0,INDIA,Urban,20-24,Literate with No Education,708368,650595,1358963
9470,0,INDIA,Urban,25-29,Literate with No Education,841173,791992,1633165
9471,0,INDIA,Urban,30-34,Literate with No Education,716288,674650,1390938
9472,0,INDIA,Urban,35-39,Literate with No Education,661294,637645,1298939
9473,0,INDIA,Urban,40-44,Literate with No Education,567202,522783,1089985
9474,0,INDIA,Urban,45-49,Literate with No Education,484774,456365,941139
9475,0,INDIA,Urban,50-54,Literate with No Education,387857,350466,738323
9476,0,INDIA,Urban,55-59,Literate with No Education,296018,280598,576616
9477,0,INDIA,Urban,60-64,Literate with No Education,250379,243044,493423
9478,0,INDIA,Urban,65-69,Literate with No Education,165189,167385,332574
9479,0,INDIA,Urban,70-74,Literate with No Education,120440,122008,242448
9480,0,INDIA,Urban,75-79,Literate with No Education,63748,69933,133681
9481,0,INDIA,Urban,80+,Literate with No Education,77811,91783,169594
9482,0,INDIA,Urban,Age not stated,Literate with No Education,156793,97942,254735
9483,1,State - JAMMU & KASHMIR,Total,All ages,Literate with No Education,124009,71774,195783
9484,1,State - JAMMU & KASHMIR,Total,0-6,Literate with No Education,0,0,0
9485,1,State - JAMMU & KASHMIR,Total,7,Literate with No Education,2216,1354,3570
9486,1,State - JAMMU & KASHMIR,Total,8,Literate with No Education,1683,1021,2704
9487,1,State - JAMMU & KASHMIR,Total,9,Literate with No Education,1460,879,2339
9488,1,State - JAMMU & KASHMIR,Total,10,Literate with No Education,1942,1180,3122
9489,1,State - JAMMU & KASHMIR,Total,11,Literate with No Education,1596,952,2548
9490,1,State - JAMMU & KASHMIR,Total,12,Literate with No Education,1551,950,2501
9491,1,State - JAMMU & KASHMIR,Total,13,Literate with No Education,1362,778,2140
9492,1,State - JAMMU & KASHMIR,Total,14,Literate with No Education,1323,909,2232
9493,1,State - JAMMU & KASHMIR,Total,15,Literate with No Education,1334,919,2253
9494,1,State - JAMMU & KASHMIR,Total,16,Literate with No Education,1286,927,2213
9495,1,State - JAMMU & KASHMIR,Total,17,Literate with No Education,1166,852,2018
9496,1,State - JAMMU & KASHMIR,Total,18,Literate with No Education,1735,1362,3097
9497,1,State - JAMMU & KASHMIR,Total,19,Literate with No Education,1395,1032,2427
9498,1,State - JAMMU & KASHMIR,Total,20-24,Literate with No Education,11961,8018,19979
9499,1,State - JAMMU & KASHMIR,Total,25-29,Literate with No Education,19990,10538,30528
9500,1,State - JAMMU & KASHMIR,Total,30-34,Literate with No Education,15836,8513,24349
9501,1,State - JAMMU & KASHMIR,Total,35-39,Literate with No Education,12627,7232,19859
9502,1,State - JAMMU & KASHMIR,Total,40-44,Literate with No Education,10910,5522,16432
9503,1,State - JAMMU & KASHMIR,Total,45-49,Literate with No Education,7965,4586,12551
9504,1,State - JAMMU & KASHMIR,Total,50-54,Literate with No Education,5921,3368,9289
9505,1,State - JAMMU & KASHMIR,Total,55-59,Literate with No Education,3905,2614,6519
9506,1,State - JAMMU & KASHMIR,Total,60-64,Literate with No Education,3704,2225,5929
9507,1,State - JAMMU & KASHMIR,Total,65-69,Literate with No Education,2307,1611,3918
9508,1,State - JAMMU & KASHMIR,Total,70-74,Literate with No Education,2183,1503,3686
9509,1,State - JAMMU & KASHMIR,Total,75-79,Literate with No Education,1078,839,1917
9510,1,State - JAMMU & KASHMIR,Total,80+,Literate with No Education,1732,1274,3006
9511,1,State - JAMMU & KASHMIR,Total,Age not stated,Literate with No Education,3841,816,4657
9512,1,State - JAMMU & KASHMIR,Rural,All ages,Literate with No Education,71510,42729,114239
9513,1,State - JAMMU & KASHMIR,Rural,0-6,Literate with No Education,0,0,0
9514,1,State - JAMMU & KASHMIR,Rural,7,Literate with No Education,1603,952,2555
9515,1,State - JAMMU & KASHMIR,Rural,8,Literate with No Education,1222,737,1959
9516,1,State - JAMMU & KASHMIR,Rural,9,Literate with No Education,1033,601,1634
9517,1,State - JAMMU & KASHMIR,Rural,10,Literate with No Education,1303,838,2141
9518,1,State - JAMMU & KASHMIR,Rural,11,Literate with No Education,1113,713,1826
9519,1,State - JAMMU & KASHMIR,Rural,12,Literate with No Education,1013,713,1726
9520,1,State - JAMMU & KASHMIR,Rural,13,Literate with No Education,893,581,1474
9521,1,State - JAMMU & KASHMIR,Rural,14,Literate with No Education,868,650,1518
9522,1,State - JAMMU & KASHMIR,Rural,15,Literate with No Education,886,692,1578
9523,1,State - JAMMU & KASHMIR,Rural,16,Literate with No Education,860,681,1541
9524,1,State - JAMMU & KASHMIR,Rural,17,Literate with No Education,808,625,1433
9525,1,State - JAMMU & KASHMIR,Rural,18,Literate with No Education,1190,1016,2206
9526,1,State - JAMMU & KASHMIR,Rural,19,Literate with No Education,954,750,1704
9527,1,State - JAMMU & KASHMIR,Rural,20-24,Literate with No Education,7307,5347,12654
9528,1,State - JAMMU & KASHMIR,Rural,25-29,Literate with No Education,10348,6135,16483
9529,1,State - JAMMU & KASHMIR,Rural,30-34,Literate with No Education,8379,4803,13182
9530,1,State - JAMMU & KASHMIR,Rural,35-39,Literate with No Education,6563,3925,10488
9531,1,State - JAMMU & KASHMIR,Rural,40-44,Literate with No Education,5809,2974,8783
9532,1,State - JAMMU & KASHMIR,Rural,45-49,Literate with No Education,4269,2376,6645
9533,1,State - JAMMU & KASHMIR,Rural,50-54,Literate with No Education,3479,1726,5205
9534,1,State - JAMMU & KASHMIR,Rural,55-59,Literate with No Education,2244,1280,3524
9535,1,State - JAMMU & KASHMIR,Rural,60-64,Literate with No Education,2250,1205,3455
9536,1,State - JAMMU & KASHMIR,Rural,65-69,Literate with No Education,1379,861,2240
9537,1,State - JAMMU & KASHMIR,Rural,70-74,Literate with No Education,1410,789,2199
9538,1,State - JAMMU & KASHMIR,Rural,75-79,Literate with No Education,682,429,1111
9539,1,State - JAMMU & KASHMIR,Rural,80+,Literate with No Education,1140,745,1885
9540,1,State - JAMMU & KASHMIR,Rural,Age not stated,Literate with No Education,2505,585,3090
9541,1,State - JAMMU & KASHMIR,Urban,All ages,Literate with No Education,52499,29045,81544
9542,1,State - JAMMU & KASHMIR,Urban,0-6,Literate with No Education,0,0,0
9543,1,State - JAMMU & KASHMIR,Urban,7,Literate with No Education,613,402,1015
9544,1,State - JAMMU & KASHMIR,Urban,8,Literate with No Education,461,284,745
9545,1,State - JAMMU & KASHMIR,Urban,9,Literate with No Education,427,278,705
9546,1,State - JAMMU & KASHMIR,Urban,10,Literate with No Education,639,342,981
9547,1,State - JAMMU & KASHMIR,Urban,11,Literate with No Education,483,239,722
9548,1,State - JAMMU & KASHMIR,Urban,12,Literate with No Education,538,237,775
9549,1,State - JAMMU & KASHMIR,Urban,13,Literate with No Education,469,197,666
9550,1,State - JAMMU & KASHMIR,Urban,14,Literate with No Education,455,259,714
9551,1,State - JAMMU & KASHMIR,Urban,15,Literate with No Education,448,227,675
9552,1,State - JAMMU & KASHMIR,Urban,16,Literate with No Education,426,246,672
9553,1,State - JAMMU & KASHMIR,Urban,17,Literate with No Education,358,227,585
9554,1,State - JAMMU & KASHMIR,Urban,18,Literate with No Education,545,346,891
9555,1,State - JAMMU & KASHMIR,Urban,19,Literate with No Education,441,282,723
9556,1,State - JAMMU & KASHMIR,Urban,20-24,Literate with No Education,4654,2671,7325
9557,1,State - JAMMU & KASHMIR,Urban,25-29,Literate with No Education,9642,4403,14045
9558,1,State - JAMMU & KASHMIR,Urban,30-34,Literate with No Education,7457,3710,11167
9559,1,State - JAMMU & KASHMIR,Urban,35-39,Literate with No Education,6064,3307,9371
9560,1,State - JAMMU & KASHMIR,Urban,40-44,Literate with No Education,5101,2548,7649
9561,1,State - JAMMU & KASHMIR,Urban,45-49,Literate with No Education,3696,2210,5906
9562,1,State - JAMMU & KASHMIR,Urban,50-54,Literate with No Education,2442,1642,4084
9563,1,State - JAMMU & KASHMIR,Urban,55-59,Literate with No Education,1661,1334,2995
9564,1,State - JAMMU & KASHMIR,Urban,60-64,Literate with No Education,1454,1020,2474
9565,1,State - JAMMU & KASHMIR,Urban,65-69,Literate with No Education,928,750,1678
9566,1,State - JAMMU & KASHMIR,Urban,70-74,Literate with No Education,773,714,1487
9567,1,State - JAMMU & KASHMIR,Urban,75-79,Literate with No Education,396,410,806
9568,1,State - JAMMU & KASHMIR,Urban,80+,Literate with No Education,592,529,1121
9569,1,State - JAMMU & KASHMIR,Urban,Age not stated,Literate with No Education,1336,231,1567
9570,2,State - HIMACHAL PRADESH,Total,All ages,Literate with No Education,64537,65486,130023
9571,2,State - HIMACHAL PRADESH,Total,0-6,Literate with No Education,0,0,0
9572,2,State - HIMACHAL PRADESH,Total,7,Literate with No Education,576,461,1037
9573,2,State - HIMACHAL PRADESH,Total,8,Literate with No Education,360,290,650
9574,2,State - HIMACHAL PRADESH,Total,9,Literate with No Education,379,326,705
9575,2,State - HIMACHAL PRADESH,Total,10,Literate with No Education,426,367,793
9576,2,State - HIMACHAL PRADESH,Total,11,Literate with No Education,420,367,787
9577,2,State - HIMACHAL PRADESH,Total,12,Literate with No Education,410,293,703
9578,2,State - HIMACHAL PRADESH,Total,13,Literate with No Education,374,304,678
9579,2,State - HIMACHAL PRADESH,Total,14,Literate with No Education,383,323,706
9580,2,State - HIMACHAL PRADESH,Total,15,Literate with No Education,456,403,859
9581,2,State - HIMACHAL PRADESH,Total,16,Literate with No Education,495,446,941
9582,2,State - HIMACHAL PRADESH,Total,17,Literate with No Education,612,509,1121
9583,2,State - HIMACHAL PRADESH,Total,18,Literate with No Education,987,722,1709
9584,2,State - HIMACHAL PRADESH,Total,19,Literate with No Education,1064,869,1933
9585,2,State - HIMACHAL PRADESH,Total,20-24,Literate with No Education,7712,7146,14858
9586,2,State - HIMACHAL PRADESH,Total,25-29,Literate with No Education,8316,8527,16843
9587,2,State - HIMACHAL PRADESH,Total,30-34,Literate with No Education,7345,7753,15098
9588,2,State - HIMACHAL PRADESH,Total,35-39,Literate with No Education,6808,7173,13981
9589,2,State - HIMACHAL PRADESH,Total,40-44,Literate with No Education,5477,6023,11500
9590,2,State - HIMACHAL PRADESH,Total,45-49,Literate with No Education,4785,5481,10266
9591,2,State - HIMACHAL PRADESH,Total,50-54,Literate with No Education,3960,4542,8502
9592,2,State - HIMACHAL PRADESH,Total,55-59,Literate with No Education,3346,3573,6919
9593,2,State - HIMACHAL PRADESH,Total,60-64,Literate with No Education,2963,3154,6117
9594,2,State - HIMACHAL PRADESH,Total,65-69,Literate with No Education,2044,1996,4040
9595,2,State - HIMACHAL PRADESH,Total,70-74,Literate with No Education,1716,1716,3432
9596,2,State - HIMACHAL PRADESH,Total,75-79,Literate with No Education,1069,941,2010
9597,2,State - HIMACHAL PRADESH,Total,80+,Literate with No Education,1483,1425,2908
9598,2,State - HIMACHAL PRADESH,Total,Age not stated,Literate with No Education,571,356,927
9599,2,State - HIMACHAL PRADESH,Rural,All ages,Literate with No Education,58588,60033,118621
9600,2,State - HIMACHAL PRADESH,Rural,0-6,Literate with No Education,0,0,0
9601,2,State - HIMACHAL PRADESH,Rural,7,Literate with No Education,504,406,910
9602,2,State - HIMACHAL PRADESH,Rural,8,Literate with No Education,325,253,578
9603,2,State - HIMACHAL PRADESH,Rural,9,Literate with No Education,328,285,613
9604,2,State - HIMACHAL PRADESH,Rural,10,Literate with No Education,381,316,697
9605,2,State - HIMACHAL PRADESH,Rural,11,Literate with No Education,376,324,700
9606,2,State - HIMACHAL PRADESH,Rural,12,Literate with No Education,378,277,655
9607,2,State - HIMACHAL PRADESH,Rural,13,Literate with No Education,336,286,622
9608,2,State - HIMACHAL PRADESH,Rural,14,Literate with No Education,354,300,654
9609,2,State - HIMACHAL PRADESH,Rural,15,Literate with No Education,410,376,786
9610,2,State - HIMACHAL PRADESH,Rural,16,Literate with No Education,448,420,868
9611,2,State - HIMACHAL PRADESH,Rural,17,Literate with No Education,553,480,1033
9612,2,State - HIMACHAL PRADESH,Rural,18,Literate with No Education,866,674,1540
9613,2,State - HIMACHAL PRADESH,Rural,19,Literate with No Education,943,817,1760
9614,2,State - HIMACHAL PRADESH,Rural,20-24,Literate with No Education,6921,6568,13489
9615,2,State - HIMACHAL PRADESH,Rural,25-29,Literate with No Education,7438,7795,15233
9616,2,State - HIMACHAL PRADESH,Rural,30-34,Literate with No Education,6654,7131,13785
9617,2,State - HIMACHAL PRADESH,Rural,35-39,Literate with No Education,6160,6520,12680
9618,2,State - HIMACHAL PRADESH,Rural,40-44,Literate with No Education,4953,5496,10449
9619,2,State - HIMACHAL PRADESH,Rural,45-49,Literate with No Education,4352,5034,9386
9620,2,State - HIMACHAL PRADESH,Rural,50-54,Literate with No Education,3616,4130,7746
9621,2,State - HIMACHAL PRADESH,Rural,55-59,Literate with No Education,3081,3296,6377
9622,2,State - HIMACHAL PRADESH,Rural,60-64,Literate with No Education,2778,2924,5702
9623,2,State - HIMACHAL PRADESH,Rural,65-69,Literate with No Education,1918,1845,3763
9624,2,State - HIMACHAL PRADESH,Rural,70-74,Literate with No Education,1619,1574,3193
9625,2,State - HIMACHAL PRADESH,Rural,75-79,Literate with No Education,1003,868,1871
9626,2,State - HIMACHAL PRADESH,Rural,80+,Literate with No Education,1391,1316,2707
9627,2,State - HIMACHAL PRADESH,Rural,Age not stated,Literate with No Education,502,322,824
9628,2,State - HIMACHAL PRADESH,Urban,All ages,Literate with No Education,5949,5453,11402
9629,2,State - HIMACHAL PRADESH,Urban,0-6,Literate with No Education,0,0,0
9630,2,State - HIMACHAL PRADESH,Urban,7,Literate with No Education,72,55,127
9631,2,State - HIMACHAL PRADESH,Urban,8,Literate with No Education,35,37,72
9632,2,State - HIMACHAL PRADESH,Urban,9,Literate with No Education,51,41,92
9633,2,State - HIMACHAL PRADESH,Urban,10,Literate with No Education,45,51,96
9634,2,State - HIMACHAL PRADESH,Urban,11,Literate with No Education,44,43,87
9635,2,State - HIMACHAL PRADESH,Urban,12,Literate with No Education,32,16,48
9636,2,State - HIMACHAL PRADESH,Urban,13,Literate with No Education,38,18,56
9637,2,State - HIMACHAL PRADESH,Urban,14,Literate with No Education,29,23,52
9638,2,State - HIMACHAL PRADESH,Urban,15,Literate with No Education,46,27,73
9639,2,State - HIMACHAL PRADESH,Urban,16,Literate with No Education,47,26,73
9640,2,State - HIMACHAL PRADESH,Urban,17,Literate with No Education,59,29,88
9641,2,State - HIMACHAL PRADESH,Urban,18,Literate with No Education,121,48,169
9642,2,State - HIMACHAL PRADESH,Urban,19,Literate with No Education,121,52,173
9643,2,State - HIMACHAL PRADESH,Urban,20-24,Literate with No Education,791,578,1369
9644,2,State - HIMACHAL PRADESH,Urban,25-29,Literate with No Education,878,732,1610
9645,2,State - HIMACHAL PRADESH,Urban,30-34,Literate with No Education,691,622,1313
9646,2,State - HIMACHAL PRADESH,Urban,35-39,Literate with No Education,648,653,1301
9647,2,State - HIMACHAL PRADESH,Urban,40-44,Literate with No Education,524,527,1051
9648,2,State - HIMACHAL PRADESH,Urban,45-49,Literate with No Education,433,447,880
9649,2,State - HIMACHAL PRADESH,Urban,50-54,Literate with No Education,344,412,756
9650,2,State - HIMACHAL PRADESH,Urban,55-59,Literate with No Education,265,277,542
9651,2,State - HIMACHAL PRADESH,Urban,60-64,Literate with No Education,185,230,415
9652,2,State - HIMACHAL PRADESH,Urban,65-69,Literate with No Education,126,151,277
9653,2,State - HIMACHAL PRADESH,Urban,70-74,Literate with No Education,97,142,239
9654,2,State - HIMACHAL PRADESH,Urban,75-79,Literate with No Education,66,73,139
9655,2,State - HIMACHAL PRADESH,Urban,80+,Literate with No Education,92,109,201
9656,2,State - HIMACHAL PRADESH,Urban,Age not stated,Literate with No Education,69,34,103
9657,3,State - PUNJAB,Total,All ages,Literate with No Education,299936,266396,566332
9658,3,State - PUNJAB,Total,0-6,Literate with No Education,0,0,0
9659,3,State - PUNJAB,Total,7,Literate with No Education,5768,3974,9742
9660,3,State - PUNJAB,Total,8,Literate with No Education,3634,2639,6273
9661,3,State - PUNJAB,Total,9,Literate with No Education,2991,2127,5118
9662,3,State - PUNJAB,Total,10,Literate with No Education,3627,2530,6157
9663,3,State - PUNJAB,Total,11,Literate with No Education,2903,2032,4935
9664,3,State - PUNJAB,Total,12,Literate with No Education,2892,2046,4938
9665,3,State - PUNJAB,Total,13,Literate with No Education,2772,1962,4734
9666,3,State - PUNJAB,Total,14,Literate with No Education,3083,2285,5368
9667,3,State - PUNJAB,Total,15,Literate with No Education,3772,2575,6347
9668,3,State - PUNJAB,Total,16,Literate with No Education,4055,2911,6966
9669,3,State - PUNJAB,Total,17,Literate with No Education,4483,3028,7511
9670,3,State - PUNJAB,Total,18,Literate with No Education,6466,4434,10900
9671,3,State - PUNJAB,Total,19,Literate with No Education,5783,4232,10015
9672,3,State - PUNJAB,Total,20-24,Literate with No Education,35203,29058,64261
9673,3,State - PUNJAB,Total,25-29,Literate with No Education,34956,31791,66747
9674,3,State - PUNJAB,Total,30-34,Literate with No Education,28995,27383,56378
9675,3,State - PUNJAB,Total,35-39,Literate with No Education,26631,25955,52586
9676,3,State - PUNJAB,Total,40-44,Literate with No Education,23763,23247,47010
9677,3,State - PUNJAB,Total,45-49,Literate with No Education,21401,20335,41736
9678,3,State - PUNJAB,Total,50-54,Literate with No Education,17479,16301,33780
9679,3,State - PUNJAB,Total,55-59,Literate with No Education,12746,12611,25357
9680,3,State - PUNJAB,Total,60-64,Literate with No Education,13243,13713,26956
9681,3,State - PUNJAB,Total,65-69,Literate with No Education,10669,9551,20220
9682,3,State - PUNJAB,Total,70-74,Literate with No Education,8069,7269,15338
9683,3,State - PUNJAB,Total,75-79,Literate with No Education,4169,4006,8175
9684,3,State - PUNJAB,Total,80+,Literate with No Education,6679,6380,13059
9685,3,State - PUNJAB,Total,Age not stated,Literate with No Education,3704,2021,5725
9686,3,State - PUNJAB,Rural,All ages,Literate with No Education,185107,162845,347952
9687,3,State - PUNJAB,Rural,0-6,Literate with No Education,0,0,0
9688,3,State - PUNJAB,Rural,7,Literate with No Education,3677,2480,6157
9689,3,State - PUNJAB,Rural,8,Literate with No Education,2226,1638,3864
9690,3,State - PUNJAB,Rural,9,Literate with No Education,1855,1332,3187
9691,3,State - PUNJAB,Rural,10,Literate with No Education,2207,1540,3747
9692,3,State - PUNJAB,Rural,11,Literate with No Education,1696,1259,2955
9693,3,State - PUNJAB,Rural,12,Literate with No Education,1807,1330,3137
9694,3,State - PUNJAB,Rural,13,Literate with No Education,1719,1285,3004
9695,3,State - PUNJAB,Rural,14,Literate with No Education,1952,1555,3507
9696,3,State - PUNJAB,Rural,15,Literate with No Education,2409,1705,4114
9697,3,State - PUNJAB,Rural,16,Literate with No Education,2630,2021,4651
9698,3,State - PUNJAB,Rural,17,Literate with No Education,2940,2066,5006
9699,3,State - PUNJAB,Rural,18,Literate with No Education,4167,3023,7190
9700,3,State - PUNJAB,Rural,19,Literate with No Education,3684,2835,6519
9701,3,State - PUNJAB,Rural,20-24,Literate with No Education,21965,18625,40590
9702,3,State - PUNJAB,Rural,25-29,Literate with No Education,20269,18964,39233
9703,3,State - PUNJAB,Rural,30-34,Literate with No Education,16807,16240,33047
9704,3,State - PUNJAB,Rural,35-39,Literate with No Education,15794,15524,31318
9705,3,State - PUNJAB,Rural,40-44,Literate with No Education,14501,14116,28617
9706,3,State - PUNJAB,Rural,45-49,Literate with No Education,13047,12004,25051
9707,3,State - PUNJAB,Rural,50-54,Literate with No Education,10369,9363,19732
9708,3,State - PUNJAB,Rural,55-59,Literate with No Education,7577,7207,14784
9709,3,State - PUNJAB,Rural,60-64,Literate with No Education,8479,8497,16976
9710,3,State - PUNJAB,Rural,65-69,Literate with No Education,7444,5936,13380
9711,3,State - PUNJAB,Rural,70-74,Literate with No Education,5586,4426,10012
9712,3,State - PUNJAB,Rural,75-79,Literate with No Education,2849,2427,5276
9713,3,State - PUNJAB,Rural,80+,Literate with No Education,4832,4073,8905
9714,3,State - PUNJAB,Rural,Age not stated,Literate with No Education,2619,1374,3993
9715,3,State - PUNJAB,Urban,All ages,Literate with No Education,114829,103551,218380
9716,3,State - PUNJAB,Urban,0-6,Literate with No Education,0,0,0
9717,3,State - PUNJAB,Urban,7,Literate with No Education,2091,1494,3585
9718,3,State - PUNJAB,Urban,8,Literate with No Education,1408,1001,2409
9719,3,State - PUNJAB,Urban,9,Literate with No Education,1136,795,1931
9720,3,State - PUNJAB,Urban,10,Literate with No Education,1420,990,2410
9721,3,State - PUNJAB,Urban,11,Literate with No Education,1207,773,1980
9722,3,State - PUNJAB,Urban,12,Literate with No Education,1085,716,1801
9723,3,State - PUNJAB,Urban,13,Literate with No Education,1053,677,1730
9724,3,State - PUNJAB,Urban,14,Literate with No Education,1131,730,1861
9725,3,State - PUNJAB,Urban,15,Literate with No Education,1363,870,2233
9726,3,State - PUNJAB,Urban,16,Literate with No Education,1425,890,2315
9727,3,State - PUNJAB,Urban,17,Literate with No Education,1543,962,2505
9728,3,State - PUNJAB,Urban,18,Literate with No Education,2299,1411,3710
9729,3,State - PUNJAB,Urban,19,Literate with No Education,2099,1397,3496
9730,3,State - PUNJAB,Urban,20-24,Literate with No Education,13238,10433,23671
9731,3,State - PUNJAB,Urban,25-29,Literate with No Education,14687,12827,27514
9732,3,State - PUNJAB,Urban,30-34,Literate with No Education,12188,11143,23331
9733,3,State - PUNJAB,Urban,35-39,Literate with No Education,10837,10431,21268
9734,3,State - PUNJAB,Urban,40-44,Literate with No Education,9262,9131,18393
9735,3,State - PUNJAB,Urban,45-49,Literate with No Education,8354,8331,16685
9736,3,State - PUNJAB,Urban,50-54,Literate with No Education,7110,6938,14048
9737,3,State - PUNJAB,Urban,55-59,Literate with No Education,5169,5404,10573
9738,3,State - PUNJAB,Urban,60-64,Literate with No Education,4764,5216,9980
9739,3,State - PUNJAB,Urban,65-69,Literate with No Education,3225,3615,6840
9740,3,State - PUNJAB,Urban,70-74,Literate with No Education,2483,2843,5326
9741,3,State - PUNJAB,Urban,75-79,Literate with No Education,1320,1579,2899
9742,3,State - PUNJAB,Urban,80+,Literate with No Education,1847,2307,4154
9743,3,State - PUNJAB,Urban,Age not stated,Literate with No Education,1085,647,1732
9744,4,State - CHANDIGARH,Total,All ages,Literate with No Education,5586,5668,11254
9745,4,State - CHANDIGARH,Total,0-6,Literate with No Education,0,0,0
9746,4,State - CHANDIGARH,Total,7,Literate with No Education,80,59,139
9747,4,State - CHANDIGARH,Total,8,Literate with No Education,31,37,68
9748,4,State - CHANDIGARH,Total,9,Literate with No Education,38,40,78
9749,4,State - CHANDIGARH,Total,10,Literate with No Education,55,35,90
9750,4,State - CHANDIGARH,Total,11,Literate with No Education,40,25,65
9751,4,State - CHANDIGARH,Total,12,Literate with No Education,33,21,54
9752,4,State - CHANDIGARH,Total,13,Literate with No Education,32,17,49
9753,4,State - CHANDIGARH,Total,14,Literate with No Education,37,35,72
9754,4,State - CHANDIGARH,Total,15,Literate with No Education,58,36,94
9755,4,State - CHANDIGARH,Total,16,Literate with No Education,51,43,94
9756,4,State - CHANDIGARH,Total,17,Literate with No Education,73,31,104
9757,4,State - CHANDIGARH,Total,18,Literate with No Education,133,78,211
9758,4,State - CHANDIGARH,Total,19,Literate with No Education,110,58,168
9759,4,State - CHANDIGARH,Total,20-24,Literate with No Education,731,537,1268
9760,4,State - CHANDIGARH,Total,25-29,Literate with No Education,784,731,1515
9761,4,State - CHANDIGARH,Total,30-34,Literate with No Education,654,670,1324
9762,4,State - CHANDIGARH,Total,35-39,Literate with No Education,609,665,1274
9763,4,State - CHANDIGARH,Total,40-44,Literate with No Education,473,556,1029
9764,4,State - CHANDIGARH,Total,45-49,Literate with No Education,405,526,931
9765,4,State - CHANDIGARH,Total,50-54,Literate with No Education,310,391,701
9766,4,State - CHANDIGARH,Total,55-59,Literate with No Education,265,286,551
9767,4,State - CHANDIGARH,Total,60-64,Literate with No Education,213,233,446
9768,4,State - CHANDIGARH,Total,65-69,Literate with No Education,119,151,270
9769,4,State - CHANDIGARH,Total,70-74,Literate with No Education,79,138,217
9770,4,State - CHANDIGARH,Total,75-79,Literate with No Education,60,114,174
9771,4,State - CHANDIGARH,Total,80+,Literate with No Education,60,134,194
9772,4,State - CHANDIGARH,Total,Age not stated,Literate with No Education,53,21,74
9773,4,State - CHANDIGARH,Rural,All ages,Literate with No Education,168,99,267
9774,4,State - CHANDIGARH,Rural,0-6,Literate with No Education,0,0,0
9775,4,State - CHANDIGARH,Rural,7,Literate with No Education,2,1,3
9776,4,State - CHANDIGARH,Rural,8,Literate with No Education,0,2,2
9777,4,State - CHANDIGARH,Rural,9,Literate with No Education,1,1,2
9778,4,State - CHANDIGARH,Rural,10,Literate with No Education,1,0,1
9779,4,State - CHANDIGARH,Rural,11,Literate with No Education,0,2,2
9780,4,State - CHANDIGARH,Rural,12,Literate with No Education,1,0,1
9781,4,State - CHANDIGARH,Rural,13,Literate with No Education,1,0,1
9782,4,State - CHANDIGARH,Rural,14,Literate with No Education,0,1,1
9783,4,State - CHANDIGARH,Rural,15,Literate with No Education,2,1,3
9784,4,State - CHANDIGARH,Rural,16,Literate with No Education,1,2,3
9785,4,State - CHANDIGARH,Rural,17,Literate with No Education,2,1,3
9786,4,State - CHANDIGARH,Rural,18,Literate with No Education,4,2,6
9787,4,State - CHANDIGARH,Rural,19,Literate with No Education,4,2,6
9788,4,State - CHANDIGARH,Rural,20-24,Literate with No Education,40,12,52
9789,4,State - CHANDIGARH,Rural,25-29,Literate with No Education,35,24,59
9790,4,State - CHANDIGARH,Rural,30-34,Literate with No Education,25,12,37
9791,4,State - CHANDIGARH,Rural,35-39,Literate with No Education,13,16,29
9792,4,State - CHANDIGARH,Rural,40-44,Literate with No Education,12,6,18
9793,4,State - CHANDIGARH,Rural,45-49,Literate with No Education,10,4,14
9794,4,State - CHANDIGARH,Rural,50-54,Literate with No Education,2,4,6
9795,4,State - CHANDIGARH,Rural,55-59,Literate with No Education,1,3,4
9796,4,State - CHANDIGARH,Rural,60-64,Literate with No Education,4,1,5
9797,4,State - CHANDIGARH,Rural,65-69,Literate with No Education,3,1,4
9798,4,State - CHANDIGARH,Rural,70-74,Literate with No Education,3,1,4
9799,4,State - CHANDIGARH,Rural,75-79,Literate with No Education,0,0,0
9800,4,State - CHANDIGARH,Rural,80+,Literate with No Education,1,0,1
9801,4,State - CHANDIGARH,Rural,Age not stated,Literate with No Education,0,0,0
9802,4,State - CHANDIGARH,Urban,All ages,Literate with No Education,5418,5569,10987
9803,4,State - CHANDIGARH,Urban,0-6,Literate with No Education,0,0,0
9804,4,State - CHANDIGARH,Urban,7,Literate with No Education,78,58,136
9805,4,State - CHANDIGARH,Urban,8,Literate with No Education,31,35,66
9806,4,State - CHANDIGARH,Urban,9,Literate with No Education,37,39,76
9807,4,State - CHANDIGARH,Urban,10,Literate with No Education,54,35,89
9808,4,State - CHANDIGARH,Urban,11,Literate with No Education,40,23,63
9809,4,State - CHANDIGARH,Urban,12,Literate with No Education,32,21,53
9810,4,State - CHANDIGARH,Urban,13,Literate with No Education,31,17,48
9811,4,State - CHANDIGARH,Urban,14,Literate with No Education,37,34,71
9812,4,State - CHANDIGARH,Urban,15,Literate with No Education,56,35,91
9813,4,State - CHANDIGARH,Urban,16,Literate with No Education,50,41,91
9814,4,State - CHANDIGARH,Urban,17,Literate with No Education,71,30,101
9815,4,State - CHANDIGARH,Urban,18,Literate with No Education,129,76,205
9816,4,State - CHANDIGARH,Urban,19,Literate with No Education,106,56,162
9817,4,State - CHANDIGARH,Urban,20-24,Literate with No Education,691,525,1216
9818,4,State - CHANDIGARH,Urban,25-29,Literate with No Education,749,707,1456
9819,4,State - CHANDIGARH,Urban,30-34,Literate with No Education,629,658,1287
9820,4,State - CHANDIGARH,Urban,35-39,Literate with No Education,596,649,1245
9821,4,State - CHANDIGARH,Urban,40-44,Literate with No Education,461,550,1011
9822,4,State - CHANDIGARH,Urban,45-49,Literate with No Education,395,522,917
9823,4,State - CHANDIGARH,Urban,50-54,Literate with No Education,308,387,695
9824,4,State - CHANDIGARH,Urban,55-59,Literate with No Education,264,283,547
9825,4,State - CHANDIGARH,Urban,60-64,Literate with No Education,209,232,441
9826,4,State - CHANDIGARH,Urban,65-69,Literate with No Education,116,150,266
9827,4,State - CHANDIGARH,Urban,70-74,Literate with No Education,76,137,213
9828,4,State - CHANDIGARH,Urban,75-79,Literate with No Education,60,114,174
9829,4,State - CHANDIGARH,Urban,80+,Literate with No Education,59,134,193
9830,4,State - CHANDIGARH,Urban,Age not stated,Literate with No Education,53,21,74
9831,5,State - UTTARAKHAND,Total,All ages,Literate with No Education,72896,73010,145906
9832,5,State - UTTARAKHAND,Total,0-6,Literate with No Education,0,0,0
9833,5,State - UTTARAKHAND,Total,7,Literate with No Education,1541,1130,2671
9834,5,State - UTTARAKHAND,Total,8,Literate with No Education,920,666,1586
9835,5,State - UTTARAKHAND,Total,9,Literate with No Education,788,527,1315
9836,5,State - UTTARAKHAND,Total,10,Literate with No Education,1010,706,1716
9837,5,State - UTTARAKHAND,Total,11,Literate with No Education,747,531,1278
9838,5,State - UTTARAKHAND,Total,12,Literate with No Education,704,523,1227
9839,5,State - UTTARAKHAND,Total,13,Literate with No Education,640,480,1120
9840,5,State - UTTARAKHAND,Total,14,Literate with No Education,777,611,1388
9841,5,State - UTTARAKHAND,Total,15,Literate with No Education,776,671,1447
9842,5,State - UTTARAKHAND,Total,16,Literate with No Education,862,797,1659
9843,5,State - UTTARAKHAND,Total,17,Literate with No Education,987,798,1785
9844,5,State - UTTARAKHAND,Total,18,Literate with No Education,1459,1253,2712
9845,5,State - UTTARAKHAND,Total,19,Literate with No Education,1350,1125,2475
9846,5,State - UTTARAKHAND,Total,20-24,Literate with No Education,7868,7801,15669
9847,5,State - UTTARAKHAND,Total,25-29,Literate with No Education,8399,8838,17237
9848,5,State - UTTARAKHAND,Total,30-34,Literate with No Education,7224,7733,14957
9849,5,State - UTTARAKHAND,Total,35-39,Literate with No Education,6689,7345,14034
9850,5,State - UTTARAKHAND,Total,40-44,Literate with No Education,5859,6395,12254
9851,5,State - UTTARAKHAND,Total,45-49,Literate with No Education,5010,5549,10559
9852,5,State - UTTARAKHAND,Total,50-54,Literate with No Education,4177,4591,8768
9853,5,State - UTTARAKHAND,Total,55-59,Literate with No Education,3073,3823,6896
9854,5,State - UTTARAKHAND,Total,60-64,Literate with No Education,3688,3833,7521
9855,5,State - UTTARAKHAND,Total,65-69,Literate with No Education,2461,2479,4940
9856,5,State - UTTARAKHAND,Total,70-74,Literate with No Education,1898,1843,3741
9857,5,State - UTTARAKHAND,Total,75-79,Literate with No Education,1003,1012,2015
9858,5,State - UTTARAKHAND,Total,80+,Literate with No Education,1397,1277,2674
9859,5,State - UTTARAKHAND,Total,Age not stated,Literate with No Education,1589,673,2262
9860,5,State - UTTARAKHAND,Rural,All ages,Literate with No Education,47334,51048,98382
9861,5,State - UTTARAKHAND,Rural,0-6,Literate with No Education,0,0,0
9862,5,State - UTTARAKHAND,Rural,7,Literate with No Education,1012,782,1794
9863,5,State - UTTARAKHAND,Rural,8,Literate with No Education,597,439,1036
9864,5,State - UTTARAKHAND,Rural,9,Literate with No Education,521,373,894
9865,5,State - UTTARAKHAND,Rural,10,Literate with No Education,589,492,1081
9866,5,State - UTTARAKHAND,Rural,11,Literate with No Education,468,397,865
9867,5,State - UTTARAKHAND,Rural,12,Literate with No Education,446,373,819
9868,5,State - UTTARAKHAND,Rural,13,Literate with No Education,400,351,751
9869,5,State - UTTARAKHAND,Rural,14,Literate with No Education,476,435,911
9870,5,State - UTTARAKHAND,Rural,15,Literate with No Education,489,486,975
9871,5,State - UTTARAKHAND,Rural,16,Literate with No Education,552,585,1137
9872,5,State - UTTARAKHAND,Rural,17,Literate with No Education,621,576,1197
9873,5,State - UTTARAKHAND,Rural,18,Literate with No Education,929,910,1839
9874,5,State - UTTARAKHAND,Rural,19,Literate with No Education,827,837,1664
9875,5,State - UTTARAKHAND,Rural,20-24,Literate with No Education,4982,5558,10540
9876,5,State - UTTARAKHAND,Rural,25-29,Literate with No Education,5083,5913,10996
9877,5,State - UTTARAKHAND,Rural,30-34,Literate with No Education,4284,5283,9567
9878,5,State - UTTARAKHAND,Rural,35-39,Literate with No Education,4091,4998,9089
9879,5,State - UTTARAKHAND,Rural,40-44,Literate with No Education,3719,4471,8190
9880,5,State - UTTARAKHAND,Rural,45-49,Literate with No Education,3283,3783,7066
9881,5,State - UTTARAKHAND,Rural,50-54,Literate with No Education,2855,3291,6146
9882,5,State - UTTARAKHAND,Rural,55-59,Literate with No Education,2114,2714,4828
9883,5,State - UTTARAKHAND,Rural,60-64,Literate with No Education,2834,2825,5659
9884,5,State - UTTARAKHAND,Rural,65-69,Literate with No Education,1848,1774,3622
9885,5,State - UTTARAKHAND,Rural,70-74,Literate with No Education,1441,1371,2812
9886,5,State - UTTARAKHAND,Rural,75-79,Literate with No Education,797,736,1533
9887,5,State - UTTARAKHAND,Rural,80+,Literate with No Education,1028,841,1869
9888,5,State - UTTARAKHAND,Rural,Age not stated,Literate with No Education,1048,454,1502
9889,5,State - UTTARAKHAND,Urban,All ages,Literate with No Education,25562,21962,47524
9890,5,State - UTTARAKHAND,Urban,0-6,Literate with No Education,0,0,0
9891,5,State - UTTARAKHAND,Urban,7,Literate with No Education,529,348,877
9892,5,State - UTTARAKHAND,Urban,8,Literate with No Education,323,227,550
9893,5,State - UTTARAKHAND,Urban,9,Literate with No Education,267,154,421
9894,5,State - UTTARAKHAND,Urban,10,Literate with No Education,421,214,635
9895,5,State - UTTARAKHAND,Urban,11,Literate with No Education,279,134,413
9896,5,State - UTTARAKHAND,Urban,12,Literate with No Education,258,150,408
9897,5,State - UTTARAKHAND,Urban,13,Literate with No Education,240,129,369
9898,5,State - UTTARAKHAND,Urban,14,Literate with No Education,301,176,477
9899,5,State - UTTARAKHAND,Urban,15,Literate with No Education,287,185,472
9900,5,State - UTTARAKHAND,Urban,16,Literate with No Education,310,212,522
9901,5,State - UTTARAKHAND,Urban,17,Literate with No Education,366,222,588
9902,5,State - UTTARAKHAND,Urban,18,Literate with No Education,530,343,873
9903,5,State - UTTARAKHAND,Urban,19,Literate with No Education,523,288,811
9904,5,State - UTTARAKHAND,Urban,20-24,Literate with No Education,2886,2243,5129
9905,5,State - UTTARAKHAND,Urban,25-29,Literate with No Education,3316,2925,6241
9906,5,State - UTTARAKHAND,Urban,30-34,Literate with No Education,2940,2450,5390
9907,5,State - UTTARAKHAND,Urban,35-39,Literate with No Education,2598,2347,4945
9908,5,State - UTTARAKHAND,Urban,40-44,Literate with No Education,2140,1924,4064
9909,5,State - UTTARAKHAND,Urban,45-49,Literate with No Education,1727,1766,3493
9910,5,State - UTTARAKHAND,Urban,50-54,Literate with No Education,1322,1300,2622
9911,5,State - UTTARAKHAND,Urban,55-59,Literate with No Education,959,1109,2068
9912,5,State - UTTARAKHAND,Urban,60-64,Literate with No Education,854,1008,1862
9913,5,State - UTTARAKHAND,Urban,65-69,Literate with No Education,613,705,1318
9914,5,State - UTTARAKHAND,Urban,70-74,Literate with No Education,457,472,929
9915,5,State - UTTARAKHAND,Urban,75-79,Literate with No Education,206,276,482
9916,5,State - UTTARAKHAND,Urban,80+,Literate with No Education,369,436,805
9917,5,State - UTTARAKHAND,Urban,Age not stated,Literate with No Education,541,219,760
9918,6,State - HARYANA,Total,All ages,Literate with No Education,212259,183631,395890
9919,6,State - HARYANA,Total,0-6,Literate with No Education,0,0,0
9920,6,State - HARYANA,Total,7,Literate with No Education,3306,2112,5418
9921,6,State - HARYANA,Total,8,Literate with No Education,2150,1443,3593
9922,6,State - HARYANA,Total,9,Literate with No Education,1806,1174,2980
9923,6,State - HARYANA,Total,10,Literate with No Education,2208,1391,3599
9924,6,State - HARYANA,Total,11,Literate with No Education,1638,1156,2794
9925,6,State - HARYANA,Total,12,Literate with No Education,1771,1283,3054
9926,6,State - HARYANA,Total,13,Literate with No Education,1564,1248,2812
9927,6,State - HARYANA,Total,14,Literate with No Education,1874,1456,3330
9928,6,State - HARYANA,Total,15,Literate with No Education,2174,1668,3842
9929,6,State - HARYANA,Total,16,Literate with No Education,2674,1959,4633
9930,6,State - HARYANA,Total,17,Literate with No Education,2752,2145,4897
9931,6,State - HARYANA,Total,18,Literate with No Education,4684,3485,8169
9932,6,State - HARYANA,Total,19,Literate with No Education,4153,3125,7278
9933,6,State - HARYANA,Total,20-24,Literate with No Education,27213,22845,50058
9934,6,State - HARYANA,Total,25-29,Literate with No Education,28084,24905,52989
9935,6,State - HARYANA,Total,30-34,Literate with No Education,22933,21519,44452
9936,6,State - HARYANA,Total,35-39,Literate with No Education,20770,19387,40157
9937,6,State - HARYANA,Total,40-44,Literate with No Education,17666,15836,33502
9938,6,State - HARYANA,Total,45-49,Literate with No Education,14750,12908,27658
9939,6,State - HARYANA,Total,50-54,Literate with No Education,11427,9873,21300
9940,6,State - HARYANA,Total,55-59,Literate with No Education,8426,8110,16536
9941,6,State - HARYANA,Total,60-64,Literate with No Education,9565,8805,18370
9942,6,State - HARYANA,Total,65-69,Literate with No Education,5938,5180,11118
9943,6,State - HARYANA,Total,70-74,Literate with No Education,4621,4022,8643
9944,6,State - HARYANA,Total,75-79,Literate with No Education,2469,2167,4636
9945,6,State - HARYANA,Total,80+,Literate with No Education,3859,3342,7201
9946,6,State - HARYANA,Total,Age not stated,Literate with No Education,1784,1087,2871
9947,6,State - HARYANA,Rural,All ages,Literate with No Education,129046,104928,233974
9948,6,State - HARYANA,Rural,0-6,Literate with No Education,0,0,0
9949,6,State - HARYANA,Rural,7,Literate with No Education,1735,1072,2807
9950,6,State - HARYANA,Rural,8,Literate with No Education,1179,791,1970
9951,6,State - HARYANA,Rural,9,Literate with No Education,927,678,1605
9952,6,State - HARYANA,Rural,10,Literate with No Education,1233,791,2024
9953,6,State - HARYANA,Rural,11,Literate with No Education,925,704,1629
9954,6,State - HARYANA,Rural,12,Literate with No Education,1057,822,1879
9955,6,State - HARYANA,Rural,13,Literate with No Education,907,838,1745
9956,6,State - HARYANA,Rural,14,Literate with No Education,1130,974,2104
9957,6,State - HARYANA,Rural,15,Literate with No Education,1340,1120,2460
9958,6,State - HARYANA,Rural,16,Literate with No Education,1695,1347,3042
9959,6,State - HARYANA,Rural,17,Literate with No Education,1798,1481,3279
9960,6,State - HARYANA,Rural,18,Literate with No Education,3038,2447,5485
9961,6,State - HARYANA,Rural,19,Literate with No Education,2624,2136,4760
9962,6,State - HARYANA,Rural,20-24,Literate with No Education,17351,14506,31857
9963,6,State - HARYANA,Rural,25-29,Literate with No Education,16838,14267,31105
9964,6,State - HARYANA,Rural,30-34,Literate with No Education,13605,12293,25898
9965,6,State - HARYANA,Rural,35-39,Literate with No Education,12454,10875,23329
9966,6,State - HARYANA,Rural,40-44,Literate with No Education,10777,8761,19538
9967,6,State - HARYANA,Rural,45-49,Literate with No Education,8673,6573,15246
9968,6,State - HARYANA,Rural,50-54,Literate with No Education,6608,4890,11498
9969,6,State - HARYANA,Rural,55-59,Literate with No Education,4809,4032,8841
9970,6,State - HARYANA,Rural,60-64,Literate with No Education,6113,4891,11004
9971,6,State - HARYANA,Rural,65-69,Literate with No Education,3809,2822,6631
9972,6,State - HARYANA,Rural,70-74,Literate with No Education,3064,2214,5278
9973,6,State - HARYANA,Rural,75-79,Literate with No Education,1647,1169,2816
9974,6,State - HARYANA,Rural,80+,Literate with No Education,2705,1866,4571
9975,6,State - HARYANA,Rural,Age not stated,Literate with No Education,1005,568,1573
9976,6,State - HARYANA,Urban,All ages,Literate with No Education,83213,78703,161916
9977,6,State - HARYANA,Urban,0-6,Literate with No Education,0,0,0
9978,6,State - HARYANA,Urban,7,Literate with No Education,1571,1040,2611
9979,6,State - HARYANA,Urban,8,Literate with No Education,971,652,1623
9980,6,State - HARYANA,Urban,9,Literate with No Education,879,496,1375
9981,6,State - HARYANA,Urban,10,Literate with No Education,975,600,1575
9982,6,State - HARYANA,Urban,11,Literate with No Education,713,452,1165
9983,6,State - HARYANA,Urban,12,Literate with No Education,714,461,1175
9984,6,State - HARYANA,Urban,13,Literate with No Education,657,410,1067
9985,6,State - HARYANA,Urban,14,Literate with No Education,744,482,1226
9986,6,State - HARYANA,Urban,15,Literate with No Education,834,548,1382
9987,6,State - HARYANA,Urban,16,Literate with No Education,979,612,1591
9988,6,State - HARYANA,Urban,17,Literate with No Education,954,664,1618
9989,6,State - HARYANA,Urban,18,Literate with No Education,1646,1038,2684
9990,6,State - HARYANA,Urban,19,Literate with No Education,1529,989,2518
9991,6,State - HARYANA,Urban,20-24,Literate with No Education,9862,8339,18201
9992,6,State - HARYANA,Urban,25-29,Literate with No Education,11246,10638,21884
9993,6,State - HARYANA,Urban,30-34,Literate with No Education,9328,9226,18554
9994,6,State - HARYANA,Urban,35-39,Literate with No Education,8316,8512,16828
9995,6,State - HARYANA,Urban,40-44,Literate with No Education,6889,7075,13964
9996,6,State - HARYANA,Urban,45-49,Literate with No Education,6077,6335,12412
9997,6,State - HARYANA,Urban,50-54,Literate with No Education,4819,4983,9802
9998,6,State - HARYANA,Urban,55-59,Literate with No Education,3617,4078,7695
9999,6,State - HARYANA,Urban,60-64,Literate with No Education,3452,3914,7366
10000,6,State - HARYANA,Urban,65-69,Literate with No Education,2129,2358,4487
10001,6,State - HARYANA,Urban,70-74,Literate with No Education,1557,1808,3365
10002,6,State - HARYANA,Urban,75-79,Literate with No Education,822,998,1820
10003,6,State - HARYANA,Urban,80+,Literate with No Education,1154,1476,2630
10004,6,State - HARYANA,Urban,Age not stated,Literate with No Education,779,519,1298
10005,7,State - NCT OF DELHI,Total,All ages,Literate with No Education,239952,213503,453455
10006,7,State - NCT OF DELHI,Total,0-6,Literate with No Education,0,0,0
10007,7,State - NCT OF DELHI,Total,7,Literate with No Education,1940,1395,3335
10008,7,State - NCT OF DELHI,Total,8,Literate with No Education,1580,1154,2734
10009,7,State - NCT OF DELHI,Total,9,Literate with No Education,1414,997,2411
10010,7,State - NCT OF DELHI,Total,10,Literate with No Education,1790,1278,3068
10011,7,State - NCT OF DELHI,Total,11,Literate with No Education,1572,1172,2744
10012,7,State - NCT OF DELHI,Total,12,Literate with No Education,1736,1236,2972
10013,7,State - NCT OF DELHI,Total,13,Literate with No Education,1578,1218,2796
10014,7,State - NCT OF DELHI,Total,14,Literate with No Education,1788,1374,3162
10015,7,State - NCT OF DELHI,Total,15,Literate with No Education,2149,1455,3604
10016,7,State - NCT OF DELHI,Total,16,Literate with No Education,2369,1746,4115
10017,7,State - NCT OF DELHI,Total,17,Literate with No Education,2724,1893,4617
10018,7,State - NCT OF DELHI,Total,18,Literate with No Education,4661,3019,7680
10019,7,State - NCT OF DELHI,Total,19,Literate with No Education,4065,2975,7040
10020,7,State - NCT OF DELHI,Total,20-24,Literate with No Education,31695,26707,58402
10021,7,State - NCT OF DELHI,Total,25-29,Literate with No Education,37748,33999,71747
10022,7,State - NCT OF DELHI,Total,30-34,Literate with No Education,30768,28735,59503
10023,7,State - NCT OF DELHI,Total,35-39,Literate with No Education,27214,25620,52834
10024,7,State - NCT OF DELHI,Total,40-44,Literate with No Education,21772,19926,41698
10025,7,State - NCT OF DELHI,Total,45-49,Literate with No Education,17624,16077,33701
10026,7,State - NCT OF DELHI,Total,50-54,Literate with No Education,12998,11866,24864
10027,7,State - NCT OF DELHI,Total,55-59,Literate with No Education,9311,8996,18307
10028,7,State - NCT OF DELHI,Total,60-64,Literate with No Education,8100,8152,16252
10029,7,State - NCT OF DELHI,Total,65-69,Literate with No Education,4941,4684,9625
10030,7,State - NCT OF DELHI,Total,70-74,Literate with No Education,3317,3265,6582
10031,7,State - NCT OF DELHI,Total,75-79,Literate with No Education,1822,1760,3582
10032,7,State - NCT OF DELHI,Total,80+,Literate with No Education,1958,2072,4030
10033,7,State - NCT OF DELHI,Total,Age not stated,Literate with No Education,1318,732,2050
10034,7,State - NCT OF DELHI,Rural,All ages,Literate with No Education,4460,3753,8213
10035,7,State - NCT OF DELHI,Rural,0-6,Literate with No Education,0,0,0
10036,7,State - NCT OF DELHI,Rural,7,Literate with No Education,53,36,89
10037,7,State - NCT OF DELHI,Rural,8,Literate with No Education,36,20,56
10038,7,State - NCT OF DELHI,Rural,9,Literate with No Education,39,17,56
10039,7,State - NCT OF DELHI,Rural,10,Literate with No Education,47,14,61
10040,7,State - NCT OF DELHI,Rural,11,Literate with No Education,27,24,51
10041,7,State - NCT OF DELHI,Rural,12,Literate with No Education,23,22,45
10042,7,State - NCT OF DELHI,Rural,13,Literate with No Education,34,25,59
10043,7,State - NCT OF DELHI,Rural,14,Literate with No Education,25,30,55
10044,7,State - NCT OF DELHI,Rural,15,Literate with No Education,41,36,77
10045,7,State - NCT OF DELHI,Rural,16,Literate with No Education,37,38,75
10046,7,State - NCT OF DELHI,Rural,17,Literate with No Education,76,43,119
10047,7,State - NCT OF DELHI,Rural,18,Literate with No Education,89,56,145
10048,7,State - NCT OF DELHI,Rural,19,Literate with No Education,72,59,131
10049,7,State - NCT OF DELHI,Rural,20-24,Literate with No Education,627,534,1161
10050,7,State - NCT OF DELHI,Rural,25-29,Literate with No Education,682,645,1327
10051,7,State - NCT OF DELHI,Rural,30-34,Literate with No Education,576,517,1093
10052,7,State - NCT OF DELHI,Rural,35-39,Literate with No Education,484,482,966
10053,7,State - NCT OF DELHI,Rural,40-44,Literate with No Education,425,311,736
10054,7,State - NCT OF DELHI,Rural,45-49,Literate with No Education,282,214,496
10055,7,State - NCT OF DELHI,Rural,50-54,Literate with No Education,217,207,424
10056,7,State - NCT OF DELHI,Rural,55-59,Literate with No Education,131,139,270
10057,7,State - NCT OF DELHI,Rural,60-64,Literate with No Education,163,118,281
10058,7,State - NCT OF DELHI,Rural,65-69,Literate with No Education,110,52,162
10059,7,State - NCT OF DELHI,Rural,70-74,Literate with No Education,65,41,106
10060,7,State - NCT OF DELHI,Rural,75-79,Literate with No Education,35,18,53
10061,7,State - NCT OF DELHI,Rural,80+,Literate with No Education,32,35,67
10062,7,State - NCT OF DELHI,Rural,Age not stated,Literate with No Education,32,20,52
10063,7,State - NCT OF DELHI,Urban,All ages,Literate with No Education,235492,209750,445242
10064,7,State - NCT OF DELHI,Urban,0-6,Literate with No Education,0,0,0
10065,7,State - NCT OF DELHI,Urban,7,Literate with No Education,1887,1359,3246
10066,7,State - NCT OF DELHI,Urban,8,Literate with No Education,1544,1134,2678
10067,7,State - NCT OF DELHI,Urban,9,Literate with No Education,1375,980,2355
10068,7,State - NCT OF DELHI,Urban,10,Literate with No Education,1743,1264,3007
10069,7,State - NCT OF DELHI,Urban,11,Literate with No Education,1545,1148,2693
10070,7,State - NCT OF DELHI,Urban,12,Literate with No Education,1713,1214,2927
10071,7,State - NCT OF DELHI,Urban,13,Literate with No Education,1544,1193,2737
10072,7,State - NCT OF DELHI,Urban,14,Literate with No Education,1763,1344,3107
10073,7,State - NCT OF DELHI,Urban,15,Literate with No Education,2108,1419,3527
10074,7,State - NCT OF DELHI,Urban,16,Literate with No Education,2332,1708,4040
10075,7,State - NCT OF DELHI,Urban,17,Literate with No Education,2648,1850,4498
10076,7,State - NCT OF DELHI,Urban,18,Literate with No Education,4572,2963,7535
10077,7,State - NCT OF DELHI,Urban,19,Literate with No Education,3993,2916,6909
10078,7,State - NCT OF DELHI,Urban,20-24,Literate with No Education,31068,26173,57241
10079,7,State - NCT OF DELHI,Urban,25-29,Literate with No Education,37066,33354,70420
10080,7,State - NCT OF DELHI,Urban,30-34,Literate with No Education,30192,28218,58410
10081,7,State - NCT OF DELHI,Urban,35-39,Literate with No Education,26730,25138,51868
10082,7,State - NCT OF DELHI,Urban,40-44,Literate with No Education,21347,19615,40962
10083,7,State - NCT OF DELHI,Urban,45-49,Literate with No Education,17342,15863,33205
10084,7,State - NCT OF DELHI,Urban,50-54,Literate with No Education,12781,11659,24440
10085,7,State - NCT OF DELHI,Urban,55-59,Literate with No Education,9180,8857,18037
10086,7,State - NCT OF DELHI,Urban,60-64,Literate with No Education,7937,8034,15971
10087,7,State - NCT OF DELHI,Urban,65-69,Literate with No Education,4831,4632,9463
10088,7,State - NCT OF DELHI,Urban,70-74,Literate with No Education,3252,3224,6476
10089,7,State - NCT OF DELHI,Urban,75-79,Literate with No Education,1787,1742,3529
10090,7,State - NCT OF DELHI,Urban,80+,Literate with No Education,1926,2037,3963
10091,7,State - NCT OF DELHI,Urban,Age not stated,Literate with No Education,1286,712,1998
10092,8,State - RAJASTHAN,Total,All ages,Literate with No Education,1084848,721316,1806164
10093,8,State - RAJASTHAN,Total,0-6,Literate with No Education,0,0,0
10094,8,State - RAJASTHAN,Total,7,Literate with No Education,12822,7817,20639
10095,8,State - RAJASTHAN,Total,8,Literate with No Education,12344,7606,19950
10096,8,State - RAJASTHAN,Total,9,Literate with No Education,9602,6249,15851
10097,8,State - RAJASTHAN,Total,10,Literate with No Education,13399,9078,22477
10098,8,State - RAJASTHAN,Total,11,Literate with No Education,10528,7443,17971
10099,8,State - RAJASTHAN,Total,12,Literate with No Education,13223,10528,23751
10100,8,State - RAJASTHAN,Total,13,Literate with No Education,11775,10195,21970
10101,8,State - RAJASTHAN,Total,14,Literate with No Education,13559,12605,26164
10102,8,State - RAJASTHAN,Total,15,Literate with No Education,17333,15425,32758
10103,8,State - RAJASTHAN,Total,16,Literate with No Education,19160,17016,36176
10104,8,State - RAJASTHAN,Total,17,Literate with No Education,17893,15160,33053
10105,8,State - RAJASTHAN,Total,18,Literate with No Education,30735,24970,55705
10106,8,State - RAJASTHAN,Total,19,Literate with No Education,21008,17639,38647
10107,8,State - RAJASTHAN,Total,20-24,Literate with No Education,146710,105245,251955
10108,8,State - RAJASTHAN,Total,25-29,Literate with No Education,140111,93681,233792
10109,8,State - RAJASTHAN,Total,30-34,Literate with No Education,116516,78195,194711
10110,8,State - RAJASTHAN,Total,35-39,Literate with No Education,103719,65611,169330
10111,8,State - RAJASTHAN,Total,40-44,Literate with No Education,87211,52588,139799
10112,8,State - RAJASTHAN,Total,45-49,Literate with No Education,72079,42218,114297
10113,8,State - RAJASTHAN,Total,50-54,Literate with No Education,58383,30576,88959
10114,8,State - RAJASTHAN,Total,55-59,Literate with No Education,40995,23671,64666
10115,8,State - RAJASTHAN,Total,60-64,Literate with No Education,36247,19846,56093
10116,8,State - RAJASTHAN,Total,65-69,Literate with No Education,24109,14258,38367
10117,8,State - RAJASTHAN,Total,70-74,Literate with No Education,19044,10654,29698
10118,8,State - RAJASTHAN,Total,75-79,Literate with No Education,8897,5639,14536
10119,8,State - RAJASTHAN,Total,80+,Literate with No Education,10491,7212,17703
10120,8,State - RAJASTHAN,Total,Age not stated,Literate with No Education,16955,10191,27146
10121,8,State - RAJASTHAN,Rural,All ages,Literate with No Education,791987,479433,1271420
10122,8,State - RAJASTHAN,Rural,0-6,Literate with No Education,0,0,0
10123,8,State - RAJASTHAN,Rural,7,Literate with No Education,9452,5745,15197
10124,8,State - RAJASTHAN,Rural,8,Literate with No Education,9527,5891,15418
10125,8,State - RAJASTHAN,Rural,9,Literate with No Education,7297,4822,12119
10126,8,State - RAJASTHAN,Rural,10,Literate with No Education,10329,7202,17531
10127,8,State - RAJASTHAN,Rural,11,Literate with No Education,7992,5866,13858
10128,8,State - RAJASTHAN,Rural,12,Literate with No Education,10326,8446,18772
10129,8,State - RAJASTHAN,Rural,13,Literate with No Education,9161,8315,17476
10130,8,State - RAJASTHAN,Rural,14,Literate with No Education,10735,10345,21080
10131,8,State - RAJASTHAN,Rural,15,Literate with No Education,13686,12584,26270
10132,8,State - RAJASTHAN,Rural,16,Literate with No Education,15201,13745,28946
10133,8,State - RAJASTHAN,Rural,17,Literate with No Education,13713,11860,25573
10134,8,State - RAJASTHAN,Rural,18,Literate with No Education,24099,19586,43685
10135,8,State - RAJASTHAN,Rural,19,Literate with No Education,15864,13427,29291
10136,8,State - RAJASTHAN,Rural,20-24,Literate with No Education,111090,74803,185893
10137,8,State - RAJASTHAN,Rural,25-29,Literate with No Education,101155,60746,161901
10138,8,State - RAJASTHAN,Rural,30-34,Literate with No Education,83758,49882,133640
10139,8,State - RAJASTHAN,Rural,35-39,Literate with No Education,74311,40261,114572
10140,8,State - RAJASTHAN,Rural,40-44,Literate with No Education,62139,31260,93399
10141,8,State - RAJASTHAN,Rural,45-49,Literate with No Education,50404,24102,74506
10142,8,State - RAJASTHAN,Rural,50-54,Literate with No Education,40594,16670,57264
10143,8,State - RAJASTHAN,Rural,55-59,Literate with No Education,28150,13249,41399
10144,8,State - RAJASTHAN,Rural,60-64,Literate with No Education,25955,11465,37420
10145,8,State - RAJASTHAN,Rural,65-69,Literate with No Education,17270,8320,25590
10146,8,State - RAJASTHAN,Rural,70-74,Literate with No Education,13797,6230,20027
10147,8,State - RAJASTHAN,Rural,75-79,Literate with No Education,6075,3123,9198
10148,8,State - RAJASTHAN,Rural,80+,Literate with No Education,7267,4008,11275
10149,8,State - RAJASTHAN,Rural,Age not stated,Literate with No Education,12640,7480,20120
10150,8,State - RAJASTHAN,Urban,All ages,Literate with No Education,292861,241883,534744
10151,8,State - RAJASTHAN,Urban,0-6,Literate with No Education,0,0,0
10152,8,State - RAJASTHAN,Urban,7,Literate with No Education,3370,2072,5442
10153,8,State - RAJASTHAN,Urban,8,Literate with No Education,2817,1715,4532
10154,8,State - RAJASTHAN,Urban,9,Literate with No Education,2305,1427,3732
10155,8,State - RAJASTHAN,Urban,10,Literate with No Education,3070,1876,4946
10156,8,State - RAJASTHAN,Urban,11,Literate with No Education,2536,1577,4113
10157,8,State - RAJASTHAN,Urban,12,Literate with No Education,2897,2082,4979
10158,8,State - RAJASTHAN,Urban,13,Literate with No Education,2614,1880,4494
10159,8,State - RAJASTHAN,Urban,14,Literate with No Education,2824,2260,5084
10160,8,State - RAJASTHAN,Urban,15,Literate with No Education,3647,2841,6488
10161,8,State - RAJASTHAN,Urban,16,Literate with No Education,3959,3271,7230
10162,8,State - RAJASTHAN,Urban,17,Literate with No Education,4180,3300,7480
10163,8,State - RAJASTHAN,Urban,18,Literate with No Education,6636,5384,12020
10164,8,State - RAJASTHAN,Urban,19,Literate with No Education,5144,4212,9356
10165,8,State - RAJASTHAN,Urban,20-24,Literate with No Education,35620,30442,66062
10166,8,State - RAJASTHAN,Urban,25-29,Literate with No Education,38956,32935,71891
10167,8,State - RAJASTHAN,Urban,30-34,Literate with No Education,32758,28313,61071
10168,8,State - RAJASTHAN,Urban,35-39,Literate with No Education,29408,25350,54758
10169,8,State - RAJASTHAN,Urban,40-44,Literate with No Education,25072,21328,46400
10170,8,State - RAJASTHAN,Urban,45-49,Literate with No Education,21675,18116,39791
10171,8,State - RAJASTHAN,Urban,50-54,Literate with No Education,17789,13906,31695
10172,8,State - RAJASTHAN,Urban,55-59,Literate with No Education,12845,10422,23267
10173,8,State - RAJASTHAN,Urban,60-64,Literate with No Education,10292,8381,18673
10174,8,State - RAJASTHAN,Urban,65-69,Literate with No Education,6839,5938,12777
10175,8,State - RAJASTHAN,Urban,70-74,Literate with No Education,5247,4424,9671
10176,8,State - RAJASTHAN,Urban,75-79,Literate with No Education,2822,2516,5338
10177,8,State - RAJASTHAN,Urban,80+,Literate with No Education,3224,3204,6428
10178,8,State - RAJASTHAN,Urban,Age not stated,Literate with No Education,4315,2711,7026
10179,9,State - UTTAR PRADESH,Total,All ages,Literate with No Education,3219206,2162260,5381466
10180,9,State - UTTAR PRADESH,Total,0-6,Literate with No Education,0,0,0
10181,9,State - UTTAR PRADESH,Total,7,Literate with No Education,62624,40207,102831
10182,9,State - UTTAR PRADESH,Total,8,Literate with No Education,52797,35764,88561
10183,9,State - UTTAR PRADESH,Total,9,Literate with No Education,40606,27735,68341
10184,9,State - UTTAR PRADESH,Total,10,Literate with No Education,58113,38384,96497
10185,9,State - UTTAR PRADESH,Total,11,Literate with No Education,40954,28369,69323
10186,9,State - UTTAR PRADESH,Total,12,Literate with No Education,47307,33697,81004
10187,9,State - UTTAR PRADESH,Total,13,Literate with No Education,38105,28905,67010
10188,9,State - UTTAR PRADESH,Total,14,Literate with No Education,46895,36510,83405
10189,9,State - UTTAR PRADESH,Total,15,Literate with No Education,57264,42493,99757
10190,9,State - UTTAR PRADESH,Total,16,Literate with No Education,59240,46076,105316
10191,9,State - UTTAR PRADESH,Total,17,Literate with No Education,52053,39112,91165
10192,9,State - UTTAR PRADESH,Total,18,Literate with No Education,87079,61795,148874
10193,9,State - UTTAR PRADESH,Total,19,Literate with No Education,59378,43462,102840
10194,9,State - UTTAR PRADESH,Total,20-24,Literate with No Education,355437,258715,614152
10195,9,State - UTTAR PRADESH,Total,25-29,Literate with No Education,365179,264708,629887
10196,9,State - UTTAR PRADESH,Total,30-34,Literate with No Education,306453,224687,531140
10197,9,State - UTTAR PRADESH,Total,35-39,Literate with No Education,297928,200330,498258
10198,9,State - UTTAR PRADESH,Total,40-44,Literate with No Education,245018,152248,397266
10199,9,State - UTTAR PRADESH,Total,45-49,Literate with No Education,197214,123706,320920
10200,9,State - UTTAR PRADESH,Total,50-54,Literate with No Education,158015,89644,247659
10201,9,State - UTTAR PRADESH,Total,55-59,Literate with No Education,115804,77618,193422
10202,9,State - UTTAR PRADESH,Total,60-64,Literate with No Education,124508,70718,195226
10203,9,State - UTTAR PRADESH,Total,65-69,Literate with No Education,81551,47107,128658
10204,9,State - UTTAR PRADESH,Total,70-74,Literate with No Education,62064,32859,94923
10205,9,State - UTTAR PRADESH,Total,75-79,Literate with No Education,27229,16447,43676
10206,9,State - UTTAR PRADESH,Total,80+,Literate with No Education,43361,26816,70177
10207,9,State - UTTAR PRADESH,Total,Age not stated,Literate with No Education,137030,74148,211178
10208,9,State - UTTAR PRADESH,Rural,All ages,Literate with No Education,2347662,1497571,3845233
10209,9,State - UTTAR PRADESH,Rural,0-6,Literate with No Education,0,0,0
10210,9,State - UTTAR PRADESH,Rural,7,Literate with No Education,48203,30966,79169
10211,9,State - UTTAR PRADESH,Rural,8,Literate with No Education,40705,28205,68910
10212,9,State - UTTAR PRADESH,Rural,9,Literate with No Education,30439,21134,51573
10213,9,State - UTTAR PRADESH,Rural,10,Literate with No Education,44383,29797,74180
10214,9,State - UTTAR PRADESH,Rural,11,Literate with No Education,30460,21476,51936
10215,9,State - UTTAR PRADESH,Rural,12,Literate with No Education,35692,26059,61751
10216,9,State - UTTAR PRADESH,Rural,13,Literate with No Education,28456,22228,50684
10217,9,State - UTTAR PRADESH,Rural,14,Literate with No Education,35210,28142,63352
10218,9,State - UTTAR PRADESH,Rural,15,Literate with No Education,43682,33285,76967
10219,9,State - UTTAR PRADESH,Rural,16,Literate with No Education,44881,35794,80675
10220,9,State - UTTAR PRADESH,Rural,17,Literate with No Education,38501,29408,67909
10221,9,State - UTTAR PRADESH,Rural,18,Literate with No Education,65881,47301,113182
10222,9,State - UTTAR PRADESH,Rural,19,Literate with No Education,42652,32065,74717
10223,9,State - UTTAR PRADESH,Rural,20-24,Literate with No Education,257434,184663,442097
10224,9,State - UTTAR PRADESH,Rural,25-29,Literate with No Education,260094,179669,439763
10225,9,State - UTTAR PRADESH,Rural,30-34,Literate with No Education,220720,152456,373176
10226,9,State - UTTAR PRADESH,Rural,35-39,Literate with No Education,215858,132498,348356
10227,9,State - UTTAR PRADESH,Rural,40-44,Literate with No Education,175528,97473,273001
10228,9,State - UTTAR PRADESH,Rural,45-49,Literate with No Education,138917,76792,215709
10229,9,State - UTTAR PRADESH,Rural,50-54,Literate with No Education,111439,55024,166463
10230,9,State - UTTAR PRADESH,Rural,55-59,Literate with No Education,81982,50005,131987
10231,9,State - UTTAR PRADESH,Rural,60-64,Literate with No Education,93944,47490,141434
10232,9,State - UTTAR PRADESH,Rural,65-69,Literate with No Education,62350,32416,94766
10233,9,State - UTTAR PRADESH,Rural,70-74,Literate with No Education,48097,22341,70438
10234,9,State - UTTAR PRADESH,Rural,75-79,Literate with No Education,20581,10973,31554
10235,9,State - UTTAR PRADESH,Rural,80+,Literate with No Education,32595,17866,50461
10236,9,State - UTTAR PRADESH,Rural,Age not stated,Literate with No Education,98978,52045,151023
10237,9,State - UTTAR PRADESH,Urban,All ages,Literate with No Education,871544,664689,1536233
10238,9,State - UTTAR PRADESH,Urban,0-6,Literate with No Education,0,0,0
10239,9,State - UTTAR PRADESH,Urban,7,Literate with No Education,14421,9241,23662
10240,9,State - UTTAR PRADESH,Urban,8,Literate with No Education,12092,7559,19651
10241,9,State - UTTAR PRADESH,Urban,9,Literate with No Education,10167,6601,16768
10242,9,State - UTTAR PRADESH,Urban,10,Literate with No Education,13730,8587,22317
10243,9,State - UTTAR PRADESH,Urban,11,Literate with No Education,10494,6893,17387
10244,9,State - UTTAR PRADESH,Urban,12,Literate with No Education,11615,7638,19253
10245,9,State - UTTAR PRADESH,Urban,13,Literate with No Education,9649,6677,16326
10246,9,State - UTTAR PRADESH,Urban,14,Literate with No Education,11685,8368,20053
10247,9,State - UTTAR PRADESH,Urban,15,Literate with No Education,13582,9208,22790
10248,9,State - UTTAR PRADESH,Urban,16,Literate with No Education,14359,10282,24641
10249,9,State - UTTAR PRADESH,Urban,17,Literate with No Education,13552,9704,23256
10250,9,State - UTTAR PRADESH,Urban,18,Literate with No Education,21198,14494,35692
10251,9,State - UTTAR PRADESH,Urban,19,Literate with No Education,16726,11397,28123
10252,9,State - UTTAR PRADESH,Urban,20-24,Literate with No Education,98003,74052,172055
10253,9,State - UTTAR PRADESH,Urban,25-29,Literate with No Education,105085,85039,190124
10254,9,State - UTTAR PRADESH,Urban,30-34,Literate with No Education,85733,72231,157964
10255,9,State - UTTAR PRADESH,Urban,35-39,Literate with No Education,82070,67832,149902
10256,9,State - UTTAR PRADESH,Urban,40-44,Literate with No Education,69490,54775,124265
10257,9,State - UTTAR PRADESH,Urban,45-49,Literate with No Education,58297,46914,105211
10258,9,State - UTTAR PRADESH,Urban,50-54,Literate with No Education,46576,34620,81196
10259,9,State - UTTAR PRADESH,Urban,55-59,Literate with No Education,33822,27613,61435
10260,9,State - UTTAR PRADESH,Urban,60-64,Literate with No Education,30564,23228,53792
10261,9,State - UTTAR PRADESH,Urban,65-69,Literate with No Education,19201,14691,33892
10262,9,State - UTTAR PRADESH,Urban,70-74,Literate with No Education,13967,10518,24485
10263,9,State - UTTAR PRADESH,Urban,75-79,Literate with No Education,6648,5474,12122
10264,9,State - UTTAR PRADESH,Urban,80+,Literate with No Education,10766,8950,19716
10265,9,State - UTTAR PRADESH,Urban,Age not stated,Literate with No Education,38052,22103,60155
10266,10,State - BIHAR,Total,All ages,Literate with No Education,1748926,1277073,3025999
10267,10,State - BIHAR,Total,0-6,Literate with No Education,0,0,0
10268,10,State - BIHAR,Total,7,Literate with No Education,38145,27323,65468
10269,10,State - BIHAR,Total,8,Literate with No Education,36165,27069,63234
10270,10,State - BIHAR,Total,9,Literate with No Education,25688,18907,44595
10271,10,State - BIHAR,Total,10,Literate with No Education,38237,27418,65655
10272,10,State - BIHAR,Total,11,Literate with No Education,24753,17597,42350
10273,10,State - BIHAR,Total,12,Literate with No Education,31101,22755,53856
10274,10,State - BIHAR,Total,13,Literate with No Education,21948,16759,38707
10275,10,State - BIHAR,Total,14,Literate with No Education,26120,18952,45072
10276,10,State - BIHAR,Total,15,Literate with No Education,32791,21223,54014
10277,10,State - BIHAR,Total,16,Literate with No Education,31383,20810,52193
10278,10,State - BIHAR,Total,17,Literate with No Education,23815,15871,39686
10279,10,State - BIHAR,Total,18,Literate with No Education,43963,29712,73675
10280,10,State - BIHAR,Total,19,Literate with No Education,26796,22909,49705
10281,10,State - BIHAR,Total,20-24,Literate with No Education,176121,147936,324057
10282,10,State - BIHAR,Total,25-29,Literate with No Education,202818,171746,374564
10283,10,State - BIHAR,Total,30-34,Literate with No Education,180894,154095,334989
10284,10,State - BIHAR,Total,35-39,Literate with No Education,167048,128623,295671
10285,10,State - BIHAR,Total,40-44,Literate with No Education,134429,91179,225608
10286,10,State - BIHAR,Total,45-49,Literate with No Education,105211,72119,177330
10287,10,State - BIHAR,Total,50-54,Literate with No Education,83672,50190,133862
10288,10,State - BIHAR,Total,55-59,Literate with No Education,61964,44937,106901
10289,10,State - BIHAR,Total,60-64,Literate with No Education,71310,42511,113821
10290,10,State - BIHAR,Total,65-69,Literate with No Education,50753,27882,78635
10291,10,State - BIHAR,Total,70-74,Literate with No Education,36155,16823,52978
10292,10,State - BIHAR,Total,75-79,Literate with No Education,14352,7705,22057
10293,10,State - BIHAR,Total,80+,Literate with No Education,19058,10981,30039
10294,10,State - BIHAR,Total,Age not stated,Literate with No Education,44236,23041,67277
10295,10,State - BIHAR,Rural,All ages,Literate with No Education,1550711,1110474,2661185
10296,10,State - BIHAR,Rural,0-6,Literate with No Education,0,0,0
10297,10,State - BIHAR,Rural,7,Literate with No Education,34102,24391,58493
10298,10,State - BIHAR,Rural,8,Literate with No Education,32560,24455,57015
10299,10,State - BIHAR,Rural,9,Literate with No Education,23172,17020,40192
10300,10,State - BIHAR,Rural,10,Literate with No Education,34566,24834,59400
10301,10,State - BIHAR,Rural,11,Literate with No Education,22298,15816,38114
10302,10,State - BIHAR,Rural,12,Literate with No Education,28160,20646,48806
10303,10,State - BIHAR,Rural,13,Literate with No Education,19946,15131,35077
10304,10,State - BIHAR,Rural,14,Literate with No Education,23570,17060,40630
10305,10,State - BIHAR,Rural,15,Literate with No Education,29881,19142,49023
10306,10,State - BIHAR,Rural,16,Literate with No Education,28422,18523,46945
10307,10,State - BIHAR,Rural,17,Literate with No Education,21453,14172,35625
10308,10,State - BIHAR,Rural,18,Literate with No Education,39735,26662,66397
10309,10,State - BIHAR,Rural,19,Literate with No Education,24010,20546,44556
10310,10,State - BIHAR,Rural,20-24,Literate with No Education,157028,131447,288475
10311,10,State - BIHAR,Rural,25-29,Literate with No Education,179030,150494,329524
10312,10,State - BIHAR,Rural,30-34,Literate with No Education,160087,134917,295004
10313,10,State - BIHAR,Rural,35-39,Literate with No Education,148229,111430,259659
10314,10,State - BIHAR,Rural,40-44,Literate with No Education,117959,77426,195385
10315,10,State - BIHAR,Rural,45-49,Literate with No Education,91820,60300,152120
10316,10,State - BIHAR,Rural,50-54,Literate with No Education,73018,41353,114371
10317,10,State - BIHAR,Rural,55-59,Literate with No Education,53720,37418,91138
10318,10,State - BIHAR,Rural,60-64,Literate with No Education,62993,35507,98500
10319,10,State - BIHAR,Rural,65-69,Literate with No Education,45308,23267,68575
10320,10,State - BIHAR,Rural,70-74,Literate with No Education,32067,13913,45980
10321,10,State - BIHAR,Rural,75-79,Literate with No Education,12713,6251,18964
10322,10,State - BIHAR,Rural,80+,Literate with No Education,16757,8925,25682
10323,10,State - BIHAR,Rural,Age not stated,Literate with No Education,38107,19428,57535
10324,10,State - BIHAR,Urban,All ages,Literate with No Education,198215,166599,364814
10325,10,State - BIHAR,Urban,0-6,Literate with No Education,0,0,0
10326,10,State - BIHAR,Urban,7,Literate with No Education,4043,2932,6975
10327,10,State - BIHAR,Urban,8,Literate with No Education,3605,2614,6219
10328,10,State - BIHAR,Urban,9,Literate with No Education,2516,1887,4403
10329,10,State - BIHAR,Urban,10,Literate with No Education,3671,2584,6255
10330,10,State - BIHAR,Urban,11,Literate with No Education,2455,1781,4236
10331,10,State - BIHAR,Urban,12,Literate with No Education,2941,2109,5050
10332,10,State - BIHAR,Urban,13,Literate with No Education,2002,1628,3630
10333,10,State - BIHAR,Urban,14,Literate with No Education,2550,1892,4442
10334,10,State - BIHAR,Urban,15,Literate with No Education,2910,2081,4991
10335,10,State - BIHAR,Urban,16,Literate with No Education,2961,2287,5248
10336,10,State - BIHAR,Urban,17,Literate with No Education,2362,1699,4061
10337,10,State - BIHAR,Urban,18,Literate with No Education,4228,3050,7278
10338,10,State - BIHAR,Urban,19,Literate with No Education,2786,2363,5149
10339,10,State - BIHAR,Urban,20-24,Literate with No Education,19093,16489,35582
10340,10,State - BIHAR,Urban,25-29,Literate with No Education,23788,21252,45040
10341,10,State - BIHAR,Urban,30-34,Literate with No Education,20807,19178,39985
10342,10,State - BIHAR,Urban,35-39,Literate with No Education,18819,17193,36012
10343,10,State - BIHAR,Urban,40-44,Literate with No Education,16470,13753,30223
10344,10,State - BIHAR,Urban,45-49,Literate with No Education,13391,11819,25210
10345,10,State - BIHAR,Urban,50-54,Literate with No Education,10654,8837,19491
10346,10,State - BIHAR,Urban,55-59,Literate with No Education,8244,7519,15763
10347,10,State - BIHAR,Urban,60-64,Literate with No Education,8317,7004,15321
10348,10,State - BIHAR,Urban,65-69,Literate with No Education,5445,4615,10060
10349,10,State - BIHAR,Urban,70-74,Literate with No Education,4088,2910,6998
10350,10,State - BIHAR,Urban,75-79,Literate with No Education,1639,1454,3093
10351,10,State - BIHAR,Urban,80+,Literate with No Education,2301,2056,4357
10352,10,State - BIHAR,Urban,Age not stated,Literate with No Education,6129,3613,9742
10353,11,State - SIKKIM,Total,All ages,Literate with No Education,10158,7470,17628
10354,11,State - SIKKIM,Total,0-6,Literate with No Education,0,0,0
10355,11,State - SIKKIM,Total,7,Literate with No Education,90,52,142
10356,11,State - SIKKIM,Total,8,Literate with No Education,56,44,100
10357,11,State - SIKKIM,Total,9,Literate with No Education,64,50,114
10358,11,State - SIKKIM,Total,10,Literate with No Education,91,51,142
10359,11,State - SIKKIM,Total,11,Literate with No Education,83,46,129
10360,11,State - SIKKIM,Total,12,Literate with No Education,84,53,137
10361,11,State - SIKKIM,Total,13,Literate with No Education,101,61,162
10362,11,State - SIKKIM,Total,14,Literate with No Education,110,71,181
10363,11,State - SIKKIM,Total,15,Literate with No Education,121,82,203
10364,11,State - SIKKIM,Total,16,Literate with No Education,123,97,220
10365,11,State - SIKKIM,Total,17,Literate with No Education,151,99,250
10366,11,State - SIKKIM,Total,18,Literate with No Education,183,134,317
10367,11,State - SIKKIM,Total,19,Literate with No Education,210,172,382
10368,11,State - SIKKIM,Total,20-24,Literate with No Education,1229,1032,2261
10369,11,State - SIKKIM,Total,25-29,Literate with No Education,1552,1331,2883
10370,11,State - SIKKIM,Total,30-34,Literate with No Education,1226,1018,2244
10371,11,State - SIKKIM,Total,35-39,Literate with No Education,987,814,1801
10372,11,State - SIKKIM,Total,40-44,Literate with No Education,828,632,1460
10373,11,State - SIKKIM,Total,45-49,Literate with No Education,670,487,1157
10374,11,State - SIKKIM,Total,50-54,Literate with No Education,549,375,924
10375,11,State - SIKKIM,Total,55-59,Literate with No Education,440,236,676
10376,11,State - SIKKIM,Total,60-64,Literate with No Education,334,154,488
10377,11,State - SIKKIM,Total,65-69,Literate with No Education,276,141,417
10378,11,State - SIKKIM,Total,70-74,Literate with No Education,235,75,310
10379,11,State - SIKKIM,Total,75-79,Literate with No Education,157,48,205
10380,11,State - SIKKIM,Total,80+,Literate with No Education,135,65,200
10381,11,State - SIKKIM,Total,Age not stated,Literate with No Education,73,50,123
10382,11,State - SIKKIM,Rural,All ages,Literate with No Education,8185,5552,13737
10383,11,State - SIKKIM,Rural,0-6,Literate with No Education,0,0,0
10384,11,State - SIKKIM,Rural,7,Literate with No Education,76,46,122
10385,11,State - SIKKIM,Rural,8,Literate with No Education,48,34,82
10386,11,State - SIKKIM,Rural,9,Literate with No Education,59,39,98
10387,11,State - SIKKIM,Rural,10,Literate with No Education,78,44,122
10388,11,State - SIKKIM,Rural,11,Literate with No Education,66,35,101
10389,11,State - SIKKIM,Rural,12,Literate with No Education,67,41,108
10390,11,State - SIKKIM,Rural,13,Literate with No Education,84,48,132
10391,11,State - SIKKIM,Rural,14,Literate with No Education,94,52,146
10392,11,State - SIKKIM,Rural,15,Literate with No Education,109,64,173
10393,11,State - SIKKIM,Rural,16,Literate with No Education,104,79,183
10394,11,State - SIKKIM,Rural,17,Literate with No Education,131,79,210
10395,11,State - SIKKIM,Rural,18,Literate with No Education,160,105,265
10396,11,State - SIKKIM,Rural,19,Literate with No Education,175,132,307
10397,11,State - SIKKIM,Rural,20-24,Literate with No Education,1011,805,1816
10398,11,State - SIKKIM,Rural,25-29,Literate with No Education,1201,963,2164
10399,11,State - SIKKIM,Rural,30-34,Literate with No Education,966,754,1720
10400,11,State - SIKKIM,Rural,35-39,Literate with No Education,753,579,1332
10401,11,State - SIKKIM,Rural,40-44,Literate with No Education,646,470,1116
10402,11,State - SIKKIM,Rural,45-49,Literate with No Education,531,353,884
10403,11,State - SIKKIM,Rural,50-54,Literate with No Education,445,258,703
10404,11,State - SIKKIM,Rural,55-59,Literate with No Education,355,177,532
10405,11,State - SIKKIM,Rural,60-64,Literate with No Education,284,112,396
10406,11,State - SIKKIM,Rural,65-69,Literate with No Education,241,100,341
10407,11,State - SIKKIM,Rural,70-74,Literate with No Education,198,60,258
10408,11,State - SIKKIM,Rural,75-79,Literate with No Education,128,33,161
10409,11,State - SIKKIM,Rural,80+,Literate with No Education,117,49,166
10410,11,State - SIKKIM,Rural,Age not stated,Literate with No Education,58,41,99
10411,11,State - SIKKIM,Urban,All ages,Literate with No Education,1973,1918,3891
10412,11,State - SIKKIM,Urban,0-6,Literate with No Education,0,0,0
10413,11,State - SIKKIM,Urban,7,Literate with No Education,14,6,20
10414,11,State - SIKKIM,Urban,8,Literate with No Education,8,10,18
10415,11,State - SIKKIM,Urban,9,Literate with No Education,5,11,16
10416,11,State - SIKKIM,Urban,10,Literate with No Education,13,7,20
10417,11,State - SIKKIM,Urban,11,Literate with No Education,17,11,28
10418,11,State - SIKKIM,Urban,12,Literate with No Education,17,12,29
10419,11,State - SIKKIM,Urban,13,Literate with No Education,17,13,30
10420,11,State - SIKKIM,Urban,14,Literate with No Education,16,19,35
10421,11,State - SIKKIM,Urban,15,Literate with No Education,12,18,30
10422,11,State - SIKKIM,Urban,16,Literate with No Education,19,18,37
10423,11,State - SIKKIM,Urban,17,Literate with No Education,20,20,40
10424,11,State - SIKKIM,Urban,18,Literate with No Education,23,29,52
10425,11,State - SIKKIM,Urban,19,Literate with No Education,35,40,75
10426,11,State - SIKKIM,Urban,20-24,Literate with No Education,218,227,445
10427,11,State - SIKKIM,Urban,25-29,Literate with No Education,351,368,719
10428,11,State - SIKKIM,Urban,30-34,Literate with No Education,260,264,524
10429,11,State - SIKKIM,Urban,35-39,Literate with No Education,234,235,469
10430,11,State - SIKKIM,Urban,40-44,Literate with No Education,182,162,344
10431,11,State - SIKKIM,Urban,45-49,Literate with No Education,139,134,273
10432,11,State - SIKKIM,Urban,50-54,Literate with No Education,104,117,221
10433,11,State - SIKKIM,Urban,55-59,Literate with No Education,85,59,144
10434,11,State - SIKKIM,Urban,60-64,Literate with No Education,50,42,92
10435,11,State - SIKKIM,Urban,65-69,Literate with No Education,35,41,76
10436,11,State - SIKKIM,Urban,70-74,Literate with No Education,37,15,52
10437,11,State - SIKKIM,Urban,75-79,Literate with No Education,29,15,44
10438,11,State - SIKKIM,Urban,80+,Literate with No Education,18,16,34
10439,11,State - SIKKIM,Urban,Age not stated,Literate with No Education,15,9,24
10440,12,State - ARUNACHAL PRADESH,Total,All ages,Literate with No Education,12529,9122,21651
10441,12,State - ARUNACHAL PRADESH,Total,0-6,Literate with No Education,0,0,0
10442,12,State - ARUNACHAL PRADESH,Total,7,Literate with No Education,228,162,390
10443,12,State - ARUNACHAL PRADESH,Total,8,Literate with No Education,209,143,352
10444,12,State - ARUNACHAL PRADESH,Total,9,Literate with No Education,185,112,297
10445,12,State - ARUNACHAL PRADESH,Total,10,Literate with No Education,196,167,363
10446,12,State - ARUNACHAL PRADESH,Total,11,Literate with No Education,151,143,294
10447,12,State - ARUNACHAL PRADESH,Total,12,Literate with No Education,184,126,310
10448,12,State - ARUNACHAL PRADESH,Total,13,Literate with No Education,160,129,289
10449,12,State - ARUNACHAL PRADESH,Total,14,Literate with No Education,159,133,292
10450,12,State - ARUNACHAL PRADESH,Total,15,Literate with No Education,171,115,286
10451,12,State - ARUNACHAL PRADESH,Total,16,Literate with No Education,160,131,291
10452,12,State - ARUNACHAL PRADESH,Total,17,Literate with No Education,146,132,278
10453,12,State - ARUNACHAL PRADESH,Total,18,Literate with No Education,230,182,412
10454,12,State - ARUNACHAL PRADESH,Total,19,Literate with No Education,151,168,319
10455,12,State - ARUNACHAL PRADESH,Total,20-24,Literate with No Education,1119,1075,2194
10456,12,State - ARUNACHAL PRADESH,Total,25-29,Literate with No Education,1940,1620,3560
10457,12,State - ARUNACHAL PRADESH,Total,30-34,Literate with No Education,1693,1187,2880
10458,12,State - ARUNACHAL PRADESH,Total,35-39,Literate with No Education,1378,1062,2440
10459,12,State - ARUNACHAL PRADESH,Total,40-44,Literate with No Education,1150,702,1852
10460,12,State - ARUNACHAL PRADESH,Total,45-49,Literate with No Education,906,530,1436
10461,12,State - ARUNACHAL PRADESH,Total,50-54,Literate with No Education,647,334,981
10462,12,State - ARUNACHAL PRADESH,Total,55-59,Literate with No Education,418,189,607
10463,12,State - ARUNACHAL PRADESH,Total,60-64,Literate with No Education,304,173,477
10464,12,State - ARUNACHAL PRADESH,Total,65-69,Literate with No Education,158,118,276
10465,12,State - ARUNACHAL PRADESH,Total,70-74,Literate with No Education,123,76,199
10466,12,State - ARUNACHAL PRADESH,Total,75-79,Literate with No Education,67,31,98
10467,12,State - ARUNACHAL PRADESH,Total,80+,Literate with No Education,104,73,177
10468,12,State - ARUNACHAL PRADESH,Total,Age not stated,Literate with No Education,192,109,301
10469,12,State - ARUNACHAL PRADESH,Rural,All ages,Literate with No Education,9511,6896,16407
10470,12,State - ARUNACHAL PRADESH,Rural,0-6,Literate with No Education,0,0,0
10471,12,State - ARUNACHAL PRADESH,Rural,7,Literate with No Education,194,122,316
10472,12,State - ARUNACHAL PRADESH,Rural,8,Literate with No Education,171,119,290
10473,12,State - ARUNACHAL PRADESH,Rural,9,Literate with No Education,151,88,239
10474,12,State - ARUNACHAL PRADESH,Rural,10,Literate with No Education,163,131,294
10475,12,State - ARUNACHAL PRADESH,Rural,11,Literate with No Education,126,109,235
10476,12,State - ARUNACHAL PRADESH,Rural,12,Literate with No Education,158,97,255
10477,12,State - ARUNACHAL PRADESH,Rural,13,Literate with No Education,133,108,241
10478,12,State - ARUNACHAL PRADESH,Rural,14,Literate with No Education,133,111,244
10479,12,State - ARUNACHAL PRADESH,Rural,15,Literate with No Education,149,93,242
10480,12,State - ARUNACHAL PRADESH,Rural,16,Literate with No Education,137,98,235
10481,12,State - ARUNACHAL PRADESH,Rural,17,Literate with No Education,120,99,219
10482,12,State - ARUNACHAL PRADESH,Rural,18,Literate with No Education,173,144,317
10483,12,State - ARUNACHAL PRADESH,Rural,19,Literate with No Education,124,130,254
10484,12,State - ARUNACHAL PRADESH,Rural,20-24,Literate with No Education,881,846,1727
10485,12,State - ARUNACHAL PRADESH,Rural,25-29,Literate with No Education,1386,1226,2612
10486,12,State - ARUNACHAL PRADESH,Rural,30-34,Literate with No Education,1182,864,2046
10487,12,State - ARUNACHAL PRADESH,Rural,35-39,Literate with No Education,1003,739,1742
10488,12,State - ARUNACHAL PRADESH,Rural,40-44,Literate with No Education,829,485,1314
10489,12,State - ARUNACHAL PRADESH,Rural,45-49,Literate with No Education,683,383,1066
10490,12,State - ARUNACHAL PRADESH,Rural,50-54,Literate with No Education,467,261,728
10491,12,State - ARUNACHAL PRADESH,Rural,55-59,Literate with No Education,323,152,475
10492,12,State - ARUNACHAL PRADESH,Rural,60-64,Literate with No Education,266,142,408
10493,12,State - ARUNACHAL PRADESH,Rural,65-69,Literate with No Education,134,97,231
10494,12,State - ARUNACHAL PRADESH,Rural,70-74,Literate with No Education,114,65,179
10495,12,State - ARUNACHAL PRADESH,Rural,75-79,Literate with No Education,61,25,86
10496,12,State - ARUNACHAL PRADESH,Rural,80+,Literate with No Education,91,64,155
10497,12,State - ARUNACHAL PRADESH,Rural,Age not stated,Literate with No Education,159,98,257
10498,12,State - ARUNACHAL PRADESH,Urban,All ages,Literate with No Education,3018,2226,5244
10499,12,State - ARUNACHAL PRADESH,Urban,0-6,Literate with No Education,0,0,0
10500,12,State - ARUNACHAL PRADESH,Urban,7,Literate with No Education,34,40,74
10501,12,State - ARUNACHAL PRADESH,Urban,8,Literate with No Education,38,24,62
10502,12,State - ARUNACHAL PRADESH,Urban,9,Literate with No Education,34,24,58
10503,12,State - ARUNACHAL PRADESH,Urban,10,Literate with No Education,33,36,69
10504,12,State - ARUNACHAL PRADESH,Urban,11,Literate with No Education,25,34,59
10505,12,State - ARUNACHAL PRADESH,Urban,12,Literate with No Education,26,29,55
10506,12,State - ARUNACHAL PRADESH,Urban,13,Literate with No Education,27,21,48
10507,12,State - ARUNACHAL PRADESH,Urban,14,Literate with No Education,26,22,48
10508,12,State - ARUNACHAL PRADESH,Urban,15,Literate with No Education,22,22,44
10509,12,State - ARUNACHAL PRADESH,Urban,16,Literate with No Education,23,33,56
10510,12,State - ARUNACHAL PRADESH,Urban,17,Literate with No Education,26,33,59
10511,12,State - ARUNACHAL PRADESH,Urban,18,Literate with No Education,57,38,95
10512,12,State - ARUNACHAL PRADESH,Urban,19,Literate with No Education,27,38,65
10513,12,State - ARUNACHAL PRADESH,Urban,20-24,Literate with No Education,238,229,467
10514,12,State - ARUNACHAL PRADESH,Urban,25-29,Literate with No Education,554,394,948
10515,12,State - ARUNACHAL PRADESH,Urban,30-34,Literate with No Education,511,323,834
10516,12,State - ARUNACHAL PRADESH,Urban,35-39,Literate with No Education,375,323,698
10517,12,State - ARUNACHAL PRADESH,Urban,40-44,Literate with No Education,321,217,538
10518,12,State - ARUNACHAL PRADESH,Urban,45-49,Literate with No Education,223,147,370
10519,12,State - ARUNACHAL PRADESH,Urban,50-54,Literate with No Education,180,73,253
10520,12,State - ARUNACHAL PRADESH,Urban,55-59,Literate with No Education,95,37,132
10521,12,State - ARUNACHAL PRADESH,Urban,60-64,Literate with No Education,38,31,69
10522,12,State - ARUNACHAL PRADESH,Urban,65-69,Literate with No Education,24,21,45
10523,12,State - ARUNACHAL PRADESH,Urban,70-74,Literate with No Education,9,11,20
10524,12,State - ARUNACHAL PRADESH,Urban,75-79,Literate with No Education,6,6,12
10525,12,State - ARUNACHAL PRADESH,Urban,80+,Literate with No Education,13,9,22
10526,12,State - ARUNACHAL PRADESH,Urban,Age not stated,Literate with No Education,33,11,44
10527,13,State - NAGALAND,Total,All ages,Literate with No Education,39339,34505,73844
10528,13,State - NAGALAND,Total,0-6,Literate with No Education,0,0,0
10529,13,State - NAGALAND,Total,7,Literate with No Education,512,324,836
10530,13,State - NAGALAND,Total,8,Literate with No Education,513,310,823
10531,13,State - NAGALAND,Total,9,Literate with No Education,455,316,771
10532,13,State - NAGALAND,Total,10,Literate with No Education,548,366,914
10533,13,State - NAGALAND,Total,11,Literate with No Education,505,336,841
10534,13,State - NAGALAND,Total,12,Literate with No Education,543,351,894
10535,13,State - NAGALAND,Total,13,Literate with No Education,491,340,831
10536,13,State - NAGALAND,Total,14,Literate with No Education,557,381,938
10537,13,State - NAGALAND,Total,15,Literate with No Education,677,486,1163
10538,13,State - NAGALAND,Total,16,Literate with No Education,721,514,1235
10539,13,State - NAGALAND,Total,17,Literate with No Education,637,523,1160
10540,13,State - NAGALAND,Total,18,Literate with No Education,854,697,1551
10541,13,State - NAGALAND,Total,19,Literate with No Education,750,644,1394
10542,13,State - NAGALAND,Total,20-24,Literate with No Education,4808,4486,9294
10543,13,State - NAGALAND,Total,25-29,Literate with No Education,5627,5674,11301
10544,13,State - NAGALAND,Total,30-34,Literate with No Education,4676,4764,9440
10545,13,State - NAGALAND,Total,35-39,Literate with No Education,3859,4022,7881
10546,13,State - NAGALAND,Total,40-44,Literate with No Education,3332,2926,6258
10547,13,State - NAGALAND,Total,45-49,Literate with No Education,2737,2207,4944
10548,13,State - NAGALAND,Total,50-54,Literate with No Education,2095,1532,3627
10549,13,State - NAGALAND,Total,55-59,Literate with No Education,1309,1029,2338
10550,13,State - NAGALAND,Total,60-64,Literate with No Education,1054,815,1869
10551,13,State - NAGALAND,Total,65-69,Literate with No Education,692,522,1214
10552,13,State - NAGALAND,Total,70-74,Literate with No Education,469,337,806
10553,13,State - NAGALAND,Total,75-79,Literate with No Education,312,232,544
10554,13,State - NAGALAND,Total,80+,Literate with No Education,372,244,616
10555,13,State - NAGALAND,Total,Age not stated,Literate with No Education,234,127,361
10556,13,State - NAGALAND,Rural,All ages,Literate with No Education,27913,24872,52785
10557,13,State - NAGALAND,Rural,0-6,Literate with No Education,0,0,0
10558,13,State - NAGALAND,Rural,7,Literate with No Education,371,227,598
10559,13,State - NAGALAND,Rural,8,Literate with No Education,396,226,622
10560,13,State - NAGALAND,Rural,9,Literate with No Education,316,233,549
10561,13,State - NAGALAND,Rural,10,Literate with No Education,436,279,715
10562,13,State - NAGALAND,Rural,11,Literate with No Education,387,264,651
10563,13,State - NAGALAND,Rural,12,Literate with No Education,407,277,684
10564,13,State - NAGALAND,Rural,13,Literate with No Education,369,260,629
10565,13,State - NAGALAND,Rural,14,Literate with No Education,406,296,702
10566,13,State - NAGALAND,Rural,15,Literate with No Education,517,368,885
10567,13,State - NAGALAND,Rural,16,Literate with No Education,574,414,988
10568,13,State - NAGALAND,Rural,17,Literate with No Education,474,403,877
10569,13,State - NAGALAND,Rural,18,Literate with No Education,667,552,1219
10570,13,State - NAGALAND,Rural,19,Literate with No Education,535,490,1025
10571,13,State - NAGALAND,Rural,20-24,Literate with No Education,3534,3362,6896
10572,13,State - NAGALAND,Rural,25-29,Literate with No Education,3722,3897,7619
10573,13,State - NAGALAND,Rural,30-34,Literate with No Education,3165,3285,6450
10574,13,State - NAGALAND,Rural,35-39,Literate with No Education,2566,2855,5421
10575,13,State - NAGALAND,Rural,40-44,Literate with No Education,2279,2099,4378
10576,13,State - NAGALAND,Rural,45-49,Literate with No Education,1913,1531,3444
10577,13,State - NAGALAND,Rural,50-54,Literate with No Education,1489,1114,2603
10578,13,State - NAGALAND,Rural,55-59,Literate with No Education,946,725,1671
10579,13,State - NAGALAND,Rural,60-64,Literate with No Education,791,596,1387
10580,13,State - NAGALAND,Rural,65-69,Literate with No Education,544,381,925
10581,13,State - NAGALAND,Rural,70-74,Literate with No Education,372,267,639
10582,13,State - NAGALAND,Rural,75-79,Literate with No Education,241,178,419
10583,13,State - NAGALAND,Rural,80+,Literate with No Education,299,185,484
10584,13,State - NAGALAND,Rural,Age not stated,Literate with No Education,197,108,305
10585,13,State - NAGALAND,Urban,All ages,Literate with No Education,11426,9633,21059
10586,13,State - NAGALAND,Urban,0-6,Literate with No Education,0,0,0
10587,13,State - NAGALAND,Urban,7,Literate with No Education,141,97,238
10588,13,State - NAGALAND,Urban,8,Literate with No Education,117,84,201
10589,13,State - NAGALAND,Urban,9,Literate with No Education,139,83,222
10590,13,State - NAGALAND,Urban,10,Literate with No Education,112,87,199
10591,13,State - NAGALAND,Urban,11,Literate with No Education,118,72,190
10592,13,State - NAGALAND,Urban,12,Literate with No Education,136,74,210
10593,13,State - NAGALAND,Urban,13,Literate with No Education,122,80,202
10594,13,State - NAGALAND,Urban,14,Literate with No Education,151,85,236
10595,13,State - NAGALAND,Urban,15,Literate with No Education,160,118,278
10596,13,State - NAGALAND,Urban,16,Literate with No Education,147,100,247
10597,13,State - NAGALAND,Urban,17,Literate with No Education,163,120,283
10598,13,State - NAGALAND,Urban,18,Literate with No Education,187,145,332
10599,13,State - NAGALAND,Urban,19,Literate with No Education,215,154,369
10600,13,State - NAGALAND,Urban,20-24,Literate with No Education,1274,1124,2398
10601,13,State - NAGALAND,Urban,25-29,Literate with No Education,1905,1777,3682
10602,13,State - NAGALAND,Urban,30-34,Literate with No Education,1511,1479,2990
10603,13,State - NAGALAND,Urban,35-39,Literate with No Education,1293,1167,2460
10604,13,State - NAGALAND,Urban,40-44,Literate with No Education,1053,827,1880
10605,13,State - NAGALAND,Urban,45-49,Literate with No Education,824,676,1500
10606,13,State - NAGALAND,Urban,50-54,Literate with No Education,606,418,1024
10607,13,State - NAGALAND,Urban,55-59,Literate with No Education,363,304,667
10608,13,State - NAGALAND,Urban,60-64,Literate with No Education,263,219,482
10609,13,State - NAGALAND,Urban,65-69,Literate with No Education,148,141,289
10610,13,State - NAGALAND,Urban,70-74,Literate with No Education,97,70,167
10611,13,State - NAGALAND,Urban,75-79,Literate with No Education,71,54,125
10612,13,State - NAGALAND,Urban,80+,Literate with No Education,73,59,132
10613,13,State - NAGALAND,Urban,Age not stated,Literate with No Education,37,19,56
10614,14,State - MANIPUR,Total,All ages,Literate with No Education,47433,40958,88391
10615,14,State - MANIPUR,Total,0-6,Literate with No Education,0,0,0
10616,14,State - MANIPUR,Total,7,Literate with No Education,708,489,1197
10617,14,State - MANIPUR,Total,8,Literate with No Education,497,363,860
10618,14,State - MANIPUR,Total,9,Literate with No Education,426,337,763
10619,14,State - MANIPUR,Total,10,Literate with No Education,502,403,905
10620,14,State - MANIPUR,Total,11,Literate with No Education,424,347,771
10621,14,State - MANIPUR,Total,12,Literate with No Education,431,343,774
10622,14,State - MANIPUR,Total,13,Literate with No Education,384,325,709
10623,14,State - MANIPUR,Total,14,Literate with No Education,409,329,738
10624,14,State - MANIPUR,Total,15,Literate with No Education,473,415,888
10625,14,State - MANIPUR,Total,16,Literate with No Education,463,402,865
10626,14,State - MANIPUR,Total,17,Literate with No Education,476,461,937
10627,14,State - MANIPUR,Total,18,Literate with No Education,682,643,1325
10628,14,State - MANIPUR,Total,19,Literate with No Education,556,622,1178
10629,14,State - MANIPUR,Total,20-24,Literate with No Education,4628,4690,9318
10630,14,State - MANIPUR,Total,25-29,Literate with No Education,7162,6453,13615
10631,14,State - MANIPUR,Total,30-34,Literate with No Education,5626,5075,10701
10632,14,State - MANIPUR,Total,35-39,Literate with No Education,4760,4444,9204
10633,14,State - MANIPUR,Total,40-44,Literate with No Education,4361,3665,8026
10634,14,State - MANIPUR,Total,45-49,Literate with No Education,3636,3030,6666
10635,14,State - MANIPUR,Total,50-54,Literate with No Education,2856,2319,5175
10636,14,State - MANIPUR,Total,55-59,Literate with No Education,2115,1635,3750
10637,14,State - MANIPUR,Total,60-64,Literate with No Education,1663,1254,2917
10638,14,State - MANIPUR,Total,65-69,Literate with No Education,1018,888,1906
10639,14,State - MANIPUR,Total,70-74,Literate with No Education,791,620,1411
10640,14,State - MANIPUR,Total,75-79,Literate with No Education,588,404,992
10641,14,State - MANIPUR,Total,80+,Literate with No Education,671,531,1202
10642,14,State - MANIPUR,Total,Age not stated,Literate with No Education,1127,471,1598
10643,14,State - MANIPUR,Rural,All ages,Literate with No Education,35530,28876,64406
10644,14,State - MANIPUR,Rural,0-6,Literate with No Education,0,0,0
10645,14,State - MANIPUR,Rural,7,Literate with No Education,537,363,900
10646,14,State - MANIPUR,Rural,8,Literate with No Education,383,266,649
10647,14,State - MANIPUR,Rural,9,Literate with No Education,335,251,586
10648,14,State - MANIPUR,Rural,10,Literate with No Education,401,313,714
10649,14,State - MANIPUR,Rural,11,Literate with No Education,345,262,607
10650,14,State - MANIPUR,Rural,12,Literate with No Education,345,275,620
10651,14,State - MANIPUR,Rural,13,Literate with No Education,304,256,560
10652,14,State - MANIPUR,Rural,14,Literate with No Education,307,258,565
10653,14,State - MANIPUR,Rural,15,Literate with No Education,386,325,711
10654,14,State - MANIPUR,Rural,16,Literate with No Education,363,328,691
10655,14,State - MANIPUR,Rural,17,Literate with No Education,375,367,742
10656,14,State - MANIPUR,Rural,18,Literate with No Education,556,505,1061
10657,14,State - MANIPUR,Rural,19,Literate with No Education,447,486,933
10658,14,State - MANIPUR,Rural,20-24,Literate with No Education,3630,3550,7180
10659,14,State - MANIPUR,Rural,25-29,Literate with No Education,5406,4683,10089
10660,14,State - MANIPUR,Rural,30-34,Literate with No Education,4178,3628,7806
10661,14,State - MANIPUR,Rural,35-39,Literate with No Education,3511,3004,6515
10662,14,State - MANIPUR,Rural,40-44,Literate with No Education,3211,2513,5724
10663,14,State - MANIPUR,Rural,45-49,Literate with No Education,2680,2025,4705
10664,14,State - MANIPUR,Rural,50-54,Literate with No Education,2104,1544,3648
10665,14,State - MANIPUR,Rural,55-59,Literate with No Education,1500,1065,2565
10666,14,State - MANIPUR,Rural,60-64,Literate with No Education,1193,792,1985
10667,14,State - MANIPUR,Rural,65-69,Literate with No Education,741,551,1292
10668,14,State - MANIPUR,Rural,70-74,Literate with No Education,550,386,936
10669,14,State - MANIPUR,Rural,75-79,Literate with No Education,404,240,644
10670,14,State - MANIPUR,Rural,80+,Literate with No Education,441,306,747
10671,14,State - MANIPUR,Rural,Age not stated,Literate with No Education,897,334,1231
10672,14,State - MANIPUR,Urban,All ages,Literate with No Education,11903,12082,23985
10673,14,State - MANIPUR,Urban,0-6,Literate with No Education,0,0,0
10674,14,State - MANIPUR,Urban,7,Literate with No Education,171,126,297
10675,14,State - MANIPUR,Urban,8,Literate with No Education,114,97,211
10676,14,State - MANIPUR,Urban,9,Literate with No Education,91,86,177
10677,14,State - MANIPUR,Urban,10,Literate with No Education,101,90,191
10678,14,State - MANIPUR,Urban,11,Literate with No Education,79,85,164
10679,14,State - MANIPUR,Urban,12,Literate with No Education,86,68,154
10680,14,State - MANIPUR,Urban,13,Literate with No Education,80,69,149
10681,14,State - MANIPUR,Urban,14,Literate with No Education,102,71,173
10682,14,State - MANIPUR,Urban,15,Literate with No Education,87,90,177
10683,14,State - MANIPUR,Urban,16,Literate with No Education,100,74,174
10684,14,State - MANIPUR,Urban,17,Literate with No Education,101,94,195
10685,14,State - MANIPUR,Urban,18,Literate with No Education,126,138,264
10686,14,State - MANIPUR,Urban,19,Literate with No Education,109,136,245
10687,14,State - MANIPUR,Urban,20-24,Literate with No Education,998,1140,2138
10688,14,State - MANIPUR,Urban,25-29,Literate with No Education,1756,1770,3526
10689,14,State - MANIPUR,Urban,30-34,Literate with No Education,1448,1447,2895
10690,14,State - MANIPUR,Urban,35-39,Literate with No Education,1249,1440,2689
10691,14,State - MANIPUR,Urban,40-44,Literate with No Education,1150,1152,2302
10692,14,State - MANIPUR,Urban,45-49,Literate with No Education,956,1005,1961
10693,14,State - MANIPUR,Urban,50-54,Literate with No Education,752,775,1527
10694,14,State - MANIPUR,Urban,55-59,Literate with No Education,615,570,1185
10695,14,State - MANIPUR,Urban,60-64,Literate with No Education,470,462,932
10696,14,State - MANIPUR,Urban,65-69,Literate with No Education,277,337,614
10697,14,State - MANIPUR,Urban,70-74,Literate with No Education,241,234,475
10698,14,State - MANIPUR,Urban,75-79,Literate with No Education,184,164,348
10699,14,State - MANIPUR,Urban,80+,Literate with No Education,230,225,455
10700,14,State - MANIPUR,Urban,Age not stated,Literate with No Education,230,137,367
10701,15,State - MIZORAM,Total,All ages,Literate with No Education,6288,7181,13469
10702,15,State - MIZORAM,Total,0-6,Literate with No Education,0,0,0
10703,15,State - MIZORAM,Total,7,Literate with No Education,106,89,195
10704,15,State - MIZORAM,Total,8,Literate with No Education,56,43,99
10705,15,State - MIZORAM,Total,9,Literate with No Education,56,47,103
10706,15,State - MIZORAM,Total,10,Literate with No Education,64,78,142
10707,15,State - MIZORAM,Total,11,Literate with No Education,49,28,77
10708,15,State - MIZORAM,Total,12,Literate with No Education,38,49,87
10709,15,State - MIZORAM,Total,13,Literate with No Education,37,46,83
10710,15,State - MIZORAM,Total,14,Literate with No Education,51,49,100
10711,15,State - MIZORAM,Total,15,Literate with No Education,50,72,122
10712,15,State - MIZORAM,Total,16,Literate with No Education,60,73,133
10713,15,State - MIZORAM,Total,17,Literate with No Education,85,83,168
10714,15,State - MIZORAM,Total,18,Literate with No Education,103,95,198
10715,15,State - MIZORAM,Total,19,Literate with No Education,128,120,248
10716,15,State - MIZORAM,Total,20-24,Literate with No Education,677,740,1417
10717,15,State - MIZORAM,Total,25-29,Literate with No Education,826,878,1704
10718,15,State - MIZORAM,Total,30-34,Literate with No Education,698,782,1480
10719,15,State - MIZORAM,Total,35-39,Literate with No Education,594,654,1248
10720,15,State - MIZORAM,Total,40-44,Literate with No Education,474,520,994
10721,15,State - MIZORAM,Total,45-49,Literate with No Education,419,519,938
10722,15,State - MIZORAM,Total,50-54,Literate with No Education,401,489,890
10723,15,State - MIZORAM,Total,55-59,Literate with No Education,324,352,676
10724,15,State - MIZORAM,Total,60-64,Literate with No Education,251,337,588
10725,15,State - MIZORAM,Total,65-69,Literate with No Education,192,263,455
10726,15,State - MIZORAM,Total,70-74,Literate with No Education,149,223,372
10727,15,State - MIZORAM,Total,75-79,Literate with No Education,129,188,317
10728,15,State - MIZORAM,Total,80+,Literate with No Education,157,285,442
10729,15,State - MIZORAM,Total,Age not stated,Literate with No Education,114,79,193
10730,15,State - MIZORAM,Rural,All ages,Literate with No Education,3565,3693,7258
10731,15,State - MIZORAM,Rural,0-6,Literate with No Education,0,0,0
10732,15,State - MIZORAM,Rural,7,Literate with No Education,63,44,107
10733,15,State - MIZORAM,Rural,8,Literate with No Education,40,24,64
10734,15,State - MIZORAM,Rural,9,Literate with No Education,35,30,65
10735,15,State - MIZORAM,Rural,10,Literate with No Education,41,56,97
10736,15,State - MIZORAM,Rural,11,Literate with No Education,27,20,47
10737,15,State - MIZORAM,Rural,12,Literate with No Education,23,31,54
10738,15,State - MIZORAM,Rural,13,Literate with No Education,25,25,50
10739,15,State - MIZORAM,Rural,14,Literate with No Education,36,33,69
10740,15,State - MIZORAM,Rural,15,Literate with No Education,34,47,81
10741,15,State - MIZORAM,Rural,16,Literate with No Education,43,53,96
10742,15,State - MIZORAM,Rural,17,Literate with No Education,44,45,89
10743,15,State - MIZORAM,Rural,18,Literate with No Education,69,45,114
10744,15,State - MIZORAM,Rural,19,Literate with No Education,75,64,139
10745,15,State - MIZORAM,Rural,20-24,Literate with No Education,399,419,818
10746,15,State - MIZORAM,Rural,25-29,Literate with No Education,455,450,905
10747,15,State - MIZORAM,Rural,30-34,Literate with No Education,380,426,806
10748,15,State - MIZORAM,Rural,35-39,Literate with No Education,305,325,630
10749,15,State - MIZORAM,Rural,40-44,Literate with No Education,261,252,513
10750,15,State - MIZORAM,Rural,45-49,Literate with No Education,237,268,505
10751,15,State - MIZORAM,Rural,50-54,Literate with No Education,225,262,487
10752,15,State - MIZORAM,Rural,55-59,Literate with No Education,205,165,370
10753,15,State - MIZORAM,Rural,60-64,Literate with No Education,150,176,326
10754,15,State - MIZORAM,Rural,65-69,Literate with No Education,108,126,234
10755,15,State - MIZORAM,Rural,70-74,Literate with No Education,83,101,184
10756,15,State - MIZORAM,Rural,75-79,Literate with No Education,74,66,140
10757,15,State - MIZORAM,Rural,80+,Literate with No Education,89,106,195
10758,15,State - MIZORAM,Rural,Age not stated,Literate with No Education,39,34,73
10759,15,State - MIZORAM,Urban,All ages,Literate with No Education,2723,3488,6211
10760,15,State - MIZORAM,Urban,0-6,Literate with No Education,0,0,0
10761,15,State - MIZORAM,Urban,7,Literate with No Education,43,45,88
10762,15,State - MIZORAM,Urban,8,Literate with No Education,16,19,35
10763,15,State - MIZORAM,Urban,9,Literate with No Education,21,17,38
10764,15,State - MIZORAM,Urban,10,Literate with No Education,23,22,45
10765,15,State - MIZORAM,Urban,11,Literate with No Education,22,8,30
10766,15,State - MIZORAM,Urban,12,Literate with No Education,15,18,33
10767,15,State - MIZORAM,Urban,13,Literate with No Education,12,21,33
10768,15,State - MIZORAM,Urban,14,Literate with No Education,15,16,31
10769,15,State - MIZORAM,Urban,15,Literate with No Education,16,25,41
10770,15,State - MIZORAM,Urban,16,Literate with No Education,17,20,37
10771,15,State - MIZORAM,Urban,17,Literate with No Education,41,38,79
10772,15,State - MIZORAM,Urban,18,Literate with No Education,34,50,84
10773,15,State - MIZORAM,Urban,19,Literate with No Education,53,56,109
10774,15,State - MIZORAM,Urban,20-24,Literate with No Education,278,321,599
10775,15,State - MIZORAM,Urban,25-29,Literate with No Education,371,428,799
10776,15,State - MIZORAM,Urban,30-34,Literate with No Education,318,356,674
10777,15,State - MIZORAM,Urban,35-39,Literate with No Education,289,329,618
10778,15,State - MIZORAM,Urban,40-44,Literate with No Education,213,268,481
10779,15,State - MIZORAM,Urban,45-49,Literate with No Education,182,251,433
10780,15,State - MIZORAM,Urban,50-54,Literate with No Education,176,227,403
10781,15,State - MIZORAM,Urban,55-59,Literate with No Education,119,187,306
10782,15,State - MIZORAM,Urban,60-64,Literate with No Education,101,161,262
10783,15,State - MIZORAM,Urban,65-69,Literate with No Education,84,137,221
10784,15,State - MIZORAM,Urban,70-74,Literate with No Education,66,122,188
10785,15,State - MIZORAM,Urban,75-79,Literate with No Education,55,122,177
10786,15,State - MIZORAM,Urban,80+,Literate with No Education,68,179,247
10787,15,State - MIZORAM,Urban,Age not stated,Literate with No Education,75,45,120
10788,16,State - TRIPURA,Total,All ages,Literate with No Education,74925,85790,160715
10789,16,State - TRIPURA,Total,0-6,Literate with No Education,0,0,0
10790,16,State - TRIPURA,Total,7,Literate with No Education,449,383,832
10791,16,State - TRIPURA,Total,8,Literate with No Education,322,279,601
10792,16,State - TRIPURA,Total,9,Literate with No Education,267,233,500
10793,16,State - TRIPURA,Total,10,Literate with No Education,358,268,626
10794,16,State - TRIPURA,Total,11,Literate with No Education,306,268,574
10795,16,State - TRIPURA,Total,12,Literate with No Education,291,308,599
10796,16,State - TRIPURA,Total,13,Literate with No Education,326,313,639
10797,16,State - TRIPURA,Total,14,Literate with No Education,411,405,816
10798,16,State - TRIPURA,Total,15,Literate with No Education,490,548,1038
10799,16,State - TRIPURA,Total,16,Literate with No Education,639,703,1342
10800,16,State - TRIPURA,Total,17,Literate with No Education,754,740,1494
10801,16,State - TRIPURA,Total,18,Literate with No Education,1090,1272,2362
10802,16,State - TRIPURA,Total,19,Literate with No Education,986,1441,2427
10803,16,State - TRIPURA,Total,20-24,Literate with No Education,6999,9148,16147
10804,16,State - TRIPURA,Total,25-29,Literate with No Education,9144,10441,19585
10805,16,State - TRIPURA,Total,30-34,Literate with No Education,7917,9173,17090
10806,16,State - TRIPURA,Total,35-39,Literate with No Education,8077,9950,18027
10807,16,State - TRIPURA,Total,40-44,Literate with No Education,7492,9382,16874
10808,16,State - TRIPURA,Total,45-49,Literate with No Education,7160,8527,15687
10809,16,State - TRIPURA,Total,50-54,Literate with No Education,5991,6293,12284
10810,16,State - TRIPURA,Total,55-59,Literate with No Education,4324,4556,8880
10811,16,State - TRIPURA,Total,60-64,Literate with No Education,3714,3920,7634
10812,16,State - TRIPURA,Total,65-69,Literate with No Education,2717,2735,5452
10813,16,State - TRIPURA,Total,70-74,Literate with No Education,2071,1964,4035
10814,16,State - TRIPURA,Total,75-79,Literate with No Education,1080,1069,2149
10815,16,State - TRIPURA,Total,80+,Literate with No Education,1305,1327,2632
10816,16,State - TRIPURA,Total,Age not stated,Literate with No Education,245,144,389
10817,16,State - TRIPURA,Rural,All ages,Literate with No Education,56225,64519,120744
10818,16,State - TRIPURA,Rural,0-6,Literate with No Education,0,0,0
10819,16,State - TRIPURA,Rural,7,Literate with No Education,351,298,649
10820,16,State - TRIPURA,Rural,8,Literate with No Education,252,216,468
10821,16,State - TRIPURA,Rural,9,Literate with No Education,198,177,375
10822,16,State - TRIPURA,Rural,10,Literate with No Education,275,221,496
10823,16,State - TRIPURA,Rural,11,Literate with No Education,237,208,445
10824,16,State - TRIPURA,Rural,12,Literate with No Education,227,256,483
10825,16,State - TRIPURA,Rural,13,Literate with No Education,259,267,526
10826,16,State - TRIPURA,Rural,14,Literate with No Education,312,335,647
10827,16,State - TRIPURA,Rural,15,Literate with No Education,396,448,844
10828,16,State - TRIPURA,Rural,16,Literate with No Education,526,586,1112
10829,16,State - TRIPURA,Rural,17,Literate with No Education,606,605,1211
10830,16,State - TRIPURA,Rural,18,Literate with No Education,864,1044,1908
10831,16,State - TRIPURA,Rural,19,Literate with No Education,761,1161,1922
10832,16,State - TRIPURA,Rural,20-24,Literate with No Education,5312,7196,12508
10833,16,State - TRIPURA,Rural,25-29,Literate with No Education,6830,7940,14770
10834,16,State - TRIPURA,Rural,30-34,Literate with No Education,5834,6845,12679
10835,16,State - TRIPURA,Rural,35-39,Literate with No Education,5951,7364,13315
10836,16,State - TRIPURA,Rural,40-44,Literate with No Education,5462,7038,12500
10837,16,State - TRIPURA,Rural,45-49,Literate with No Education,5323,6262,11585
10838,16,State - TRIPURA,Rural,50-54,Literate with No Education,4410,4616,9026
10839,16,State - TRIPURA,Rural,55-59,Literate with No Education,3155,3294,6449
10840,16,State - TRIPURA,Rural,60-64,Literate with No Education,2872,2948,5820
10841,16,State - TRIPURA,Rural,65-69,Literate with No Education,2095,2045,4140
10842,16,State - TRIPURA,Rural,70-74,Literate with No Education,1675,1407,3082
10843,16,State - TRIPURA,Rural,75-79,Literate with No Education,844,734,1578
10844,16,State - TRIPURA,Rural,80+,Literate with No Education,1028,911,1939
10845,16,State - TRIPURA,Rural,Age not stated,Literate with No Education,170,97,267
10846,16,State - TRIPURA,Urban,All ages,Literate with No Education,18700,21271,39971
10847,16,State - TRIPURA,Urban,0-6,Literate with No Education,0,0,0
10848,16,State - TRIPURA,Urban,7,Literate with No Education,98,85,183
10849,16,State - TRIPURA,Urban,8,Literate with No Education,70,63,133
10850,16,State - TRIPURA,Urban,9,Literate with No Education,69,56,125
10851,16,State - TRIPURA,Urban,10,Literate with No Education,83,47,130
10852,16,State - TRIPURA,Urban,11,Literate with No Education,69,60,129
10853,16,State - TRIPURA,Urban,12,Literate with No Education,64,52,116
10854,16,State - TRIPURA,Urban,13,Literate with No Education,67,46,113
10855,16,State - TRIPURA,Urban,14,Literate with No Education,99,70,169
10856,16,State - TRIPURA,Urban,15,Literate with No Education,94,100,194
10857,16,State - TRIPURA,Urban,16,Literate with No Education,113,117,230
10858,16,State - TRIPURA,Urban,17,Literate with No Education,148,135,283
10859,16,State - TRIPURA,Urban,18,Literate with No Education,226,228,454
10860,16,State - TRIPURA,Urban,19,Literate with No Education,225,280,505
10861,16,State - TRIPURA,Urban,20-24,Literate with No Education,1687,1952,3639
10862,16,State - TRIPURA,Urban,25-29,Literate with No Education,2314,2501,4815
10863,16,State - TRIPURA,Urban,30-34,Literate with No Education,2083,2328,4411
10864,16,State - TRIPURA,Urban,35-39,Literate with No Education,2126,2586,4712
10865,16,State - TRIPURA,Urban,40-44,Literate with No Education,2030,2344,4374
10866,16,State - TRIPURA,Urban,45-49,Literate with No Education,1837,2265,4102
10867,16,State - TRIPURA,Urban,50-54,Literate with No Education,1581,1677,3258
10868,16,State - TRIPURA,Urban,55-59,Literate with No Education,1169,1262,2431
10869,16,State - TRIPURA,Urban,60-64,Literate with No Education,842,972,1814
10870,16,State - TRIPURA,Urban,65-69,Literate with No Education,622,690,1312
10871,16,State - TRIPURA,Urban,70-74,Literate with No Education,396,557,953
10872,16,State - TRIPURA,Urban,75-79,Literate with No Education,236,335,571
10873,16,State - TRIPURA,Urban,80+,Literate with No Education,277,416,693
10874,16,State - TRIPURA,Urban,Age not stated,Literate with No Education,75,47,122
10875,17,State - MEGHALAYA,Total,All ages,Literate with No Education,41109,37358,78467
10876,17,State - MEGHALAYA,Total,0-6,Literate with No Education,0,0,0
10877,17,State - MEGHALAYA,Total,7,Literate with No Education,809,683,1492
10878,17,State - MEGHALAYA,Total,8,Literate with No Education,654,484,1138
10879,17,State - MEGHALAYA,Total,9,Literate with No Education,552,467,1019
10880,17,State - MEGHALAYA,Total,10,Literate with No Education,568,539,1107
10881,17,State - MEGHALAYA,Total,11,Literate with No Education,553,461,1014
10882,17,State - MEGHALAYA,Total,12,Literate with No Education,533,482,1015
10883,17,State - MEGHALAYA,Total,13,Literate with No Education,464,400,864
10884,17,State - MEGHALAYA,Total,14,Literate with No Education,586,448,1034
10885,17,State - MEGHALAYA,Total,15,Literate with No Education,607,510,1117
10886,17,State - MEGHALAYA,Total,16,Literate with No Education,694,532,1226
10887,17,State - MEGHALAYA,Total,17,Literate with No Education,641,628,1269
10888,17,State - MEGHALAYA,Total,18,Literate with No Education,839,753,1592
10889,17,State - MEGHALAYA,Total,19,Literate with No Education,733,727,1460
10890,17,State - MEGHALAYA,Total,20-24,Literate with No Education,4532,4780,9312
10891,17,State - MEGHALAYA,Total,25-29,Literate with No Education,5973,6053,12026
10892,17,State - MEGHALAYA,Total,30-34,Literate with No Education,4460,4280,8740
10893,17,State - MEGHALAYA,Total,35-39,Literate with No Education,3994,3896,7890
10894,17,State - MEGHALAYA,Total,40-44,Literate with No Education,3390,3055,6445
10895,17,State - MEGHALAYA,Total,45-49,Literate with No Education,3067,2493,5560
10896,17,State - MEGHALAYA,Total,50-54,Literate with No Education,2169,1643,3812
10897,17,State - MEGHALAYA,Total,55-59,Literate with No Education,1482,1072,2554
10898,17,State - MEGHALAYA,Total,60-64,Literate with No Education,1209,940,2149
10899,17,State - MEGHALAYA,Total,65-69,Literate with No Education,891,684,1575
10900,17,State - MEGHALAYA,Total,70-74,Literate with No Education,492,399,891
10901,17,State - MEGHALAYA,Total,75-79,Literate with No Education,278,256,534
10902,17,State - MEGHALAYA,Total,80+,Literate with No Education,358,339,697
10903,17,State - MEGHALAYA,Total,Age not stated,Literate with No Education,581,354,935
10904,17,State - MEGHALAYA,Rural,All ages,Literate with No Education,34681,30719,65400
10905,17,State - MEGHALAYA,Rural,0-6,Literate with No Education,0,0,0
10906,17,State - MEGHALAYA,Rural,7,Literate with No Education,759,621,1380
10907,17,State - MEGHALAYA,Rural,8,Literate with No Education,616,445,1061
10908,17,State - MEGHALAYA,Rural,9,Literate with No Education,486,413,899
10909,17,State - MEGHALAYA,Rural,10,Literate with No Education,531,502,1033
10910,17,State - MEGHALAYA,Rural,11,Literate with No Education,520,419,939
10911,17,State - MEGHALAYA,Rural,12,Literate with No Education,477,430,907
10912,17,State - MEGHALAYA,Rural,13,Literate with No Education,432,364,796
10913,17,State - MEGHALAYA,Rural,14,Literate with No Education,524,392,916
10914,17,State - MEGHALAYA,Rural,15,Literate with No Education,551,463,1014
10915,17,State - MEGHALAYA,Rural,16,Literate with No Education,631,477,1108
10916,17,State - MEGHALAYA,Rural,17,Literate with No Education,569,561,1130
10917,17,State - MEGHALAYA,Rural,18,Literate with No Education,739,668,1407
10918,17,State - MEGHALAYA,Rural,19,Literate with No Education,637,658,1295
10919,17,State - MEGHALAYA,Rural,20-24,Literate with No Education,3880,4140,8020
10920,17,State - MEGHALAYA,Rural,25-29,Literate with No Education,4888,4938,9826
10921,17,State - MEGHALAYA,Rural,30-34,Literate with No Education,3670,3405,7075
10922,17,State - MEGHALAYA,Rural,35-39,Literate with No Education,3316,3061,6377
10923,17,State - MEGHALAYA,Rural,40-44,Literate with No Education,2785,2399,5184
10924,17,State - MEGHALAYA,Rural,45-49,Literate with No Education,2500,1960,4460
10925,17,State - MEGHALAYA,Rural,50-54,Literate with No Education,1771,1246,3017
10926,17,State - MEGHALAYA,Rural,55-59,Literate with No Education,1194,798,1992
10927,17,State - MEGHALAYA,Rural,60-64,Literate with No Education,1008,763,1771
10928,17,State - MEGHALAYA,Rural,65-69,Literate with No Education,763,555,1318
10929,17,State - MEGHALAYA,Rural,70-74,Literate with No Education,415,300,715
10930,17,State - MEGHALAYA,Rural,75-79,Literate with No Education,221,193,414
10931,17,State - MEGHALAYA,Rural,80+,Literate with No Education,288,233,521
10932,17,State - MEGHALAYA,Rural,Age not stated,Literate with No Education,510,315,825
10933,17,State - MEGHALAYA,Urban,All ages,Literate with No Education,6428,6639,13067
10934,17,State - MEGHALAYA,Urban,0-6,Literate with No Education,0,0,0
10935,17,State - MEGHALAYA,Urban,7,Literate with No Education,50,62,112
10936,17,State - MEGHALAYA,Urban,8,Literate with No Education,38,39,77
10937,17,State - MEGHALAYA,Urban,9,Literate with No Education,66,54,120
10938,17,State - MEGHALAYA,Urban,10,Literate with No Education,37,37,74
10939,17,State - MEGHALAYA,Urban,11,Literate with No Education,33,42,75
10940,17,State - MEGHALAYA,Urban,12,Literate with No Education,56,52,108
10941,17,State - MEGHALAYA,Urban,13,Literate with No Education,32,36,68
10942,17,State - MEGHALAYA,Urban,14,Literate with No Education,62,56,118
10943,17,State - MEGHALAYA,Urban,15,Literate with No Education,56,47,103
10944,17,State - MEGHALAYA,Urban,16,Literate with No Education,63,55,118
10945,17,State - MEGHALAYA,Urban,17,Literate with No Education,72,67,139
10946,17,State - MEGHALAYA,Urban,18,Literate with No Education,100,85,185
10947,17,State - MEGHALAYA,Urban,19,Literate with No Education,96,69,165
10948,17,State - MEGHALAYA,Urban,20-24,Literate with No Education,652,640,1292
10949,17,State - MEGHALAYA,Urban,25-29,Literate with No Education,1085,1115,2200
10950,17,State - MEGHALAYA,Urban,30-34,Literate with No Education,790,875,1665
10951,17,State - MEGHALAYA,Urban,35-39,Literate with No Education,678,835,1513
10952,17,State - MEGHALAYA,Urban,40-44,Literate with No Education,605,656,1261
10953,17,State - MEGHALAYA,Urban,45-49,Literate with No Education,567,533,1100
10954,17,State - MEGHALAYA,Urban,50-54,Literate with No Education,398,397,795
10955,17,State - MEGHALAYA,Urban,55-59,Literate with No Education,288,274,562
10956,17,State - MEGHALAYA,Urban,60-64,Literate with No Education,201,177,378
10957,17,State - MEGHALAYA,Urban,65-69,Literate with No Education,128,129,257
10958,17,State - MEGHALAYA,Urban,70-74,Literate with No Education,77,99,176
10959,17,State - MEGHALAYA,Urban,75-79,Literate with No Education,57,63,120
10960,17,State - MEGHALAYA,Urban,80+,Literate with No Education,70,106,176
10961,17,State - MEGHALAYA,Urban,Age not stated,Literate with No Education,71,39,110
10962,18,State - ASSAM,Total,All ages,Literate with No Education,507614,413049,920663
10963,18,State - ASSAM,Total,0-6,Literate with No Education,0,0,0
10964,18,State - ASSAM,Total,7,Literate with No Education,5441,4269,9710
10965,18,State - ASSAM,Total,8,Literate with No Education,4340,3581,7921
10966,18,State - ASSAM,Total,9,Literate with No Education,3994,3145,7139
10967,18,State - ASSAM,Total,10,Literate with No Education,4972,3796,8768
10968,18,State - ASSAM,Total,11,Literate with No Education,4468,3388,7856
10969,18,State - ASSAM,Total,12,Literate with No Education,5664,4207,9871
10970,18,State - ASSAM,Total,13,Literate with No Education,5521,4164,9685
10971,18,State - ASSAM,Total,14,Literate with No Education,6452,4877,11329
10972,18,State - ASSAM,Total,15,Literate with No Education,8192,5758,13950
10973,18,State - ASSAM,Total,16,Literate with No Education,8814,6213,15027
10974,18,State - ASSAM,Total,17,Literate with No Education,8509,5983,14492
10975,18,State - ASSAM,Total,18,Literate with No Education,12033,10235,22268
10976,18,State - ASSAM,Total,19,Literate with No Education,9479,9764,19243
10977,18,State - ASSAM,Total,20-24,Literate with No Education,59716,59552,119268
10978,18,State - ASSAM,Total,25-29,Literate with No Education,70506,65396,135902
10979,18,State - ASSAM,Total,30-34,Literate with No Education,57577,50676,108253
10980,18,State - ASSAM,Total,35-39,Literate with No Education,54683,46021,100704
10981,18,State - ASSAM,Total,40-44,Literate with No Education,43855,32575,76430
10982,18,State - ASSAM,Total,45-49,Literate with No Education,37594,26949,64543
10983,18,State - ASSAM,Total,50-54,Literate with No Education,27512,18712,46224
10984,18,State - ASSAM,Total,55-59,Literate with No Education,20397,13083,33480
10985,18,State - ASSAM,Total,60-64,Literate with No Education,17103,11394,28497
10986,18,State - ASSAM,Total,65-69,Literate with No Education,11165,7276,18441
10987,18,State - ASSAM,Total,70-74,Literate with No Education,8362,5065,13427
10988,18,State - ASSAM,Total,75-79,Literate with No Education,4258,2473,6731
10989,18,State - ASSAM,Total,80+,Literate with No Education,4981,3213,8194
10990,18,State - ASSAM,Total,Age not stated,Literate with No Education,2026,1284,3310
10991,18,State - ASSAM,Rural,All ages,Literate with No Education,440255,348827,789082
10992,18,State - ASSAM,Rural,0-6,Literate with No Education,0,0,0
10993,18,State - ASSAM,Rural,7,Literate with No Education,4855,3857,8712
10994,18,State - ASSAM,Rural,8,Literate with No Education,3972,3267,7239
10995,18,State - ASSAM,Rural,9,Literate with No Education,3656,2854,6510
10996,18,State - ASSAM,Rural,10,Literate with No Education,4533,3450,7983
10997,18,State - ASSAM,Rural,11,Literate with No Education,4088,3080,7168
10998,18,State - ASSAM,Rural,12,Literate with No Education,5254,3886,9140
10999,18,State - ASSAM,Rural,13,Literate with No Education,5114,3850,8964
11000,18,State - ASSAM,Rural,14,Literate with No Education,5952,4486,10438
11001,18,State - ASSAM,Rural,15,Literate with No Education,7581,5284,12865
11002,18,State - ASSAM,Rural,16,Literate with No Education,8163,5728,13891
11003,18,State - ASSAM,Rural,17,Literate with No Education,7780,5438,13218
11004,18,State - ASSAM,Rural,18,Literate with No Education,11014,9396,20410
11005,18,State - ASSAM,Rural,19,Literate with No Education,8569,8861,17430
11006,18,State - ASSAM,Rural,20-24,Literate with No Education,53159,52668,105827
11007,18,State - ASSAM,Rural,25-29,Literate with No Education,61284,56011,117295
11008,18,State - ASSAM,Rural,30-34,Literate with No Education,49466,42455,91921
11009,18,State - ASSAM,Rural,35-39,Literate with No Education,46815,37797,84612
11010,18,State - ASSAM,Rural,40-44,Literate with No Education,36849,26219,63068
11011,18,State - ASSAM,Rural,45-49,Literate with No Education,31479,21388,52867
11012,18,State - ASSAM,Rural,50-54,Literate with No Education,22775,14728,37503
11013,18,State - ASSAM,Rural,55-59,Literate with No Education,17101,10191,27292
11014,18,State - ASSAM,Rural,60-64,Literate with No Education,14545,9035,23580
11015,18,State - ASSAM,Rural,65-69,Literate with No Education,9527,5705,15232
11016,18,State - ASSAM,Rural,70-74,Literate with No Education,7185,3938,11123
11017,18,State - ASSAM,Rural,75-79,Literate with No Education,3648,1791,5439
11018,18,State - ASSAM,Rural,80+,Literate with No Education,4295,2447,6742
11019,18,State - ASSAM,Rural,Age not stated,Literate with No Education,1596,1017,2613
11020,18,State - ASSAM,Urban,All ages,Literate with No Education,67359,64222,131581
11021,18,State - ASSAM,Urban,0-6,Literate with No Education,0,0,0
11022,18,State - ASSAM,Urban,7,Literate with No Education,586,412,998
11023,18,State - ASSAM,Urban,8,Literate with No Education,368,314,682
11024,18,State - ASSAM,Urban,9,Literate with No Education,338,291,629
11025,18,State - ASSAM,Urban,10,Literate with No Education,439,346,785
11026,18,State - ASSAM,Urban,11,Literate with No Education,380,308,688
11027,18,State - ASSAM,Urban,12,Literate with No Education,410,321,731
11028,18,State - ASSAM,Urban,13,Literate with No Education,407,314,721
11029,18,State - ASSAM,Urban,14,Literate with No Education,500,391,891
11030,18,State - ASSAM,Urban,15,Literate with No Education,611,474,1085
11031,18,State - ASSAM,Urban,16,Literate with No Education,651,485,1136
11032,18,State - ASSAM,Urban,17,Literate with No Education,729,545,1274
11033,18,State - ASSAM,Urban,18,Literate with No Education,1019,839,1858
11034,18,State - ASSAM,Urban,19,Literate with No Education,910,903,1813
11035,18,State - ASSAM,Urban,20-24,Literate with No Education,6557,6884,13441
11036,18,State - ASSAM,Urban,25-29,Literate with No Education,9222,9385,18607
11037,18,State - ASSAM,Urban,30-34,Literate with No Education,8111,8221,16332
11038,18,State - ASSAM,Urban,35-39,Literate with No Education,7868,8224,16092
11039,18,State - ASSAM,Urban,40-44,Literate with No Education,7006,6356,13362
11040,18,State - ASSAM,Urban,45-49,Literate with No Education,6115,5561,11676
11041,18,State - ASSAM,Urban,50-54,Literate with No Education,4737,3984,8721
11042,18,State - ASSAM,Urban,55-59,Literate with No Education,3296,2892,6188
11043,18,State - ASSAM,Urban,60-64,Literate with No Education,2558,2359,4917
11044,18,State - ASSAM,Urban,65-69,Literate with No Education,1638,1571,3209
11045,18,State - ASSAM,Urban,70-74,Literate with No Education,1177,1127,2304
11046,18,State - ASSAM,Urban,75-79,Literate with No Education,610,682,1292
11047,18,State - ASSAM,Urban,80+,Literate with No Education,686,766,1452
11048,18,State - ASSAM,Urban,Age not stated,Literate with No Education,430,267,697
11049,19,State - WEST BENGAL,Total,All ages,Literate with No Education,1048966,914793,1963759
11050,19,State - WEST BENGAL,Total,0-6,Literate with No Education,0,0,0
11051,19,State - WEST BENGAL,Total,7,Literate with No Education,11126,8554,19680
11052,19,State - WEST BENGAL,Total,8,Literate with No Education,8000,6382,14382
11053,19,State - WEST BENGAL,Total,9,Literate with No Education,6652,5314,11966
11054,19,State - WEST BENGAL,Total,10,Literate with No Education,8922,6770,15692
11055,19,State - WEST BENGAL,Total,11,Literate with No Education,7358,5584,12942
11056,19,State - WEST BENGAL,Total,12,Literate with No Education,9112,6477,15589
11057,19,State - WEST BENGAL,Total,13,Literate with No Education,8255,6344,14599
11058,19,State - WEST BENGAL,Total,14,Literate with No Education,10109,7575,17684
11059,19,State - WEST BENGAL,Total,15,Literate with No Education,12536,9191,21727
11060,19,State - WEST BENGAL,Total,16,Literate with No Education,13911,10160,24071
11061,19,State - WEST BENGAL,Total,17,Literate with No Education,13982,10655,24637
11062,19,State - WEST BENGAL,Total,18,Literate with No Education,20991,18620,39611
11063,19,State - WEST BENGAL,Total,19,Literate with No Education,16378,17186,33564
11064,19,State - WEST BENGAL,Total,20-24,Literate with No Education,104469,103872,208341
11065,19,State - WEST BENGAL,Total,25-29,Literate with No Education,119063,114179,233242
11066,19,State - WEST BENGAL,Total,30-34,Literate with No Education,105327,100563,205890
11067,19,State - WEST BENGAL,Total,35-39,Literate with No Education,109742,104140,213882
11068,19,State - WEST BENGAL,Total,40-44,Literate with No Education,102015,85812,187827
11069,19,State - WEST BENGAL,Total,45-49,Literate with No Education,89015,72642,161657
11070,19,State - WEST BENGAL,Total,50-54,Literate with No Education,72589,54206,126795
11071,19,State - WEST BENGAL,Total,55-59,Literate with No Education,54013,41800,95813
11072,19,State - WEST BENGAL,Total,60-64,Literate with No Education,43886,35589,79475
11073,19,State - WEST BENGAL,Total,65-69,Literate with No Education,31295,26635,57930
11074,19,State - WEST BENGAL,Total,70-74,Literate with No Education,22320,19443,41763
11075,19,State - WEST BENGAL,Total,75-79,Literate with No Education,11943,11333,23276
11076,19,State - WEST BENGAL,Total,80+,Literate with No Education,14677,15375,30052
11077,19,State - WEST BENGAL,Total,Age not stated,Literate with No Education,21280,10392,31672
11078,19,State - WEST BENGAL,Rural,All ages,Literate with No Education,647306,545148,1192454
11079,19,State - WEST BENGAL,Rural,0-6,Literate with No Education,0,0,0
11080,19,State - WEST BENGAL,Rural,7,Literate with No Education,7111,5331,12442
11081,19,State - WEST BENGAL,Rural,8,Literate with No Education,5072,3975,9047
11082,19,State - WEST BENGAL,Rural,9,Literate with No Education,4128,3259,7387
11083,19,State - WEST BENGAL,Rural,10,Literate with No Education,5488,4015,9503
11084,19,State - WEST BENGAL,Rural,11,Literate with No Education,4582,3460,8042
11085,19,State - WEST BENGAL,Rural,12,Literate with No Education,6008,4116,10124
11086,19,State - WEST BENGAL,Rural,13,Literate with No Education,5557,4196,9753
11087,19,State - WEST BENGAL,Rural,14,Literate with No Education,6847,4883,11730
11088,19,State - WEST BENGAL,Rural,15,Literate with No Education,8594,6055,14649
11089,19,State - WEST BENGAL,Rural,16,Literate with No Education,9739,6727,16466
11090,19,State - WEST BENGAL,Rural,17,Literate with No Education,9553,6977,16530
11091,19,State - WEST BENGAL,Rural,18,Literate with No Education,14381,12600,26981
11092,19,State - WEST BENGAL,Rural,19,Literate with No Education,10904,11705,22609
11093,19,State - WEST BENGAL,Rural,20-24,Literate with No Education,68543,68229,136772
11094,19,State - WEST BENGAL,Rural,25-29,Literate with No Education,74356,70886,145242
11095,19,State - WEST BENGAL,Rural,30-34,Literate with No Education,64803,61332,126135
11096,19,State - WEST BENGAL,Rural,35-39,Literate with No Education,68464,63895,132359
11097,19,State - WEST BENGAL,Rural,40-44,Literate with No Education,63945,51760,115705
11098,19,State - WEST BENGAL,Rural,45-49,Literate with No Education,55137,41626,96763
11099,19,State - WEST BENGAL,Rural,50-54,Literate with No Education,43883,29872,73755
11100,19,State - WEST BENGAL,Rural,55-59,Literate with No Education,32376,22325,54701
11101,19,State - WEST BENGAL,Rural,60-64,Literate with No Education,25979,18677,44656
11102,19,State - WEST BENGAL,Rural,65-69,Literate with No Education,18642,13930,32572
11103,19,State - WEST BENGAL,Rural,70-74,Literate with No Education,12636,9585,22221
11104,19,State - WEST BENGAL,Rural,75-79,Literate with No Education,6600,5215,11815
11105,19,State - WEST BENGAL,Rural,80+,Literate with No Education,7972,6918,14890
11106,19,State - WEST BENGAL,Rural,Age not stated,Literate with No Education,6006,3599,9605
11107,19,State - WEST BENGAL,Urban,All ages,Literate with No Education,401660,369645,771305
11108,19,State - WEST BENGAL,Urban,0-6,Literate with No Education,0,0,0
11109,19,State - WEST BENGAL,Urban,7,Literate with No Education,4015,3223,7238
11110,19,State - WEST BENGAL,Urban,8,Literate with No Education,2928,2407,5335
11111,19,State - WEST BENGAL,Urban,9,Literate with No Education,2524,2055,4579
11112,19,State - WEST BENGAL,Urban,10,Literate with No Education,3434,2755,6189
11113,19,State - WEST BENGAL,Urban,11,Literate with No Education,2776,2124,4900
11114,19,State - WEST BENGAL,Urban,12,Literate with No Education,3104,2361,5465
11115,19,State - WEST BENGAL,Urban,13,Literate with No Education,2698,2148,4846
11116,19,State - WEST BENGAL,Urban,14,Literate with No Education,3262,2692,5954
11117,19,State - WEST BENGAL,Urban,15,Literate with No Education,3942,3136,7078
11118,19,State - WEST BENGAL,Urban,16,Literate with No Education,4172,3433,7605
11119,19,State - WEST BENGAL,Urban,17,Literate with No Education,4429,3678,8107
11120,19,State - WEST BENGAL,Urban,18,Literate with No Education,6610,6020,12630
11121,19,State - WEST BENGAL,Urban,19,Literate with No Education,5474,5481,10955
11122,19,State - WEST BENGAL,Urban,20-24,Literate with No Education,35926,35643,71569
11123,19,State - WEST BENGAL,Urban,25-29,Literate with No Education,44707,43293,88000
11124,19,State - WEST BENGAL,Urban,30-34,Literate with No Education,40524,39231,79755
11125,19,State - WEST BENGAL,Urban,35-39,Literate with No Education,41278,40245,81523
11126,19,State - WEST BENGAL,Urban,40-44,Literate with No Education,38070,34052,72122
11127,19,State - WEST BENGAL,Urban,45-49,Literate with No Education,33878,31016,64894
11128,19,State - WEST BENGAL,Urban,50-54,Literate with No Education,28706,24334,53040
11129,19,State - WEST BENGAL,Urban,55-59,Literate with No Education,21637,19475,41112
11130,19,State - WEST BENGAL,Urban,60-64,Literate with No Education,17907,16912,34819
11131,19,State - WEST BENGAL,Urban,65-69,Literate with No Education,12653,12705,25358
11132,19,State - WEST BENGAL,Urban,70-74,Literate with No Education,9684,9858,19542
11133,19,State - WEST BENGAL,Urban,75-79,Literate with No Education,5343,6118,11461
11134,19,State - WEST BENGAL,Urban,80+,Literate with No Education,6705,8457,15162
11135,19,State - WEST BENGAL,Urban,Age not stated,Literate with No Education,15274,6793,22067
11136,20,State - JHARKHAND,Total,All ages,Literate with No Education,454490,326958,781448
11137,20,State - JHARKHAND,Total,0-6,Literate with No Education,0,0,0
11138,20,State - JHARKHAND,Total,7,Literate with No Education,7904,5653,13557
11139,20,State - JHARKHAND,Total,8,Literate with No Education,6620,4846,11466
11140,20,State - JHARKHAND,Total,9,Literate with No Education,4653,3426,8079
11141,20,State - JHARKHAND,Total,10,Literate with No Education,6703,4748,11451
11142,20,State - JHARKHAND,Total,11,Literate with No Education,4686,3310,7996
11143,20,State - JHARKHAND,Total,12,Literate with No Education,6416,4562,10978
11144,20,State - JHARKHAND,Total,13,Literate with No Education,4993,3836,8829
11145,20,State - JHARKHAND,Total,14,Literate with No Education,5854,4452,10306
11146,20,State - JHARKHAND,Total,15,Literate with No Education,7691,5061,12752
11147,20,State - JHARKHAND,Total,16,Literate with No Education,7272,5115,12387
11148,20,State - JHARKHAND,Total,17,Literate with No Education,6174,4387,10561
11149,20,State - JHARKHAND,Total,18,Literate with No Education,10849,8264,19113
11150,20,State - JHARKHAND,Total,19,Literate with No Education,6821,6337,13158
11151,20,State - JHARKHAND,Total,20-24,Literate with No Education,49082,41234,90316
11152,20,State - JHARKHAND,Total,25-29,Literate with No Education,57957,43701,101658
11153,20,State - JHARKHAND,Total,30-34,Literate with No Education,48689,36377,85066
11154,20,State - JHARKHAND,Total,35-39,Literate with No Education,44973,31573,76546
11155,20,State - JHARKHAND,Total,40-44,Literate with No Education,37134,24637,61771
11156,20,State - JHARKHAND,Total,45-49,Literate with No Education,31540,20545,52085
11157,20,State - JHARKHAND,Total,50-54,Literate with No Education,23971,15471,39442
11158,20,State - JHARKHAND,Total,55-59,Literate with No Education,18734,13344,32078
11159,20,State - JHARKHAND,Total,60-64,Literate with No Education,18442,12506,30948
11160,20,State - JHARKHAND,Total,65-69,Literate with No Education,12515,8193,20708
11161,20,State - JHARKHAND,Total,70-74,Literate with No Education,8237,5127,13364
11162,20,State - JHARKHAND,Total,75-79,Literate with No Education,3475,2439,5914
11163,20,State - JHARKHAND,Total,80+,Literate with No Education,4274,2908,7182
11164,20,State - JHARKHAND,Total,Age not stated,Literate with No Education,8831,4906,13737
11165,20,State - JHARKHAND,Rural,All ages,Literate with No Education,365222,248011,613233
11166,20,State - JHARKHAND,Rural,0-6,Literate with No Education,0,0,0
11167,20,State - JHARKHAND,Rural,7,Literate with No Education,6174,4414,10588
11168,20,State - JHARKHAND,Rural,8,Literate with No Education,5430,4041,9471
11169,20,State - JHARKHAND,Rural,9,Literate with No Education,3805,2892,6697
11170,20,State - JHARKHAND,Rural,10,Literate with No Education,5583,4010,9593
11171,20,State - JHARKHAND,Rural,11,Literate with No Education,3833,2776,6609
11172,20,State - JHARKHAND,Rural,12,Literate with No Education,5433,3967,9400
11173,20,State - JHARKHAND,Rural,13,Literate with No Education,4170,3240,7410
11174,20,State - JHARKHAND,Rural,14,Literate with No Education,4928,3780,8708
11175,20,State - JHARKHAND,Rural,15,Literate with No Education,6570,4310,10880
11176,20,State - JHARKHAND,Rural,16,Literate with No Education,6131,4304,10435
11177,20,State - JHARKHAND,Rural,17,Literate with No Education,5162,3590,8752
11178,20,State - JHARKHAND,Rural,18,Literate with No Education,9093,6901,15994
11179,20,State - JHARKHAND,Rural,19,Literate with No Education,5620,5190,10810
11180,20,State - JHARKHAND,Rural,20-24,Literate with No Education,40262,33094,73356
11181,20,State - JHARKHAND,Rural,25-29,Literate with No Education,46583,33558,80141
11182,20,State - JHARKHAND,Rural,30-34,Literate with No Education,39165,27631,66796
11183,20,State - JHARKHAND,Rural,35-39,Literate with No Education,36331,23260,59591
11184,20,State - JHARKHAND,Rural,40-44,Literate with No Education,29681,17806,47487
11185,20,State - JHARKHAND,Rural,45-49,Literate with No Education,25023,14544,39567
11186,20,State - JHARKHAND,Rural,50-54,Literate with No Education,18775,10547,29322
11187,20,State - JHARKHAND,Rural,55-59,Literate with No Education,14582,9335,23917
11188,20,State - JHARKHAND,Rural,60-64,Literate with No Education,14838,9047,23885
11189,20,State - JHARKHAND,Rural,65-69,Literate with No Education,10287,6031,16318
11190,20,State - JHARKHAND,Rural,70-74,Literate with No Education,6653,3612,10265
11191,20,State - JHARKHAND,Rural,75-79,Literate with No Education,2693,1662,4355
11192,20,State - JHARKHAND,Rural,80+,Literate with No Education,3340,1877,5217
11193,20,State - JHARKHAND,Rural,Age not stated,Literate with No Education,5077,2592,7669
11194,20,State - JHARKHAND,Urban,All ages,Literate with No Education,89268,78947,168215
11195,20,State - JHARKHAND,Urban,0-6,Literate with No Education,0,0,0
11196,20,State - JHARKHAND,Urban,7,Literate with No Education,1730,1239,2969
11197,20,State - JHARKHAND,Urban,8,Literate with No Education,1190,805,1995
11198,20,State - JHARKHAND,Urban,9,Literate with No Education,848,534,1382
11199,20,State - JHARKHAND,Urban,10,Literate with No Education,1120,738,1858
11200,20,State - JHARKHAND,Urban,11,Literate with No Education,853,534,1387
11201,20,State - JHARKHAND,Urban,12,Literate with No Education,983,595,1578
11202,20,State - JHARKHAND,Urban,13,Literate with No Education,823,596,1419
11203,20,State - JHARKHAND,Urban,14,Literate with No Education,926,672,1598
11204,20,State - JHARKHAND,Urban,15,Literate with No Education,1121,751,1872
11205,20,State - JHARKHAND,Urban,16,Literate with No Education,1141,811,1952
11206,20,State - JHARKHAND,Urban,17,Literate with No Education,1012,797,1809
11207,20,State - JHARKHAND,Urban,18,Literate with No Education,1756,1363,3119
11208,20,State - JHARKHAND,Urban,19,Literate with No Education,1201,1147,2348
11209,20,State - JHARKHAND,Urban,20-24,Literate with No Education,8820,8140,16960
11210,20,State - JHARKHAND,Urban,25-29,Literate with No Education,11374,10143,21517
11211,20,State - JHARKHAND,Urban,30-34,Literate with No Education,9524,8746,18270
11212,20,State - JHARKHAND,Urban,35-39,Literate with No Education,8642,8313,16955
11213,20,State - JHARKHAND,Urban,40-44,Literate with No Education,7453,6831,14284
11214,20,State - JHARKHAND,Urban,45-49,Literate with No Education,6517,6001,12518
11215,20,State - JHARKHAND,Urban,50-54,Literate with No Education,5196,4924,10120
11216,20,State - JHARKHAND,Urban,55-59,Literate with No Education,4152,4009,8161
11217,20,State - JHARKHAND,Urban,60-64,Literate with No Education,3604,3459,7063
11218,20,State - JHARKHAND,Urban,65-69,Literate with No Education,2228,2162,4390
11219,20,State - JHARKHAND,Urban,70-74,Literate with No Education,1584,1515,3099
11220,20,State - JHARKHAND,Urban,75-79,Literate with No Education,782,777,1559
11221,20,State - JHARKHAND,Urban,80+,Literate with No Education,934,1031,1965
11222,20,State - JHARKHAND,Urban,Age not stated,Literate with No Education,3754,2314,6068
11223,21,State - ODISHA,Total,All ages,Literate with No Education,438797,394008,832805
11224,21,State - ODISHA,Total,0-6,Literate with No Education,0,0,0
11225,21,State - ODISHA,Total,7,Literate with No Education,5677,4184,9861
11226,21,State - ODISHA,Total,8,Literate with No Education,4070,3313,7383
11227,21,State - ODISHA,Total,9,Literate with No Education,3381,2723,6104
11228,21,State - ODISHA,Total,10,Literate with No Education,4485,3616,8101
11229,21,State - ODISHA,Total,11,Literate with No Education,3870,3386,7256
11230,21,State - ODISHA,Total,12,Literate with No Education,4370,4285,8655
11231,21,State - ODISHA,Total,13,Literate with No Education,4147,4249,8396
11232,21,State - ODISHA,Total,14,Literate with No Education,5065,4947,10012
11233,21,State - ODISHA,Total,15,Literate with No Education,6533,6384,12917
11234,21,State - ODISHA,Total,16,Literate with No Education,6793,6432,13225
11235,21,State - ODISHA,Total,17,Literate with No Education,6771,6358,13129
11236,21,State - ODISHA,Total,18,Literate with No Education,10494,9846,20340
11237,21,State - ODISHA,Total,19,Literate with No Education,8158,8248,16406
11238,21,State - ODISHA,Total,20-24,Literate with No Education,49619,48772,98391
11239,21,State - ODISHA,Total,25-29,Literate with No Education,50777,48826,99603
11240,21,State - ODISHA,Total,30-34,Literate with No Education,42154,41375,83529
11241,21,State - ODISHA,Total,35-39,Literate with No Education,41035,38892,79927
11242,21,State - ODISHA,Total,40-44,Literate with No Education,36732,31787,68519
11243,21,State - ODISHA,Total,45-49,Literate with No Education,31479,26595,58074
11244,21,State - ODISHA,Total,50-54,Literate with No Education,24436,20789,45225
11245,21,State - ODISHA,Total,55-59,Literate with No Education,19066,16871,35937
11246,21,State - ODISHA,Total,60-64,Literate with No Education,19925,16070,35995
11247,21,State - ODISHA,Total,65-69,Literate with No Education,14309,11067,25376
11248,21,State - ODISHA,Total,70-74,Literate with No Education,11873,8974,20847
11249,21,State - ODISHA,Total,75-79,Literate with No Education,6099,4457,10556
11250,21,State - ODISHA,Total,80+,Literate with No Education,7878,5383,13261
11251,21,State - ODISHA,Total,Age not stated,Literate with No Education,9601,6179,15780
11252,21,State - ODISHA,Rural,All ages,Literate with No Education,364474,316393,680867
11253,21,State - ODISHA,Rural,0-6,Literate with No Education,0,0,0
11254,21,State - ODISHA,Rural,7,Literate with No Education,4618,3422,8040
11255,21,State - ODISHA,Rural,8,Literate with No Education,3372,2823,6195
11256,21,State - ODISHA,Rural,9,Literate with No Education,2836,2320,5156
11257,21,State - ODISHA,Rural,10,Literate with No Education,3791,2914,6705
11258,21,State - ODISHA,Rural,11,Literate with No Education,3249,2657,5906
11259,21,State - ODISHA,Rural,12,Literate with No Education,3779,3437,7216
11260,21,State - ODISHA,Rural,13,Literate with No Education,3613,3276,6889
11261,21,State - ODISHA,Rural,14,Literate with No Education,4453,3951,8404
11262,21,State - ODISHA,Rural,15,Literate with No Education,5692,5221,10913
11263,21,State - ODISHA,Rural,16,Literate with No Education,5843,5438,11281
11264,21,State - ODISHA,Rural,17,Literate with No Education,5762,5452,11214
11265,21,State - ODISHA,Rural,18,Literate with No Education,8873,8142,17015
11266,21,State - ODISHA,Rural,19,Literate with No Education,6703,6539,13242
11267,21,State - ODISHA,Rural,20-24,Literate with No Education,40591,39707,80298
11268,21,State - ODISHA,Rural,25-29,Literate with No Education,41404,39266,80670
11269,21,State - ODISHA,Rural,30-34,Literate with No Education,34369,33066,67435
11270,21,State - ODISHA,Rural,35-39,Literate with No Education,33632,30958,64590
11271,21,State - ODISHA,Rural,40-44,Literate with No Education,30231,25051,55282
11272,21,State - ODISHA,Rural,45-49,Literate with No Education,25972,20851,46823
11273,21,State - ODISHA,Rural,50-54,Literate with No Education,20236,16428,36664
11274,21,State - ODISHA,Rural,55-59,Literate with No Education,15843,13491,29334
11275,21,State - ODISHA,Rural,60-64,Literate with No Education,17162,13009,30171
11276,21,State - ODISHA,Rural,65-69,Literate with No Education,12486,9027,21513
11277,21,State - ODISHA,Rural,70-74,Literate with No Education,10322,7282,17604
11278,21,State - ODISHA,Rural,75-79,Literate with No Education,5282,3575,8857
11279,21,State - ODISHA,Rural,80+,Literate with No Education,6752,4088,10840
11280,21,State - ODISHA,Rural,Age not stated,Literate with No Education,7608,5002,12610
11281,21,State - ODISHA,Urban,All ages,Literate with No Education,74323,77615,151938
11282,21,State - ODISHA,Urban,0-6,Literate with No Education,0,0,0
11283,21,State - ODISHA,Urban,7,Literate with No Education,1059,762,1821
11284,21,State - ODISHA,Urban,8,Literate with No Education,698,490,1188
11285,21,State - ODISHA,Urban,9,Literate with No Education,545,403,948
11286,21,State - ODISHA,Urban,10,Literate with No Education,694,702,1396
11287,21,State - ODISHA,Urban,11,Literate with No Education,621,729,1350
11288,21,State - ODISHA,Urban,12,Literate with No Education,591,848,1439
11289,21,State - ODISHA,Urban,13,Literate with No Education,534,973,1507
11290,21,State - ODISHA,Urban,14,Literate with No Education,612,996,1608
11291,21,State - ODISHA,Urban,15,Literate with No Education,841,1163,2004
11292,21,State - ODISHA,Urban,16,Literate with No Education,950,994,1944
11293,21,State - ODISHA,Urban,17,Literate with No Education,1009,906,1915
11294,21,State - ODISHA,Urban,18,Literate with No Education,1621,1704,3325
11295,21,State - ODISHA,Urban,19,Literate with No Education,1455,1709,3164
11296,21,State - ODISHA,Urban,20-24,Literate with No Education,9028,9065,18093
11297,21,State - ODISHA,Urban,25-29,Literate with No Education,9373,9560,18933
11298,21,State - ODISHA,Urban,30-34,Literate with No Education,7785,8309,16094
11299,21,State - ODISHA,Urban,35-39,Literate with No Education,7403,7934,15337
11300,21,State - ODISHA,Urban,40-44,Literate with No Education,6501,6736,13237
11301,21,State - ODISHA,Urban,45-49,Literate with No Education,5507,5744,11251
11302,21,State - ODISHA,Urban,50-54,Literate with No Education,4200,4361,8561
11303,21,State - ODISHA,Urban,55-59,Literate with No Education,3223,3380,6603
11304,21,State - ODISHA,Urban,60-64,Literate with No Education,2763,3061,5824
11305,21,State - ODISHA,Urban,65-69,Literate with No Education,1823,2040,3863
11306,21,State - ODISHA,Urban,70-74,Literate with No Education,1551,1692,3243
11307,21,State - ODISHA,Urban,75-79,Literate with No Education,817,882,1699
11308,21,State - ODISHA,Urban,80+,Literate with No Education,1126,1295,2421
11309,21,State - ODISHA,Urban,Age not stated,Literate with No Education,1993,1177,3170
11310,22,State - CHHATTISGARH,Total,All ages,Literate with No Education,204602,173163,377765
11311,22,State - CHHATTISGARH,Total,0-6,Literate with No Education,0,0,0
11312,22,State - CHHATTISGARH,Total,7,Literate with No Education,2527,1748,4275
11313,22,State - CHHATTISGARH,Total,8,Literate with No Education,1665,1204,2869
11314,22,State - CHHATTISGARH,Total,9,Literate with No Education,1343,997,2340
11315,22,State - CHHATTISGARH,Total,10,Literate with No Education,1742,1215,2957
11316,22,State - CHHATTISGARH,Total,11,Literate with No Education,1361,1039,2400
11317,22,State - CHHATTISGARH,Total,12,Literate with No Education,1704,1335,3039
11318,22,State - CHHATTISGARH,Total,13,Literate with No Education,1661,1315,2976
11319,22,State - CHHATTISGARH,Total,14,Literate with No Education,1946,1653,3599
11320,22,State - CHHATTISGARH,Total,15,Literate with No Education,2640,2164,4804
11321,22,State - CHHATTISGARH,Total,16,Literate with No Education,3018,2597,5615
11322,22,State - CHHATTISGARH,Total,17,Literate with No Education,3258,2809,6067
11323,22,State - CHHATTISGARH,Total,18,Literate with No Education,5161,4554,9715
11324,22,State - CHHATTISGARH,Total,19,Literate with No Education,4068,4019,8087
11325,22,State - CHHATTISGARH,Total,20-24,Literate with No Education,26765,25103,51868
11326,22,State - CHHATTISGARH,Total,25-29,Literate with No Education,26382,23391,49773
11327,22,State - CHHATTISGARH,Total,30-34,Literate with No Education,21499,20143,41642
11328,22,State - CHHATTISGARH,Total,35-39,Literate with No Education,21011,18439,39450
11329,22,State - CHHATTISGARH,Total,40-44,Literate with No Education,18439,15572,34011
11330,22,State - CHHATTISGARH,Total,45-49,Literate with No Education,15875,11888,27763
11331,22,State - CHHATTISGARH,Total,50-54,Literate with No Education,11337,8666,20003
11332,22,State - CHHATTISGARH,Total,55-59,Literate with No Education,8653,6604,15257
11333,22,State - CHHATTISGARH,Total,60-64,Literate with No Education,7612,6033,13645
11334,22,State - CHHATTISGARH,Total,65-69,Literate with No Education,5402,4077,9479
11335,22,State - CHHATTISGARH,Total,70-74,Literate with No Education,3790,2703,6493
11336,22,State - CHHATTISGARH,Total,75-79,Literate with No Education,1693,1239,2932
11337,22,State - CHHATTISGARH,Total,80+,Literate with No Education,2112,1633,3745
11338,22,State - CHHATTISGARH,Total,Age not stated,Literate with No Education,1938,1023,2961
11339,22,State - CHHATTISGARH,Rural,All ages,Literate with No Education,156656,127940,284596
11340,22,State - CHHATTISGARH,Rural,0-6,Literate with No Education,0,0,0
11341,22,State - CHHATTISGARH,Rural,7,Literate with No Education,1868,1311,3179
11342,22,State - CHHATTISGARH,Rural,8,Literate with No Education,1291,959,2250
11343,22,State - CHHATTISGARH,Rural,9,Literate with No Education,1057,817,1874
11344,22,State - CHHATTISGARH,Rural,10,Literate with No Education,1375,989,2364
11345,22,State - CHHATTISGARH,Rural,11,Literate with No Education,1084,842,1926
11346,22,State - CHHATTISGARH,Rural,12,Literate with No Education,1375,1119,2494
11347,22,State - CHHATTISGARH,Rural,13,Literate with No Education,1335,1089,2424
11348,22,State - CHHATTISGARH,Rural,14,Literate with No Education,1576,1348,2924
11349,22,State - CHHATTISGARH,Rural,15,Literate with No Education,2137,1796,3933
11350,22,State - CHHATTISGARH,Rural,16,Literate with No Education,2396,2196,4592
11351,22,State - CHHATTISGARH,Rural,17,Literate with No Education,2564,2330,4894
11352,22,State - CHHATTISGARH,Rural,18,Literate with No Education,4125,3727,7852
11353,22,State - CHHATTISGARH,Rural,19,Literate with No Education,3253,3207,6460
11354,22,State - CHHATTISGARH,Rural,20-24,Literate with No Education,20657,19232,39889
11355,22,State - CHHATTISGARH,Rural,25-29,Literate with No Education,19570,16777,36347
11356,22,State - CHHATTISGARH,Rural,30-34,Literate with No Education,15897,14802,30699
11357,22,State - CHHATTISGARH,Rural,35-39,Literate with No Education,15975,13392,29367
11358,22,State - CHHATTISGARH,Rural,40-44,Literate with No Education,14105,11270,25375
11359,22,State - CHHATTISGARH,Rural,45-49,Literate with No Education,12293,8405,20698
11360,22,State - CHHATTISGARH,Rural,50-54,Literate with No Education,8594,6062,14656
11361,22,State - CHHATTISGARH,Rural,55-59,Literate with No Education,6598,4657,11255
11362,22,State - CHHATTISGARH,Rural,60-64,Literate with No Education,5953,4290,10243
11363,22,State - CHHATTISGARH,Rural,65-69,Literate with No Education,4339,2911,7250
11364,22,State - CHHATTISGARH,Rural,70-74,Literate with No Education,2970,1863,4833
11365,22,State - CHHATTISGARH,Rural,75-79,Literate with No Education,1331,850,2181
11366,22,State - CHHATTISGARH,Rural,80+,Literate with No Education,1676,1085,2761
11367,22,State - CHHATTISGARH,Rural,Age not stated,Literate with No Education,1262,614,1876
11368,22,State - CHHATTISGARH,Urban,All ages,Literate with No Education,47946,45223,93169
11369,22,State - CHHATTISGARH,Urban,0-6,Literate with No Education,0,0,0
11370,22,State - CHHATTISGARH,Urban,7,Literate with No Education,659,437,1096
11371,22,State - CHHATTISGARH,Urban,8,Literate with No Education,374,245,619
11372,22,State - CHHATTISGARH,Urban,9,Literate with No Education,286,180,466
11373,22,State - CHHATTISGARH,Urban,10,Literate with No Education,367,226,593
11374,22,State - CHHATTISGARH,Urban,11,Literate with No Education,277,197,474
11375,22,State - CHHATTISGARH,Urban,12,Literate with No Education,329,216,545
11376,22,State - CHHATTISGARH,Urban,13,Literate with No Education,326,226,552
11377,22,State - CHHATTISGARH,Urban,14,Literate with No Education,370,305,675
11378,22,State - CHHATTISGARH,Urban,15,Literate with No Education,503,368,871
11379,22,State - CHHATTISGARH,Urban,16,Literate with No Education,622,401,1023
11380,22,State - CHHATTISGARH,Urban,17,Literate with No Education,694,479,1173
11381,22,State - CHHATTISGARH,Urban,18,Literate with No Education,1036,827,1863
11382,22,State - CHHATTISGARH,Urban,19,Literate with No Education,815,812,1627
11383,22,State - CHHATTISGARH,Urban,20-24,Literate with No Education,6108,5871,11979
11384,22,State - CHHATTISGARH,Urban,25-29,Literate with No Education,6812,6614,13426
11385,22,State - CHHATTISGARH,Urban,30-34,Literate with No Education,5602,5341,10943
11386,22,State - CHHATTISGARH,Urban,35-39,Literate with No Education,5036,5047,10083
11387,22,State - CHHATTISGARH,Urban,40-44,Literate with No Education,4334,4302,8636
11388,22,State - CHHATTISGARH,Urban,45-49,Literate with No Education,3582,3483,7065
11389,22,State - CHHATTISGARH,Urban,50-54,Literate with No Education,2743,2604,5347
11390,22,State - CHHATTISGARH,Urban,55-59,Literate with No Education,2055,1947,4002
11391,22,State - CHHATTISGARH,Urban,60-64,Literate with No Education,1659,1743,3402
11392,22,State - CHHATTISGARH,Urban,65-69,Literate with No Education,1063,1166,2229
11393,22,State - CHHATTISGARH,Urban,70-74,Literate with No Education,820,840,1660
11394,22,State - CHHATTISGARH,Urban,75-79,Literate with No Education,362,389,751
11395,22,State - CHHATTISGARH,Urban,80+,Literate with No Education,436,548,984
11396,22,State - CHHATTISGARH,Urban,Age not stated,Literate with No Education,676,409,1085
11397,23,State - MADHYA PRADESH,Total,All ages,Literate with No Education,1048973,789299,1838272
11398,23,State - MADHYA PRADESH,Total,0-6,Literate with No Education,0,0,0
11399,23,State - MADHYA PRADESH,Total,7,Literate with No Education,10605,7619,18224
11400,23,State - MADHYA PRADESH,Total,8,Literate with No Education,8471,6420,14891
11401,23,State - MADHYA PRADESH,Total,9,Literate with No Education,6897,5269,12166
11402,23,State - MADHYA PRADESH,Total,10,Literate with No Education,9394,6923,16317
11403,23,State - MADHYA PRADESH,Total,11,Literate with No Education,7517,5810,13327
11404,23,State - MADHYA PRADESH,Total,12,Literate with No Education,9250,7444,16694
11405,23,State - MADHYA PRADESH,Total,13,Literate with No Education,8471,7291,15762
11406,23,State - MADHYA PRADESH,Total,14,Literate with No Education,10495,9544,20039
11407,23,State - MADHYA PRADESH,Total,15,Literate with No Education,14689,12775,27464
11408,23,State - MADHYA PRADESH,Total,16,Literate with No Education,16598,14880,31478
11409,23,State - MADHYA PRADESH,Total,17,Literate with No Education,16181,14396,30577
11410,23,State - MADHYA PRADESH,Total,18,Literate with No Education,27951,23604,51555
11411,23,State - MADHYA PRADESH,Total,19,Literate with No Education,20161,18350,38511
11412,23,State - MADHYA PRADESH,Total,20-24,Literate with No Education,135790,111595,247385
11413,23,State - MADHYA PRADESH,Total,25-29,Literate with No Education,135986,109133,245119
11414,23,State - MADHYA PRADESH,Total,30-34,Literate with No Education,118481,94310,212791
11415,23,State - MADHYA PRADESH,Total,35-39,Literate with No Education,108202,81072,189274
11416,23,State - MADHYA PRADESH,Total,40-44,Literate with No Education,93367,64891,158258
11417,23,State - MADHYA PRADESH,Total,45-49,Literate with No Education,76296,50781,127077
11418,23,State - MADHYA PRADESH,Total,50-54,Literate with No Education,57777,35340,93117
11419,23,State - MADHYA PRADESH,Total,55-59,Literate with No Education,40957,26914,67871
11420,23,State - MADHYA PRADESH,Total,60-64,Literate with No Education,38733,24485,63218
11421,23,State - MADHYA PRADESH,Total,65-69,Literate with No Education,26578,17328,43906
11422,23,State - MADHYA PRADESH,Total,70-74,Literate with No Education,20827,13025,33852
11423,23,State - MADHYA PRADESH,Total,75-79,Literate with No Education,9686,6558,16244
11424,23,State - MADHYA PRADESH,Total,80+,Literate with No Education,13136,9252,22388
11425,23,State - MADHYA PRADESH,Total,Age not stated,Literate with No Education,6477,4290,10767
11426,23,State - MADHYA PRADESH,Rural,All ages,Literate with No Education,757551,525552,1283103
11427,23,State - MADHYA PRADESH,Rural,0-6,Literate with No Education,0,0,0
11428,23,State - MADHYA PRADESH,Rural,7,Literate with No Education,7452,5333,12785
11429,23,State - MADHYA PRADESH,Rural,8,Literate with No Education,6235,4793,11028
11430,23,State - MADHYA PRADESH,Rural,9,Literate with No Education,5060,3878,8938
11431,23,State - MADHYA PRADESH,Rural,10,Literate with No Education,6836,5188,12024
11432,23,State - MADHYA PRADESH,Rural,11,Literate with No Education,5400,4351,9751
11433,23,State - MADHYA PRADESH,Rural,12,Literate with No Education,6837,5763,12600
11434,23,State - MADHYA PRADESH,Rural,13,Literate with No Education,6230,5594,11824
11435,23,State - MADHYA PRADESH,Rural,14,Literate with No Education,7974,7505,15479
11436,23,State - MADHYA PRADESH,Rural,15,Literate with No Education,11304,10287,21591
11437,23,State - MADHYA PRADESH,Rural,16,Literate with No Education,12848,11929,24777
11438,23,State - MADHYA PRADESH,Rural,17,Literate with No Education,12356,11232,23588
11439,23,State - MADHYA PRADESH,Rural,18,Literate with No Education,21488,18472,39960
11440,23,State - MADHYA PRADESH,Rural,19,Literate with No Education,15017,13838,28855
11441,23,State - MADHYA PRADESH,Rural,20-24,Literate with No Education,101120,79359,180479
11442,23,State - MADHYA PRADESH,Rural,25-29,Literate with No Education,96595,71585,168180
11443,23,State - MADHYA PRADESH,Rural,30-34,Literate with No Education,84564,61978,146542
11444,23,State - MADHYA PRADESH,Rural,35-39,Literate with No Education,78078,52196,130274
11445,23,State - MADHYA PRADESH,Rural,40-44,Literate with No Education,66901,40724,107625
11446,23,State - MADHYA PRADESH,Rural,45-49,Literate with No Education,53762,30258,84020
11447,23,State - MADHYA PRADESH,Rural,50-54,Literate with No Education,39879,20519,60398
11448,23,State - MADHYA PRADESH,Rural,55-59,Literate with No Education,28329,15850,44179
11449,23,State - MADHYA PRADESH,Rural,60-64,Literate with No Education,27982,14729,42711
11450,23,State - MADHYA PRADESH,Rural,65-69,Literate with No Education,19330,10629,29959
11451,23,State - MADHYA PRADESH,Rural,70-74,Literate with No Education,15394,7938,23332
11452,23,State - MADHYA PRADESH,Rural,75-79,Literate with No Education,7032,3874,10906
11453,23,State - MADHYA PRADESH,Rural,80+,Literate with No Education,9660,5420,15080
11454,23,State - MADHYA PRADESH,Rural,Age not stated,Literate with No Education,3888,2330,6218
11455,23,State - MADHYA PRADESH,Urban,All ages,Literate with No Education,291422,263747,555169
11456,23,State - MADHYA PRADESH,Urban,0-6,Literate with No Education,0,0,0
11457,23,State - MADHYA PRADESH,Urban,7,Literate with No Education,3153,2286,5439
11458,23,State - MADHYA PRADESH,Urban,8,Literate with No Education,2236,1627,3863
11459,23,State - MADHYA PRADESH,Urban,9,Literate with No Education,1837,1391,3228
11460,23,State - MADHYA PRADESH,Urban,10,Literate with No Education,2558,1735,4293
11461,23,State - MADHYA PRADESH,Urban,11,Literate with No Education,2117,1459,3576
11462,23,State - MADHYA PRADESH,Urban,12,Literate with No Education,2413,1681,4094
11463,23,State - MADHYA PRADESH,Urban,13,Literate with No Education,2241,1697,3938
11464,23,State - MADHYA PRADESH,Urban,14,Literate with No Education,2521,2039,4560
11465,23,State - MADHYA PRADESH,Urban,15,Literate with No Education,3385,2488,5873
11466,23,State - MADHYA PRADESH,Urban,16,Literate with No Education,3750,2951,6701
11467,23,State - MADHYA PRADESH,Urban,17,Literate with No Education,3825,3164,6989
11468,23,State - MADHYA PRADESH,Urban,18,Literate with No Education,6463,5132,11595
11469,23,State - MADHYA PRADESH,Urban,19,Literate with No Education,5144,4512,9656
11470,23,State - MADHYA PRADESH,Urban,20-24,Literate with No Education,34670,32236,66906
11471,23,State - MADHYA PRADESH,Urban,25-29,Literate with No Education,39391,37548,76939
11472,23,State - MADHYA PRADESH,Urban,30-34,Literate with No Education,33917,32332,66249
11473,23,State - MADHYA PRADESH,Urban,35-39,Literate with No Education,30124,28876,59000
11474,23,State - MADHYA PRADESH,Urban,40-44,Literate with No Education,26466,24167,50633
11475,23,State - MADHYA PRADESH,Urban,45-49,Literate with No Education,22534,20523,43057
11476,23,State - MADHYA PRADESH,Urban,50-54,Literate with No Education,17898,14821,32719
11477,23,State - MADHYA PRADESH,Urban,55-59,Literate with No Education,12628,11064,23692
11478,23,State - MADHYA PRADESH,Urban,60-64,Literate with No Education,10751,9756,20507
11479,23,State - MADHYA PRADESH,Urban,65-69,Literate with No Education,7248,6699,13947
11480,23,State - MADHYA PRADESH,Urban,70-74,Literate with No Education,5433,5087,10520
11481,23,State - MADHYA PRADESH,Urban,75-79,Literate with No Education,2654,2684,5338
11482,23,State - MADHYA PRADESH,Urban,80+,Literate with No Education,3476,3832,7308
11483,23,State - MADHYA PRADESH,Urban,Age not stated,Literate with No Education,2589,1960,4549
11484,24,State - GUJARAT,Total,All ages,Literate with No Education,1230706,1086717,2317423
11485,24,State - GUJARAT,Total,0-6,Literate with No Education,0,0,0
11486,24,State - GUJARAT,Total,7,Literate with No Education,12619,9090,21709
11487,24,State - GUJARAT,Total,8,Literate with No Education,10291,7801,18092
11488,24,State - GUJARAT,Total,9,Literate with No Education,9558,7511,17069
11489,24,State - GUJARAT,Total,10,Literate with No Education,11285,9117,20402
11490,24,State - GUJARAT,Total,11,Literate with No Education,11037,9283,20320
11491,24,State - GUJARAT,Total,12,Literate with No Education,11451,10560,22011
11492,24,State - GUJARAT,Total,13,Literate with No Education,11317,11358,22675
11493,24,State - GUJARAT,Total,14,Literate with No Education,13473,14127,27600
11494,24,State - GUJARAT,Total,15,Literate with No Education,17395,17383,34778
11495,24,State - GUJARAT,Total,16,Literate with No Education,19014,18965,37979
11496,24,State - GUJARAT,Total,17,Literate with No Education,21803,20016,41819
11497,24,State - GUJARAT,Total,18,Literate with No Education,30254,25878,56132
11498,24,State - GUJARAT,Total,19,Literate with No Education,26583,23883,50466
11499,24,State - GUJARAT,Total,20-24,Literate with No Education,162348,140706,303054
11500,24,State - GUJARAT,Total,25-29,Literate with No Education,171816,148438,320254
11501,24,State - GUJARAT,Total,30-34,Literate with No Education,143622,128204,271826
11502,24,State - GUJARAT,Total,35-39,Literate with No Education,122843,108401,231244
11503,24,State - GUJARAT,Total,40-44,Literate with No Education,101546,90658,192204
11504,24,State - GUJARAT,Total,45-49,Literate with No Education,83260,73585,156845
11505,24,State - GUJARAT,Total,50-54,Literate with No Education,67091,57044,124135
11506,24,State - GUJARAT,Total,55-59,Literate with No Education,49499,43423,92922
11507,24,State - GUJARAT,Total,60-64,Literate with No Education,39746,34767,74513
11508,24,State - GUJARAT,Total,65-69,Literate with No Education,25875,23624,49499
11509,24,State - GUJARAT,Total,70-74,Literate with No Education,18886,17915,36801
11510,24,State - GUJARAT,Total,75-79,Literate with No Education,9356,9462,18818
11511,24,State - GUJARAT,Total,80+,Literate with No Education,11033,12306,23339
11512,24,State - GUJARAT,Total,Age not stated,Literate with No Education,17705,13212,30917
11513,24,State - GUJARAT,Rural,All ages,Literate with No Education,685105,582541,1267646
11514,24,State - GUJARAT,Rural,0-6,Literate with No Education,0,0,0
11515,24,State - GUJARAT,Rural,7,Literate with No Education,6300,4881,11181
11516,24,State - GUJARAT,Rural,8,Literate with No Education,5697,4565,10262
11517,24,State - GUJARAT,Rural,9,Literate with No Education,5391,4483,9874
11518,24,State - GUJARAT,Rural,10,Literate with No Education,6283,5519,11802
11519,24,State - GUJARAT,Rural,11,Literate with No Education,6378,5680,12058
11520,24,State - GUJARAT,Rural,12,Literate with No Education,6934,6718,13652
11521,24,State - GUJARAT,Rural,13,Literate with No Education,6911,7581,14492
11522,24,State - GUJARAT,Rural,14,Literate with No Education,8301,9425,17726
11523,24,State - GUJARAT,Rural,15,Literate with No Education,10993,11807,22800
11524,24,State - GUJARAT,Rural,16,Literate with No Education,11846,12805,24651
11525,24,State - GUJARAT,Rural,17,Literate with No Education,13179,13138,26317
11526,24,State - GUJARAT,Rural,18,Literate with No Education,17428,16835,34263
11527,24,State - GUJARAT,Rural,19,Literate with No Education,14944,14844,29788
11528,24,State - GUJARAT,Rural,20-24,Literate with No Education,89517,80286,169803
11529,24,State - GUJARAT,Rural,25-29,Literate with No Education,91868,76967,168835
11530,24,State - GUJARAT,Rural,30-34,Literate with No Education,78508,67168,145676
11531,24,State - GUJARAT,Rural,35-39,Literate with No Education,68496,55850,124346
11532,24,State - GUJARAT,Rural,40-44,Literate with No Education,56677,46215,102892
11533,24,State - GUJARAT,Rural,45-49,Literate with No Education,46489,35588,82077
11534,24,State - GUJARAT,Rural,50-54,Literate with No Education,37085,27468,64553
11535,24,State - GUJARAT,Rural,55-59,Literate with No Education,27408,20973,48381
11536,24,State - GUJARAT,Rural,60-64,Literate with No Education,22782,16772,39554
11537,24,State - GUJARAT,Rural,65-69,Literate with No Education,14855,11635,26490
11538,24,State - GUJARAT,Rural,70-74,Literate with No Education,11035,8850,19885
11539,24,State - GUJARAT,Rural,75-79,Literate with No Education,5229,4379,9608
11540,24,State - GUJARAT,Rural,80+,Literate with No Education,6123,5575,11698
11541,24,State - GUJARAT,Rural,Age not stated,Literate with No Education,8448,6534,14982
11542,24,State - GUJARAT,Urban,All ages,Literate with No Education,545601,504176,1049777
11543,24,State - GUJARAT,Urban,0-6,Literate with No Education,0,0,0
11544,24,State - GUJARAT,Urban,7,Literate with No Education,6319,4209,10528
11545,24,State - GUJARAT,Urban,8,Literate with No Education,4594,3236,7830
11546,24,State - GUJARAT,Urban,9,Literate with No Education,4167,3028,7195
11547,24,State - GUJARAT,Urban,10,Literate with No Education,5002,3598,8600
11548,24,State - GUJARAT,Urban,11,Literate with No Education,4659,3603,8262
11549,24,State - GUJARAT,Urban,12,Literate with No Education,4517,3842,8359
11550,24,State - GUJARAT,Urban,13,Literate with No Education,4406,3777,8183
11551,24,State - GUJARAT,Urban,14,Literate with No Education,5172,4702,9874
11552,24,State - GUJARAT,Urban,15,Literate with No Education,6402,5576,11978
11553,24,State - GUJARAT,Urban,16,Literate with No Education,7168,6160,13328
11554,24,State - GUJARAT,Urban,17,Literate with No Education,8624,6878,15502
11555,24,State - GUJARAT,Urban,18,Literate with No Education,12826,9043,21869
11556,24,State - GUJARAT,Urban,19,Literate with No Education,11639,9039,20678
11557,24,State - GUJARAT,Urban,20-24,Literate with No Education,72831,60420,133251
11558,24,State - GUJARAT,Urban,25-29,Literate with No Education,79948,71471,151419
11559,24,State - GUJARAT,Urban,30-34,Literate with No Education,65114,61036,126150
11560,24,State - GUJARAT,Urban,35-39,Literate with No Education,54347,52551,106898
11561,24,State - GUJARAT,Urban,40-44,Literate with No Education,44869,44443,89312
11562,24,State - GUJARAT,Urban,45-49,Literate with No Education,36771,37997,74768
11563,24,State - GUJARAT,Urban,50-54,Literate with No Education,30006,29576,59582
11564,24,State - GUJARAT,Urban,55-59,Literate with No Education,22091,22450,44541
11565,24,State - GUJARAT,Urban,60-64,Literate with No Education,16964,17995,34959
11566,24,State - GUJARAT,Urban,65-69,Literate with No Education,11020,11989,23009
11567,24,State - GUJARAT,Urban,70-74,Literate with No Education,7851,9065,16916
11568,24,State - GUJARAT,Urban,75-79,Literate with No Education,4127,5083,9210
11569,24,State - GUJARAT,Urban,80+,Literate with No Education,4910,6731,11641
11570,24,State - GUJARAT,Urban,Age not stated,Literate with No Education,9257,6678,15935
11571,25,State - DAMAN & DIU,Total,All ages,Literate with No Education,4342,2156,6498
11572,25,State - DAMAN & DIU,Total,0-6,Literate with No Education,0,0,0
11573,25,State - DAMAN & DIU,Total,7,Literate with No Education,28,19,47
11574,25,State - DAMAN & DIU,Total,8,Literate with No Education,27,21,48
11575,25,State - DAMAN & DIU,Total,9,Literate with No Education,20,15,35
11576,25,State - DAMAN & DIU,Total,10,Literate with No Education,27,19,46
11577,25,State - DAMAN & DIU,Total,11,Literate with No Education,25,16,41
11578,25,State - DAMAN & DIU,Total,12,Literate with No Education,15,17,32
11579,25,State - DAMAN & DIU,Total,13,Literate with No Education,27,18,45
11580,25,State - DAMAN & DIU,Total,14,Literate with No Education,28,17,45
11581,25,State - DAMAN & DIU,Total,15,Literate with No Education,44,20,64
11582,25,State - DAMAN & DIU,Total,16,Literate with No Education,51,18,69
11583,25,State - DAMAN & DIU,Total,17,Literate with No Education,69,22,91
11584,25,State - DAMAN & DIU,Total,18,Literate with No Education,200,27,227
11585,25,State - DAMAN & DIU,Total,19,Literate with No Education,133,32,165
11586,25,State - DAMAN & DIU,Total,20-24,Literate with No Education,948,303,1251
11587,25,State - DAMAN & DIU,Total,25-29,Literate with No Education,813,407,1220
11588,25,State - DAMAN & DIU,Total,30-34,Literate with No Education,482,302,784
11589,25,State - DAMAN & DIU,Total,35-39,Literate with No Education,459,229,688
11590,25,State - DAMAN & DIU,Total,40-44,Literate with No Education,285,174,459
11591,25,State - DAMAN & DIU,Total,45-49,Literate with No Education,212,114,326
11592,25,State - DAMAN & DIU,Total,50-54,Literate with No Education,116,95,211
11593,25,State - DAMAN & DIU,Total,55-59,Literate with No Education,78,69,147
11594,25,State - DAMAN & DIU,Total,60-64,Literate with No Education,64,76,140
11595,25,State - DAMAN & DIU,Total,65-69,Literate with No Education,34,42,76
11596,25,State - DAMAN & DIU,Total,70-74,Literate with No Education,28,30,58
11597,25,State - DAMAN & DIU,Total,75-79,Literate with No Education,17,8,25
11598,25,State - DAMAN & DIU,Total,80+,Literate with No Education,24,22,46
11599,25,State - DAMAN & DIU,Total,Age not stated,Literate with No Education,88,24,112
11600,25,State - DAMAN & DIU,Rural,All ages,Literate with No Education,739,596,1335
11601,25,State - DAMAN & DIU,Rural,0-6,Literate with No Education,0,0,0
11602,25,State - DAMAN & DIU,Rural,7,Literate with No Education,10,4,14
11603,25,State - DAMAN & DIU,Rural,8,Literate with No Education,8,10,18
11604,25,State - DAMAN & DIU,Rural,9,Literate with No Education,8,4,12
11605,25,State - DAMAN & DIU,Rural,10,Literate with No Education,4,9,13
11606,25,State - DAMAN & DIU,Rural,11,Literate with No Education,7,8,15
11607,25,State - DAMAN & DIU,Rural,12,Literate with No Education,6,5,11
11608,25,State - DAMAN & DIU,Rural,13,Literate with No Education,8,8,16
11609,25,State - DAMAN & DIU,Rural,14,Literate with No Education,6,4,10
11610,25,State - DAMAN & DIU,Rural,15,Literate with No Education,7,7,14
11611,25,State - DAMAN & DIU,Rural,16,Literate with No Education,8,4,12
11612,25,State - DAMAN & DIU,Rural,17,Literate with No Education,9,7,16
11613,25,State - DAMAN & DIU,Rural,18,Literate with No Education,31,12,43
11614,25,State - DAMAN & DIU,Rural,19,Literate with No Education,16,19,35
11615,25,State - DAMAN & DIU,Rural,20-24,Literate with No Education,101,79,180
11616,25,State - DAMAN & DIU,Rural,25-29,Literate with No Education,110,94,204
11617,25,State - DAMAN & DIU,Rural,30-34,Literate with No Education,72,70,142
11618,25,State - DAMAN & DIU,Rural,35-39,Literate with No Education,110,57,167
11619,25,State - DAMAN & DIU,Rural,40-44,Literate with No Education,60,51,111
11620,25,State - DAMAN & DIU,Rural,45-49,Literate with No Education,57,33,90
11621,25,State - DAMAN & DIU,Rural,50-54,Literate with No Education,25,31,56
11622,25,State - DAMAN & DIU,Rural,55-59,Literate with No Education,21,27,48
11623,25,State - DAMAN & DIU,Rural,60-64,Literate with No Education,21,21,42
11624,25,State - DAMAN & DIU,Rural,65-69,Literate with No Education,6,7,13
11625,25,State - DAMAN & DIU,Rural,70-74,Literate with No Education,8,9,17
11626,25,State - DAMAN & DIU,Rural,75-79,Literate with No Education,5,3,8
11627,25,State - DAMAN & DIU,Rural,80+,Literate with No Education,5,5,10
11628,25,State - DAMAN & DIU,Rural,Age not stated,Literate with No Education,10,8,18
11629,25,State - DAMAN & DIU,Urban,All ages,Literate with No Education,3603,1560,5163
11630,25,State - DAMAN & DIU,Urban,0-6,Literate with No Education,0,0,0
11631,25,State - DAMAN & DIU,Urban,7,Literate with No Education,18,15,33
11632,25,State - DAMAN & DIU,Urban,8,Literate with No Education,19,11,30
11633,25,State - DAMAN & DIU,Urban,9,Literate with No Education,12,11,23
11634,25,State - DAMAN & DIU,Urban,10,Literate with No Education,23,10,33
11635,25,State - DAMAN & DIU,Urban,11,Literate with No Education,18,8,26
11636,25,State - DAMAN & DIU,Urban,12,Literate with No Education,9,12,21
11637,25,State - DAMAN & DIU,Urban,13,Literate with No Education,19,10,29
11638,25,State - DAMAN & DIU,Urban,14,Literate with No Education,22,13,35
11639,25,State - DAMAN & DIU,Urban,15,Literate with No Education,37,13,50
11640,25,State - DAMAN & DIU,Urban,16,Literate with No Education,43,14,57
11641,25,State - DAMAN & DIU,Urban,17,Literate with No Education,60,15,75
11642,25,State - DAMAN & DIU,Urban,18,Literate with No Education,169,15,184
11643,25,State - DAMAN & DIU,Urban,19,Literate with No Education,117,13,130
11644,25,State - DAMAN & DIU,Urban,20-24,Literate with No Education,847,224,1071
11645,25,State - DAMAN & DIU,Urban,25-29,Literate with No Education,703,313,1016
11646,25,State - DAMAN & DIU,Urban,30-34,Literate with No Education,410,232,642
11647,25,State - DAMAN & DIU,Urban,35-39,Literate with No Education,349,172,521
11648,25,State - DAMAN & DIU,Urban,40-44,Literate with No Education,225,123,348
11649,25,State - DAMAN & DIU,Urban,45-49,Literate with No Education,155,81,236
11650,25,State - DAMAN & DIU,Urban,50-54,Literate with No Education,91,64,155
11651,25,State - DAMAN & DIU,Urban,55-59,Literate with No Education,57,42,99
11652,25,State - DAMAN & DIU,Urban,60-64,Literate with No Education,43,55,98
11653,25,State - DAMAN & DIU,Urban,65-69,Literate with No Education,28,35,63
11654,25,State - DAMAN & DIU,Urban,70-74,Literate with No Education,20,21,41
11655,25,State - DAMAN & DIU,Urban,75-79,Literate with No Education,12,5,17
11656,25,State - DAMAN & DIU,Urban,80+,Literate with No Education,19,17,36
11657,25,State - DAMAN & DIU,Urban,Age not stated,Literate with No Education,78,16,94
11658,26,State - DADRA & NAGAR HAVELI,Total,All ages,Literate with No Education,8683,4428,13111
11659,26,State - DADRA & NAGAR HAVELI,Total,0-6,Literate with No Education,0,0,0
11660,26,State - DADRA & NAGAR HAVELI,Total,7,Literate with No Education,72,43,115
11661,26,State - DADRA & NAGAR HAVELI,Total,8,Literate with No Education,53,66,119
11662,26,State - DADRA & NAGAR HAVELI,Total,9,Literate with No Education,57,54,111
11663,26,State - DADRA & NAGAR HAVELI,Total,10,Literate with No Education,63,43,106
11664,26,State - DADRA & NAGAR HAVELI,Total,11,Literate with No Education,64,52,116
11665,26,State - DADRA & NAGAR HAVELI,Total,12,Literate with No Education,62,57,119
11666,26,State - DADRA & NAGAR HAVELI,Total,13,Literate with No Education,74,61,135
11667,26,State - DADRA & NAGAR HAVELI,Total,14,Literate with No Education,73,55,128
11668,26,State - DADRA & NAGAR HAVELI,Total,15,Literate with No Education,86,68,154
11669,26,State - DADRA & NAGAR HAVELI,Total,16,Literate with No Education,103,77,180
11670,26,State - DADRA & NAGAR HAVELI,Total,17,Literate with No Education,136,61,197
11671,26,State - DADRA & NAGAR HAVELI,Total,18,Literate with No Education,284,124,408
11672,26,State - DADRA & NAGAR HAVELI,Total,19,Literate with No Education,332,118,450
11673,26,State - DADRA & NAGAR HAVELI,Total,20-24,Literate with No Education,1768,807,2575
11674,26,State - DADRA & NAGAR HAVELI,Total,25-29,Literate with No Education,1721,865,2586
11675,26,State - DADRA & NAGAR HAVELI,Total,30-34,Literate with No Education,1163,600,1763
11676,26,State - DADRA & NAGAR HAVELI,Total,35-39,Literate with No Education,880,470,1350
11677,26,State - DADRA & NAGAR HAVELI,Total,40-44,Literate with No Education,578,248,826
11678,26,State - DADRA & NAGAR HAVELI,Total,45-49,Literate with No Education,410,178,588
11679,26,State - DADRA & NAGAR HAVELI,Total,50-54,Literate with No Education,252,113,365
11680,26,State - DADRA & NAGAR HAVELI,Total,55-59,Literate with No Education,175,86,261
11681,26,State - DADRA & NAGAR HAVELI,Total,60-64,Literate with No Education,101,65,166
11682,26,State - DADRA & NAGAR HAVELI,Total,65-69,Literate with No Education,73,43,116
11683,26,State - DADRA & NAGAR HAVELI,Total,70-74,Literate with No Education,30,20,50
11684,26,State - DADRA & NAGAR HAVELI,Total,75-79,Literate with No Education,15,22,37
11685,26,State - DADRA & NAGAR HAVELI,Total,80+,Literate with No Education,19,19,38
11686,26,State - DADRA & NAGAR HAVELI,Total,Age not stated,Literate with No Education,39,13,52
11687,26,State - DADRA & NAGAR HAVELI,Rural,All ages,Literate with No Education,4237,1798,6035
11688,26,State - DADRA & NAGAR HAVELI,Rural,0-6,Literate with No Education,0,0,0
11689,26,State - DADRA & NAGAR HAVELI,Rural,7,Literate with No Education,38,23,61
11690,26,State - DADRA & NAGAR HAVELI,Rural,8,Literate with No Education,35,41,76
11691,26,State - DADRA & NAGAR HAVELI,Rural,9,Literate with No Education,34,34,68
11692,26,State - DADRA & NAGAR HAVELI,Rural,10,Literate with No Education,40,33,73
11693,26,State - DADRA & NAGAR HAVELI,Rural,11,Literate with No Education,45,34,79
11694,26,State - DADRA & NAGAR HAVELI,Rural,12,Literate with No Education,40,39,79
11695,26,State - DADRA & NAGAR HAVELI,Rural,13,Literate with No Education,52,37,89
11696,26,State - DADRA & NAGAR HAVELI,Rural,14,Literate with No Education,45,45,90
11697,26,State - DADRA & NAGAR HAVELI,Rural,15,Literate with No Education,53,45,98
11698,26,State - DADRA & NAGAR HAVELI,Rural,16,Literate with No Education,57,54,111
11699,26,State - DADRA & NAGAR HAVELI,Rural,17,Literate with No Education,91,45,136
11700,26,State - DADRA & NAGAR HAVELI,Rural,18,Literate with No Education,160,75,235
11701,26,State - DADRA & NAGAR HAVELI,Rural,19,Literate with No Education,186,73,259
11702,26,State - DADRA & NAGAR HAVELI,Rural,20-24,Literate with No Education,963,381,1344
11703,26,State - DADRA & NAGAR HAVELI,Rural,25-29,Literate with No Education,869,301,1170
11704,26,State - DADRA & NAGAR HAVELI,Rural,30-34,Literate with No Education,488,168,656
11705,26,State - DADRA & NAGAR HAVELI,Rural,35-39,Literate with No Education,315,123,438
11706,26,State - DADRA & NAGAR HAVELI,Rural,40-44,Literate with No Education,231,62,293
11707,26,State - DADRA & NAGAR HAVELI,Rural,45-49,Literate with No Education,191,62,253
11708,26,State - DADRA & NAGAR HAVELI,Rural,50-54,Literate with No Education,114,39,153
11709,26,State - DADRA & NAGAR HAVELI,Rural,55-59,Literate with No Education,64,27,91
11710,26,State - DADRA & NAGAR HAVELI,Rural,60-64,Literate with No Education,44,16,60
11711,26,State - DADRA & NAGAR HAVELI,Rural,65-69,Literate with No Education,34,18,52
11712,26,State - DADRA & NAGAR HAVELI,Rural,70-74,Literate with No Education,12,1,13
11713,26,State - DADRA & NAGAR HAVELI,Rural,75-79,Literate with No Education,4,6,10
11714,26,State - DADRA & NAGAR HAVELI,Rural,80+,Literate with No Education,8,4,12
11715,26,State - DADRA & NAGAR HAVELI,Rural,Age not stated,Literate with No Education,24,12,36
11716,26,State - DADRA & NAGAR HAVELI,Urban,All ages,Literate with No Education,4446,2630,7076
11717,26,State - DADRA & NAGAR HAVELI,Urban,0-6,Literate with No Education,0,0,0
11718,26,State - DADRA & NAGAR HAVELI,Urban,7,Literate with No Education,34,20,54
11719,26,State - DADRA & NAGAR HAVELI,Urban,8,Literate with No Education,18,25,43
11720,26,State - DADRA & NAGAR HAVELI,Urban,9,Literate with No Education,23,20,43
11721,26,State - DADRA & NAGAR HAVELI,Urban,10,Literate with No Education,23,10,33
11722,26,State - DADRA & NAGAR HAVELI,Urban,11,Literate with No Education,19,18,37
11723,26,State - DADRA & NAGAR HAVELI,Urban,12,Literate with No Education,22,18,40
11724,26,State - DADRA & NAGAR HAVELI,Urban,13,Literate with No Education,22,24,46
11725,26,State - DADRA & NAGAR HAVELI,Urban,14,Literate with No Education,28,10,38
11726,26,State - DADRA & NAGAR HAVELI,Urban,15,Literate with No Education,33,23,56
11727,26,State - DADRA & NAGAR HAVELI,Urban,16,Literate with No Education,46,23,69
11728,26,State - DADRA & NAGAR HAVELI,Urban,17,Literate with No Education,45,16,61
11729,26,State - DADRA & NAGAR HAVELI,Urban,18,Literate with No Education,124,49,173
11730,26,State - DADRA & NAGAR HAVELI,Urban,19,Literate with No Education,146,45,191
11731,26,State - DADRA & NAGAR HAVELI,Urban,20-24,Literate with No Education,805,426,1231
11732,26,State - DADRA & NAGAR HAVELI,Urban,25-29,Literate with No Education,852,564,1416
11733,26,State - DADRA & NAGAR HAVELI,Urban,30-34,Literate with No Education,675,432,1107
11734,26,State - DADRA & NAGAR HAVELI,Urban,35-39,Literate with No Education,565,347,912
11735,26,State - DADRA & NAGAR HAVELI,Urban,40-44,Literate with No Education,347,186,533
11736,26,State - DADRA & NAGAR HAVELI,Urban,45-49,Literate with No Education,219,116,335
11737,26,State - DADRA & NAGAR HAVELI,Urban,50-54,Literate with No Education,138,74,212
11738,26,State - DADRA & NAGAR HAVELI,Urban,55-59,Literate with No Education,111,59,170
11739,26,State - DADRA & NAGAR HAVELI,Urban,60-64,Literate with No Education,57,49,106
11740,26,State - DADRA & NAGAR HAVELI,Urban,65-69,Literate with No Education,39,25,64
11741,26,State - DADRA & NAGAR HAVELI,Urban,70-74,Literate with No Education,18,19,37
11742,26,State - DADRA & NAGAR HAVELI,Urban,75-79,Literate with No Education,11,16,27
11743,26,State - DADRA & NAGAR HAVELI,Urban,80+,Literate with No Education,11,15,26
11744,26,State - DADRA & NAGAR HAVELI,Urban,Age not stated,Literate with No Education,15,1,16
11745,27,State - MAHARASHTRA,Total,All ages,Literate with No Education,2079746,2048132,4127878
11746,27,State - MAHARASHTRA,Total,0-6,Literate with No Education,0,0,0
11747,27,State - MAHARASHTRA,Total,7,Literate with No Education,22937,17685,40622
11748,27,State - MAHARASHTRA,Total,8,Literate with No Education,14617,11748,26365
11749,27,State - MAHARASHTRA,Total,9,Literate with No Education,14317,11284,25601
11750,27,State - MAHARASHTRA,Total,10,Literate with No Education,17956,14030,31986
11751,27,State - MAHARASHTRA,Total,11,Literate with No Education,15385,12168,27553
11752,27,State - MAHARASHTRA,Total,12,Literate with No Education,15369,12470,27839
11753,27,State - MAHARASHTRA,Total,13,Literate with No Education,14805,12521,27326
11754,27,State - MAHARASHTRA,Total,14,Literate with No Education,16526,14100,30626
11755,27,State - MAHARASHTRA,Total,15,Literate with No Education,19960,16964,36924
11756,27,State - MAHARASHTRA,Total,16,Literate with No Education,22231,18477,40708
11757,27,State - MAHARASHTRA,Total,17,Literate with No Education,23814,20004,43818
11758,27,State - MAHARASHTRA,Total,18,Literate with No Education,36383,31676,68059
11759,27,State - MAHARASHTRA,Total,19,Literate with No Education,33269,32027,65296
11760,27,State - MAHARASHTRA,Total,20-24,Literate with No Education,227603,219051,446654
11761,27,State - MAHARASHTRA,Total,25-29,Literate with No Education,263724,247559,511283
11762,27,State - MAHARASHTRA,Total,30-34,Literate with No Education,225111,217786,442897
11763,27,State - MAHARASHTRA,Total,35-39,Literate with No Education,208392,208552,416944
11764,27,State - MAHARASHTRA,Total,40-44,Literate with No Education,183788,179721,363509
11765,27,State - MAHARASHTRA,Total,45-49,Literate with No Education,152493,154358,306851
11766,27,State - MAHARASHTRA,Total,50-54,Literate with No Education,127139,125348,252487
11767,27,State - MAHARASHTRA,Total,55-59,Literate with No Education,97787,103941,201728
11768,27,State - MAHARASHTRA,Total,60-64,Literate with No Education,89177,109486,198663
11769,27,State - MAHARASHTRA,Total,65-69,Literate with No Education,78700,95997,174697
11770,27,State - MAHARASHTRA,Total,70-74,Literate with No Education,58548,65799,124347
11771,27,State - MAHARASHTRA,Total,75-79,Literate with No Education,28620,32787,61407
11772,27,State - MAHARASHTRA,Total,80+,Literate with No Education,32816,39155,71971
11773,27,State - MAHARASHTRA,Total,Age not stated,Literate with No Education,38279,23438,61717
11774,27,State - MAHARASHTRA,Rural,All ages,Literate with No Education,1232270,1253858,2486128
11775,27,State - MAHARASHTRA,Rural,0-6,Literate with No Education,0,0,0
11776,27,State - MAHARASHTRA,Rural,7,Literate with No Education,12809,10240,23049
11777,27,State - MAHARASHTRA,Rural,8,Literate with No Education,8773,7261,16034
11778,27,State - MAHARASHTRA,Rural,9,Literate with No Education,8776,7039,15815
11779,27,State - MAHARASHTRA,Rural,10,Literate with No Education,10784,8804,19588
11780,27,State - MAHARASHTRA,Rural,11,Literate with No Education,9534,7796,17330
11781,27,State - MAHARASHTRA,Rural,12,Literate with No Education,9514,8225,17739
11782,27,State - MAHARASHTRA,Rural,13,Literate with No Education,9319,8336,17655
11783,27,State - MAHARASHTRA,Rural,14,Literate with No Education,10428,9436,19864
11784,27,State - MAHARASHTRA,Rural,15,Literate with No Education,12849,11442,24291
11785,27,State - MAHARASHTRA,Rural,16,Literate with No Education,14677,12561,27238
11786,27,State - MAHARASHTRA,Rural,17,Literate with No Education,14792,13169,27961
11787,27,State - MAHARASHTRA,Rural,18,Literate with No Education,22230,20899,43129
11788,27,State - MAHARASHTRA,Rural,19,Literate with No Education,19559,20503,40062
11789,27,State - MAHARASHTRA,Rural,20-24,Literate with No Education,131778,132217,263995
11790,27,State - MAHARASHTRA,Rural,25-29,Literate with No Education,145207,140260,285467
11791,27,State - MAHARASHTRA,Rural,30-34,Literate with No Education,124362,125912,250274
11792,27,State - MAHARASHTRA,Rural,35-39,Literate with No Education,117963,123624,241587
11793,27,State - MAHARASHTRA,Rural,40-44,Literate with No Education,107550,108176,215726
11794,27,State - MAHARASHTRA,Rural,45-49,Literate with No Education,90057,92869,182926
11795,27,State - MAHARASHTRA,Rural,50-54,Literate with No Education,76290,76453,152743
11796,27,State - MAHARASHTRA,Rural,55-59,Literate with No Education,59184,64833,124017
11797,27,State - MAHARASHTRA,Rural,60-64,Literate with No Education,57066,72815,129881
11798,27,State - MAHARASHTRA,Rural,65-69,Literate with No Education,55608,67188,122796
11799,27,State - MAHARASHTRA,Rural,70-74,Literate with No Education,42254,45481,87735
11800,27,State - MAHARASHTRA,Rural,75-79,Literate with No Education,19958,21462,41420
11801,27,State - MAHARASHTRA,Rural,80+,Literate with No Education,22122,24591,46713
11802,27,State - MAHARASHTRA,Rural,Age not stated,Literate with No Education,18827,12266,31093
11803,27,State - MAHARASHTRA,Urban,All ages,Literate with No Education,847476,794274,1641750
11804,27,State - MAHARASHTRA,Urban,0-6,Literate with No Education,0,0,0
11805,27,State - MAHARASHTRA,Urban,7,Literate with No Education,10128,7445,17573
11806,27,State - MAHARASHTRA,Urban,8,Literate with No Education,5844,4487,10331
11807,27,State - MAHARASHTRA,Urban,9,Literate with No Education,5541,4245,9786
11808,27,State - MAHARASHTRA,Urban,10,Literate with No Education,7172,5226,12398
11809,27,State - MAHARASHTRA,Urban,11,Literate with No Education,5851,4372,10223
11810,27,State - MAHARASHTRA,Urban,12,Literate with No Education,5855,4245,10100
11811,27,State - MAHARASHTRA,Urban,13,Literate with No Education,5486,4185,9671
11812,27,State - MAHARASHTRA,Urban,14,Literate with No Education,6098,4664,10762
11813,27,State - MAHARASHTRA,Urban,15,Literate with No Education,7111,5522,12633
11814,27,State - MAHARASHTRA,Urban,16,Literate with No Education,7554,5916,13470
11815,27,State - MAHARASHTRA,Urban,17,Literate with No Education,9022,6835,15857
11816,27,State - MAHARASHTRA,Urban,18,Literate with No Education,14153,10777,24930
11817,27,State - MAHARASHTRA,Urban,19,Literate with No Education,13710,11524,25234
11818,27,State - MAHARASHTRA,Urban,20-24,Literate with No Education,95825,86834,182659
11819,27,State - MAHARASHTRA,Urban,25-29,Literate with No Education,118517,107299,225816
11820,27,State - MAHARASHTRA,Urban,30-34,Literate with No Education,100749,91874,192623
11821,27,State - MAHARASHTRA,Urban,35-39,Literate with No Education,90429,84928,175357
11822,27,State - MAHARASHTRA,Urban,40-44,Literate with No Education,76238,71545,147783
11823,27,State - MAHARASHTRA,Urban,45-49,Literate with No Education,62436,61489,123925
11824,27,State - MAHARASHTRA,Urban,50-54,Literate with No Education,50849,48895,99744
11825,27,State - MAHARASHTRA,Urban,55-59,Literate with No Education,38603,39108,77711
11826,27,State - MAHARASHTRA,Urban,60-64,Literate with No Education,32111,36671,68782
11827,27,State - MAHARASHTRA,Urban,65-69,Literate with No Education,23092,28809,51901
11828,27,State - MAHARASHTRA,Urban,70-74,Literate with No Education,16294,20318,36612
11829,27,State - MAHARASHTRA,Urban,75-79,Literate with No Education,8662,11325,19987
11830,27,State - MAHARASHTRA,Urban,80+,Literate with No Education,10694,14564,25258
11831,27,State - MAHARASHTRA,Urban,Age not stated,Literate with No Education,19452,11172,30624
11832,28,State - ANDHRA PRADESH,Total,All ages,Literate with No Education,1741175,1401136,3142311
11833,28,State - ANDHRA PRADESH,Total,0-6,Literate with No Education,0,0,0
11834,28,State - ANDHRA PRADESH,Total,7,Literate with No Education,15089,11017,26106
11835,28,State - ANDHRA PRADESH,Total,8,Literate with No Education,12586,9983,22569
11836,28,State - ANDHRA PRADESH,Total,9,Literate with No Education,12590,9697,22287
11837,28,State - ANDHRA PRADESH,Total,10,Literate with No Education,15665,12191,27856
11838,28,State - ANDHRA PRADESH,Total,11,Literate with No Education,13485,10773,24258
11839,28,State - ANDHRA PRADESH,Total,12,Literate with No Education,15312,12493,27805
11840,28,State - ANDHRA PRADESH,Total,13,Literate with No Education,14601,12138,26739
11841,28,State - ANDHRA PRADESH,Total,14,Literate with No Education,16985,14387,31372
11842,28,State - ANDHRA PRADESH,Total,15,Literate with No Education,21200,17768,38968
11843,28,State - ANDHRA PRADESH,Total,16,Literate with No Education,23402,20009,43411
11844,28,State - ANDHRA PRADESH,Total,17,Literate with No Education,25235,21273,46508
11845,28,State - ANDHRA PRADESH,Total,18,Literate with No Education,36799,34143,70942
11846,28,State - ANDHRA PRADESH,Total,19,Literate with No Education,32405,31488,63893
11847,28,State - ANDHRA PRADESH,Total,20-24,Literate with No Education,200001,193247,393248
11848,28,State - ANDHRA PRADESH,Total,25-29,Literate with No Education,237164,211695,448859
11849,28,State - ANDHRA PRADESH,Total,30-34,Literate with No Education,195066,157962,353028
11850,28,State - ANDHRA PRADESH,Total,35-39,Literate with No Education,181851,143854,325705
11851,28,State - ANDHRA PRADESH,Total,40-44,Literate with No Education,146478,101365,247843
11852,28,State - ANDHRA PRADESH,Total,45-49,Literate with No Education,118411,82470,200881
11853,28,State - ANDHRA PRADESH,Total,50-54,Literate with No Education,89712,60427,150139
11854,28,State - ANDHRA PRADESH,Total,55-59,Literate with No Education,65713,49667,115380
11855,28,State - ANDHRA PRADESH,Total,60-64,Literate with No Education,65616,48261,113877
11856,28,State - ANDHRA PRADESH,Total,65-69,Literate with No Education,44981,31449,76430
11857,28,State - ANDHRA PRADESH,Total,70-74,Literate with No Education,31070,20784,51854
11858,28,State - ANDHRA PRADESH,Total,75-79,Literate with No Education,14381,10255,24636
11859,28,State - ANDHRA PRADESH,Total,80+,Literate with No Education,17488,15180,32668
11860,28,State - ANDHRA PRADESH,Total,Age not stated,Literate with No Education,77889,57160,135049
11861,28,State - ANDHRA PRADESH,Rural,All ages,Literate with No Education,1065591,791342,1856933
11862,28,State - ANDHRA PRADESH,Rural,0-6,Literate with No Education,0,0,0
11863,28,State - ANDHRA PRADESH,Rural,7,Literate with No Education,8601,6437,15038
11864,28,State - ANDHRA PRADESH,Rural,8,Literate with No Education,7374,6105,13479
11865,28,State - ANDHRA PRADESH,Rural,9,Literate with No Education,7332,5903,13235
11866,28,State - ANDHRA PRADESH,Rural,10,Literate with No Education,9031,7243,16274
11867,28,State - ANDHRA PRADESH,Rural,11,Literate with No Education,7863,6611,14474
11868,28,State - ANDHRA PRADESH,Rural,12,Literate with No Education,9404,8144,17548
11869,28,State - ANDHRA PRADESH,Rural,13,Literate with No Education,9175,8022,17197
11870,28,State - ANDHRA PRADESH,Rural,14,Literate with No Education,10887,9627,20514
11871,28,State - ANDHRA PRADESH,Rural,15,Literate with No Education,13801,12268,26069
11872,28,State - ANDHRA PRADESH,Rural,16,Literate with No Education,15324,13477,28801
11873,28,State - ANDHRA PRADESH,Rural,17,Literate with No Education,16374,14025,30399
11874,28,State - ANDHRA PRADESH,Rural,18,Literate with No Education,25460,23313,48773
11875,28,State - ANDHRA PRADESH,Rural,19,Literate with No Education,21646,20243,41889
11876,28,State - ANDHRA PRADESH,Rural,20-24,Literate with No Education,133389,119865,253254
11877,28,State - ANDHRA PRADESH,Rural,25-29,Literate with No Education,147741,121154,268895
11878,28,State - ANDHRA PRADESH,Rural,30-34,Literate with No Education,118285,87244,205529
11879,28,State - ANDHRA PRADESH,Rural,35-39,Literate with No Education,109177,76654,185831
11880,28,State - ANDHRA PRADESH,Rural,40-44,Literate with No Education,85926,51514,137440
11881,28,State - ANDHRA PRADESH,Rural,45-49,Literate with No Education,68437,41270,109707
11882,28,State - ANDHRA PRADESH,Rural,50-54,Literate with No Education,51455,29830,81285
11883,28,State - ANDHRA PRADESH,Rural,55-59,Literate with No Education,37493,25832,63325
11884,28,State - ANDHRA PRADESH,Rural,60-64,Literate with No Education,41169,26851,68020
11885,28,State - ANDHRA PRADESH,Rural,65-69,Literate with No Education,29586,17605,47191
11886,28,State - ANDHRA PRADESH,Rural,70-74,Literate with No Education,20605,11242,31847
11887,28,State - ANDHRA PRADESH,Rural,75-79,Literate with No Education,9080,5094,14174
11888,28,State - ANDHRA PRADESH,Rural,80+,Literate with No Education,10504,7409,17913
11889,28,State - ANDHRA PRADESH,Rural,Age not stated,Literate with No Education,40472,28360,68832
11890,28,State - ANDHRA PRADESH,Urban,All ages,Literate with No Education,675584,609794,1285378
11891,28,State - ANDHRA PRADESH,Urban,0-6,Literate with No Education,0,0,0
11892,28,State - ANDHRA PRADESH,Urban,7,Literate with No Education,6488,4580,11068
11893,28,State - ANDHRA PRADESH,Urban,8,Literate with No Education,5212,3878,9090
11894,28,State - ANDHRA PRADESH,Urban,9,Literate with No Education,5258,3794,9052
11895,28,State - ANDHRA PRADESH,Urban,10,Literate with No Education,6634,4948,11582
11896,28,State - ANDHRA PRADESH,Urban,11,Literate with No Education,5622,4162,9784
11897,28,State - ANDHRA PRADESH,Urban,12,Literate with No Education,5908,4349,10257
11898,28,State - ANDHRA PRADESH,Urban,13,Literate with No Education,5426,4116,9542
11899,28,State - ANDHRA PRADESH,Urban,14,Literate with No Education,6098,4760,10858
11900,28,State - ANDHRA PRADESH,Urban,15,Literate with No Education,7399,5500,12899
11901,28,State - ANDHRA PRADESH,Urban,16,Literate with No Education,8078,6532,14610
11902,28,State - ANDHRA PRADESH,Urban,17,Literate with No Education,8861,7248,16109
11903,28,State - ANDHRA PRADESH,Urban,18,Literate with No Education,11339,10830,22169
11904,28,State - ANDHRA PRADESH,Urban,19,Literate with No Education,10759,11245,22004
11905,28,State - ANDHRA PRADESH,Urban,20-24,Literate with No Education,66612,73382,139994
11906,28,State - ANDHRA PRADESH,Urban,25-29,Literate with No Education,89423,90541,179964
11907,28,State - ANDHRA PRADESH,Urban,30-34,Literate with No Education,76781,70718,147499
11908,28,State - ANDHRA PRADESH,Urban,35-39,Literate with No Education,72674,67200,139874
11909,28,State - ANDHRA PRADESH,Urban,40-44,Literate with No Education,60552,49851,110403
11910,28,State - ANDHRA PRADESH,Urban,45-49,Literate with No Education,49974,41200,91174
11911,28,State - ANDHRA PRADESH,Urban,50-54,Literate with No Education,38257,30597,68854
11912,28,State - ANDHRA PRADESH,Urban,55-59,Literate with No Education,28220,23835,52055
11913,28,State - ANDHRA PRADESH,Urban,60-64,Literate with No Education,24447,21410,45857
11914,28,State - ANDHRA PRADESH,Urban,65-69,Literate with No Education,15395,13844,29239
11915,28,State - ANDHRA PRADESH,Urban,70-74,Literate with No Education,10465,9542,20007
11916,28,State - ANDHRA PRADESH,Urban,75-79,Literate with No Education,5301,5161,10462
11917,28,State - ANDHRA PRADESH,Urban,80+,Literate with No Education,6984,7771,14755
11918,28,State - ANDHRA PRADESH,Urban,Age not stated,Literate with No Education,37417,28800,66217
11919,29,State - KARNATAKA,Total,All ages,Literate with No Education,1354868,1163824,2518692
11920,29,State - KARNATAKA,Total,0-6,Literate with No Education,0,0,0
11921,29,State - KARNATAKA,Total,7,Literate with No Education,10637,8529,19166
11922,29,State - KARNATAKA,Total,8,Literate with No Education,8360,6612,14972
11923,29,State - KARNATAKA,Total,9,Literate with No Education,7816,6398,14214
11924,29,State - KARNATAKA,Total,10,Literate with No Education,9870,7962,17832
11925,29,State - KARNATAKA,Total,11,Literate with No Education,8585,7234,15819
11926,29,State - KARNATAKA,Total,12,Literate with No Education,9584,8335,17919
11927,29,State - KARNATAKA,Total,13,Literate with No Education,9532,8494,18026
11928,29,State - KARNATAKA,Total,14,Literate with No Education,11463,9773,21236
11929,29,State - KARNATAKA,Total,15,Literate with No Education,14054,12002,26056
11930,29,State - KARNATAKA,Total,16,Literate with No Education,17398,14815,32213
11931,29,State - KARNATAKA,Total,17,Literate with No Education,18915,16560,35475
11932,29,State - KARNATAKA,Total,18,Literate with No Education,31399,28117,59516
11933,29,State - KARNATAKA,Total,19,Literate with No Education,27092,26287,53379
11934,29,State - KARNATAKA,Total,20-24,Literate with No Education,175706,160780,336486
11935,29,State - KARNATAKA,Total,25-29,Literate with No Education,185931,172758,358689
11936,29,State - KARNATAKA,Total,30-34,Literate with No Education,148402,131871,280273
11937,29,State - KARNATAKA,Total,35-39,Literate with No Education,140722,127760,268482
11938,29,State - KARNATAKA,Total,40-44,Literate with No Education,117319,93632,210951
11939,29,State - KARNATAKA,Total,45-49,Literate with No Education,104754,83666,188420
11940,29,State - KARNATAKA,Total,50-54,Literate with No Education,79367,61195,140562
11941,29,State - KARNATAKA,Total,55-59,Literate with No Education,60773,48462,109235
11942,29,State - KARNATAKA,Total,60-64,Literate with No Education,54230,43080,97310
11943,29,State - KARNATAKA,Total,65-69,Literate with No Education,39753,30931,70684
11944,29,State - KARNATAKA,Total,70-74,Literate with No Education,27343,20618,47961
11945,29,State - KARNATAKA,Total,75-79,Literate with No Education,14097,10861,24958
11946,29,State - KARNATAKA,Total,80+,Literate with No Education,14654,13454,28108
11947,29,State - KARNATAKA,Total,Age not stated,Literate with No Education,7112,3638,10750
11948,29,State - KARNATAKA,Rural,All ages,Literate with No Education,880268,713756,1594024
11949,29,State - KARNATAKA,Rural,0-6,Literate with No Education,0,0,0
11950,29,State - KARNATAKA,Rural,7,Literate with No Education,6402,5242,11644
11951,29,State - KARNATAKA,Rural,8,Literate with No Education,5173,4200,9373
11952,29,State - KARNATAKA,Rural,9,Literate with No Education,4836,4135,8971
11953,29,State - KARNATAKA,Rural,10,Literate with No Education,6026,5033,11059
11954,29,State - KARNATAKA,Rural,11,Literate with No Education,5323,4705,10028
11955,29,State - KARNATAKA,Rural,12,Literate with No Education,6248,5632,11880
11956,29,State - KARNATAKA,Rural,13,Literate with No Education,6329,5778,12107
11957,29,State - KARNATAKA,Rural,14,Literate with No Education,7958,6946,14904
11958,29,State - KARNATAKA,Rural,15,Literate with No Education,10002,8661,18663
11959,29,State - KARNATAKA,Rural,16,Literate with No Education,12495,10658,23153
11960,29,State - KARNATAKA,Rural,17,Literate with No Education,13323,11592,24915
11961,29,State - KARNATAKA,Rural,18,Literate with No Education,22407,19564,41971
11962,29,State - KARNATAKA,Rural,19,Literate with No Education,18275,17690,35965
11963,29,State - KARNATAKA,Rural,20-24,Literate with No Education,117202,102810,220012
11964,29,State - KARNATAKA,Rural,25-29,Literate with No Education,118886,104116,223002
11965,29,State - KARNATAKA,Rural,30-34,Literate with No Education,92630,78450,171080
11966,29,State - KARNATAKA,Rural,35-39,Literate with No Education,88980,77177,166157
11967,29,State - KARNATAKA,Rural,40-44,Literate with No Education,75343,55814,131157
11968,29,State - KARNATAKA,Rural,45-49,Literate with No Education,67926,49155,117081
11969,29,State - KARNATAKA,Rural,50-54,Literate with No Education,50947,35356,86303
11970,29,State - KARNATAKA,Rural,55-59,Literate with No Education,38397,27795,66192
11971,29,State - KARNATAKA,Rural,60-64,Literate with No Education,35964,25830,61794
11972,29,State - KARNATAKA,Rural,65-69,Literate with No Education,27457,19033,46490
11973,29,State - KARNATAKA,Rural,70-74,Literate with No Education,18876,12469,31345
11974,29,State - KARNATAKA,Rural,75-79,Literate with No Education,9593,6257,15850
11975,29,State - KARNATAKA,Rural,80+,Literate with No Education,9789,7730,17519
11976,29,State - KARNATAKA,Rural,Age not stated,Literate with No Education,3481,1928,5409
11977,29,State - KARNATAKA,Urban,All ages,Literate with No Education,474600,450068,924668
11978,29,State - KARNATAKA,Urban,0-6,Literate with No Education,0,0,0
11979,29,State - KARNATAKA,Urban,7,Literate with No Education,4235,3287,7522
11980,29,State - KARNATAKA,Urban,8,Literate with No Education,3187,2412,5599
11981,29,State - KARNATAKA,Urban,9,Literate with No Education,2980,2263,5243
11982,29,State - KARNATAKA,Urban,10,Literate with No Education,3844,2929,6773
11983,29,State - KARNATAKA,Urban,11,Literate with No Education,3262,2529,5791
11984,29,State - KARNATAKA,Urban,12,Literate with No Education,3336,2703,6039
11985,29,State - KARNATAKA,Urban,13,Literate with No Education,3203,2716,5919
11986,29,State - KARNATAKA,Urban,14,Literate with No Education,3505,2827,6332
11987,29,State - KARNATAKA,Urban,15,Literate with No Education,4052,3341,7393
11988,29,State - KARNATAKA,Urban,16,Literate with No Education,4903,4157,9060
11989,29,State - KARNATAKA,Urban,17,Literate with No Education,5592,4968,10560
11990,29,State - KARNATAKA,Urban,18,Literate with No Education,8992,8553,17545
11991,29,State - KARNATAKA,Urban,19,Literate with No Education,8817,8597,17414
11992,29,State - KARNATAKA,Urban,20-24,Literate with No Education,58504,57970,116474
11993,29,State - KARNATAKA,Urban,25-29,Literate with No Education,67045,68642,135687
11994,29,State - KARNATAKA,Urban,30-34,Literate with No Education,55772,53421,109193
11995,29,State - KARNATAKA,Urban,35-39,Literate with No Education,51742,50583,102325
11996,29,State - KARNATAKA,Urban,40-44,Literate with No Education,41976,37818,79794
11997,29,State - KARNATAKA,Urban,45-49,Literate with No Education,36828,34511,71339
11998,29,State - KARNATAKA,Urban,50-54,Literate with No Education,28420,25839,54259
11999,29,State - KARNATAKA,Urban,55-59,Literate with No Education,22376,20667,43043
12000,29,State - KARNATAKA,Urban,60-64,Literate with No Education,18266,17250,35516
12001,29,State - KARNATAKA,Urban,65-69,Literate with No Education,12296,11898,24194
12002,29,State - KARNATAKA,Urban,70-74,Literate with No Education,8467,8149,16616
12003,29,State - KARNATAKA,Urban,75-79,Literate with No Education,4504,4604,9108
12004,29,State - KARNATAKA,Urban,80+,Literate with No Education,4865,5724,10589
12005,29,State - KARNATAKA,Urban,Age not stated,Literate with No Education,3631,1710,5341
12006,30,State - GOA,Total,All ages,Literate with No Education,45518,54305,99823
12007,30,State - GOA,Total,0-6,Literate with No Education,0,0,0
12008,30,State - GOA,Total,7,Literate with No Education,369,320,689
12009,30,State - GOA,Total,8,Literate with No Education,260,198,458
12010,30,State - GOA,Total,9,Literate with No Education,213,181,394
12011,30,State - GOA,Total,10,Literate with No Education,267,220,487
12012,30,State - GOA,Total,11,Literate with No Education,269,230,499
12013,30,State - GOA,Total,12,Literate with No Education,218,186,404
12014,30,State - GOA,Total,13,Literate with No Education,246,203,449
12015,30,State - GOA,Total,14,Literate with No Education,232,215,447
12016,30,State - GOA,Total,15,Literate with No Education,260,207,467
12017,30,State - GOA,Total,16,Literate with No Education,253,228,481
12018,30,State - GOA,Total,17,Literate with No Education,297,277,574
12019,30,State - GOA,Total,18,Literate with No Education,551,396,947
12020,30,State - GOA,Total,19,Literate with No Education,604,472,1076
12021,30,State - GOA,Total,20-24,Literate with No Education,4138,3770,7908
12022,30,State - GOA,Total,25-29,Literate with No Education,5726,5967,11693
12023,30,State - GOA,Total,30-34,Literate with No Education,5102,5826,10928
12024,30,State - GOA,Total,35-39,Literate with No Education,5230,6242,11472
12025,30,State - GOA,Total,40-44,Literate with No Education,4506,5359,9865
12026,30,State - GOA,Total,45-49,Literate with No Education,3815,4814,8629
12027,30,State - GOA,Total,50-54,Literate with No Education,3106,3999,7105
12028,30,State - GOA,Total,55-59,Literate with No Education,2616,3709,6325
12029,30,State - GOA,Total,60-64,Literate with No Education,2482,3814,6296
12030,30,State - GOA,Total,65-69,Literate with No Education,1872,2755,4627
12031,30,State - GOA,Total,70-74,Literate with No Education,1301,2051,3352
12032,30,State - GOA,Total,75-79,Literate with No Education,694,1201,1895
12033,30,State - GOA,Total,80+,Literate with No Education,566,1224,1790
12034,30,State - GOA,Total,Age not stated,Literate with No Education,325,241,566
12035,30,State - GOA,Rural,All ages,Literate with No Education,18560,22989,41549
12036,30,State - GOA,Rural,0-6,Literate with No Education,0,0,0
12037,30,State - GOA,Rural,7,Literate with No Education,149,125,274
12038,30,State - GOA,Rural,8,Literate with No Education,82,74,156
12039,30,State - GOA,Rural,9,Literate with No Education,80,70,150
12040,30,State - GOA,Rural,10,Literate with No Education,101,91,192
12041,30,State - GOA,Rural,11,Literate with No Education,104,98,202
12042,30,State - GOA,Rural,12,Literate with No Education,81,77,158
12043,30,State - GOA,Rural,13,Literate with No Education,91,80,171
12044,30,State - GOA,Rural,14,Literate with No Education,83,85,168
12045,30,State - GOA,Rural,15,Literate with No Education,94,87,181
12046,30,State - GOA,Rural,16,Literate with No Education,111,98,209
12047,30,State - GOA,Rural,17,Literate with No Education,126,127,253
12048,30,State - GOA,Rural,18,Literate with No Education,198,168,366
12049,30,State - GOA,Rural,19,Literate with No Education,226,190,416
12050,30,State - GOA,Rural,20-24,Literate with No Education,1542,1489,3031
12051,30,State - GOA,Rural,25-29,Literate with No Education,2236,2420,4656
12052,30,State - GOA,Rural,30-34,Literate with No Education,2044,2449,4493
12053,30,State - GOA,Rural,35-39,Literate with No Education,2208,2587,4795
12054,30,State - GOA,Rural,40-44,Literate with No Education,1859,2181,4040
12055,30,State - GOA,Rural,45-49,Literate with No Education,1580,2011,3591
12056,30,State - GOA,Rural,50-54,Literate with No Education,1260,1800,3060
12057,30,State - GOA,Rural,55-59,Literate with No Education,1132,1606,2738
12058,30,State - GOA,Rural,60-64,Literate with No Education,1092,1700,2792
12059,30,State - GOA,Rural,65-69,Literate with No Education,853,1266,2119
12060,30,State - GOA,Rural,70-74,Literate with No Education,538,949,1487
12061,30,State - GOA,Rural,75-79,Literate with No Education,298,503,801
12062,30,State - GOA,Rural,80+,Literate with No Education,257,550,807
12063,30,State - GOA,Rural,Age not stated,Literate with No Education,135,108,243
12064,30,State - GOA,Urban,All ages,Literate with No Education,26958,31316,58274
12065,30,State - GOA,Urban,0-6,Literate with No Education,0,0,0
12066,30,State - GOA,Urban,7,Literate with No Education,220,195,415
12067,30,State - GOA,Urban,8,Literate with No Education,178,124,302
12068,30,State - GOA,Urban,9,Literate with No Education,133,111,244
12069,30,State - GOA,Urban,10,Literate with No Education,166,129,295
12070,30,State - GOA,Urban,11,Literate with No Education,165,132,297
12071,30,State - GOA,Urban,12,Literate with No Education,137,109,246
12072,30,State - GOA,Urban,13,Literate with No Education,155,123,278
12073,30,State - GOA,Urban,14,Literate with No Education,149,130,279
12074,30,State - GOA,Urban,15,Literate with No Education,166,120,286
12075,30,State - GOA,Urban,16,Literate with No Education,142,130,272
12076,30,State - GOA,Urban,17,Literate with No Education,171,150,321
12077,30,State - GOA,Urban,18,Literate with No Education,353,228,581
12078,30,State - GOA,Urban,19,Literate with No Education,378,282,660
12079,30,State - GOA,Urban,20-24,Literate with No Education,2596,2281,4877
12080,30,State - GOA,Urban,25-29,Literate with No Education,3490,3547,7037
12081,30,State - GOA,Urban,30-34,Literate with No Education,3058,3377,6435
12082,30,State - GOA,Urban,35-39,Literate with No Education,3022,3655,6677
12083,30,State - GOA,Urban,40-44,Literate with No Education,2647,3178,5825
12084,30,State - GOA,Urban,45-49,Literate with No Education,2235,2803,5038
12085,30,State - GOA,Urban,50-54,Literate with No Education,1846,2199,4045
12086,30,State - GOA,Urban,55-59,Literate with No Education,1484,2103,3587
12087,30,State - GOA,Urban,60-64,Literate with No Education,1390,2114,3504
12088,30,State - GOA,Urban,65-69,Literate with No Education,1019,1489,2508
12089,30,State - GOA,Urban,70-74,Literate with No Education,763,1102,1865
12090,30,State - GOA,Urban,75-79,Literate with No Education,396,698,1094
12091,30,State - GOA,Urban,80+,Literate with No Education,309,674,983
12092,30,State - GOA,Urban,Age not stated,Literate with No Education,190,133,323
12093,31,State - LAKSHADWEEP,Total,All ages,Literate with No Education,1250,1479,2729
12094,31,State - LAKSHADWEEP,Total,0-6,Literate with No Education,0,0,0
12095,31,State - LAKSHADWEEP,Total,7,Literate with No Education,6,1,7
12096,31,State - LAKSHADWEEP,Total,8,Literate with No Education,2,2,4
12097,31,State - LAKSHADWEEP,Total,9,Literate with No Education,4,2,6
12098,31,State - LAKSHADWEEP,Total,10,Literate with No Education,2,6,8
12099,31,State - LAKSHADWEEP,Total,11,Literate with No Education,4,6,10
12100,31,State - LAKSHADWEEP,Total,12,Literate with No Education,0,5,5
12101,31,State - LAKSHADWEEP,Total,13,Literate with No Education,2,8,10
12102,31,State - LAKSHADWEEP,Total,14,Literate with No Education,1,3,4
12103,31,State - LAKSHADWEEP,Total,15,Literate with No Education,3,3,6
12104,31,State - LAKSHADWEEP,Total,16,Literate with No Education,4,3,7
12105,31,State - LAKSHADWEEP,Total,17,Literate with No Education,4,2,6
12106,31,State - LAKSHADWEEP,Total,18,Literate with No Education,6,13,19
12107,31,State - LAKSHADWEEP,Total,19,Literate with No Education,24,15,39
12108,31,State - LAKSHADWEEP,Total,20-24,Literate with No Education,95,117,212
12109,31,State - LAKSHADWEEP,Total,25-29,Literate with No Education,170,162,332
12110,31,State - LAKSHADWEEP,Total,30-34,Literate with No Education,115,144,259
12111,31,State - LAKSHADWEEP,Total,35-39,Literate with No Education,110,141,251
12112,31,State - LAKSHADWEEP,Total,40-44,Literate with No Education,123,124,247
12113,31,State - LAKSHADWEEP,Total,45-49,Literate with No Education,100,112,212
12114,31,State - LAKSHADWEEP,Total,50-54,Literate with No Education,78,92,170
12115,31,State - LAKSHADWEEP,Total,55-59,Literate with No Education,64,97,161
12116,31,State - LAKSHADWEEP,Total,60-64,Literate with No Education,75,124,199
12117,31,State - LAKSHADWEEP,Total,65-69,Literate with No Education,89,107,196
12118,31,State - LAKSHADWEEP,Total,70-74,Literate with No Education,69,75,144
12119,31,State - LAKSHADWEEP,Total,75-79,Literate with No Education,47,59,106
12120,31,State - LAKSHADWEEP,Total,80+,Literate with No Education,37,48,85
12121,31,State - LAKSHADWEEP,Total,Age not stated,Literate with No Education,16,8,24
12122,31,State - LAKSHADWEEP,Rural,All ages,Literate with No Education,385,397,782
12123,31,State - LAKSHADWEEP,Rural,0-6,Literate with No Education,0,0,0
12124,31,State - LAKSHADWEEP,Rural,7,Literate with No Education,1,0,1
12125,31,State - LAKSHADWEEP,Rural,8,Literate with No Education,1,1,2
12126,31,State - LAKSHADWEEP,Rural,9,Literate with No Education,2,2,4
12127,31,State - LAKSHADWEEP,Rural,10,Literate with No Education,0,3,3
12128,31,State - LAKSHADWEEP,Rural,11,Literate with No Education,2,2,4
12129,31,State - LAKSHADWEEP,Rural,12,Literate with No Education,0,2,2
12130,31,State - LAKSHADWEEP,Rural,13,Literate with No Education,0,2,2
12131,31,State - LAKSHADWEEP,Rural,14,Literate with No Education,0,1,1
12132,31,State - LAKSHADWEEP,Rural,15,Literate with No Education,0,1,1
12133,31,State - LAKSHADWEEP,Rural,16,Literate with No Education,0,2,2
12134,31,State - LAKSHADWEEP,Rural,17,Literate with No Education,3,0,3
12135,31,State - LAKSHADWEEP,Rural,18,Literate with No Education,1,6,7
12136,31,State - LAKSHADWEEP,Rural,19,Literate with No Education,9,9,18
12137,31,State - LAKSHADWEEP,Rural,20-24,Literate with No Education,47,54,101
12138,31,State - LAKSHADWEEP,Rural,25-29,Literate with No Education,81,74,155
12139,31,State - LAKSHADWEEP,Rural,30-34,Literate with No Education,53,47,100
12140,31,State - LAKSHADWEEP,Rural,35-39,Literate with No Education,36,51,87
12141,31,State - LAKSHADWEEP,Rural,40-44,Literate with No Education,41,40,81
12142,31,State - LAKSHADWEEP,Rural,45-49,Literate with No Education,29,39,68
12143,31,State - LAKSHADWEEP,Rural,50-54,Literate with No Education,23,29,52
12144,31,State - LAKSHADWEEP,Rural,55-59,Literate with No Education,12,14,26
12145,31,State - LAKSHADWEEP,Rural,60-64,Literate with No Education,13,9,22
12146,31,State - LAKSHADWEEP,Rural,65-69,Literate with No Education,12,4,16
12147,31,State - LAKSHADWEEP,Rural,70-74,Literate with No Education,3,1,4
12148,31,State - LAKSHADWEEP,Rural,75-79,Literate with No Education,3,2,5
12149,31,State - LAKSHADWEEP,Rural,80+,Literate with No Education,6,1,7
12150,31,State - LAKSHADWEEP,Rural,Age not stated,Literate with No Education,7,1,8
12151,31,State - LAKSHADWEEP,Urban,All ages,Literate with No Education,865,1082,1947
12152,31,State - LAKSHADWEEP,Urban,0-6,Literate with No Education,0,0,0
12153,31,State - LAKSHADWEEP,Urban,7,Literate with No Education,5,1,6
12154,31,State - LAKSHADWEEP,Urban,8,Literate with No Education,1,1,2
12155,31,State - LAKSHADWEEP,Urban,9,Literate with No Education,2,0,2
12156,31,State - LAKSHADWEEP,Urban,10,Literate with No Education,2,3,5
12157,31,State - LAKSHADWEEP,Urban,11,Literate with No Education,2,4,6
12158,31,State - LAKSHADWEEP,Urban,12,Literate with No Education,0,3,3
12159,31,State - LAKSHADWEEP,Urban,13,Literate with No Education,2,6,8
12160,31,State - LAKSHADWEEP,Urban,14,Literate with No Education,1,2,3
12161,31,State - LAKSHADWEEP,Urban,15,Literate with No Education,3,2,5
12162,31,State - LAKSHADWEEP,Urban,16,Literate with No Education,4,1,5
12163,31,State - LAKSHADWEEP,Urban,17,Literate with No Education,1,2,3
12164,31,State - LAKSHADWEEP,Urban,18,Literate with No Education,5,7,12
12165,31,State - LAKSHADWEEP,Urban,19,Literate with No Education,15,6,21
12166,31,State - LAKSHADWEEP,Urban,20-24,Literate with No Education,48,63,111
12167,31,State - LAKSHADWEEP,Urban,25-29,Literate with No Education,89,88,177
12168,31,State - LAKSHADWEEP,Urban,30-34,Literate with No Education,62,97,159
12169,31,State - LAKSHADWEEP,Urban,35-39,Literate with No Education,74,90,164
12170,31,State - LAKSHADWEEP,Urban,40-44,Literate with No Education,82,84,166
12171,31,State - LAKSHADWEEP,Urban,45-49,Literate with No Education,71,73,144
12172,31,State - LAKSHADWEEP,Urban,50-54,Literate with No Education,55,63,118
12173,31,State - LAKSHADWEEP,Urban,55-59,Literate with No Education,52,83,135
12174,31,State - LAKSHADWEEP,Urban,60-64,Literate with No Education,62,115,177
12175,31,State - LAKSHADWEEP,Urban,65-69,Literate with No Education,77,103,180
12176,31,State - LAKSHADWEEP,Urban,70-74,Literate with No Education,66,74,140
12177,31,State - LAKSHADWEEP,Urban,75-79,Literate with No Education,44,57,101
12178,31,State - LAKSHADWEEP,Urban,80+,Literate with No Education,31,47,78
12179,31,State - LAKSHADWEEP,Urban,Age not stated,Literate with No Education,9,7,16
12180,32,State - KERALA,Total,All ages,Literate with No Education,601366,712170,1313536
12181,32,State - KERALA,Total,0-6,Literate with No Education,0,0,0
12182,32,State - KERALA,Total,7,Literate with No Education,3633,3152,6785
12183,32,State - KERALA,Total,8,Literate with No Education,2839,2522,5361
12184,32,State - KERALA,Total,9,Literate with No Education,2720,2496,5216
12185,32,State - KERALA,Total,10,Literate with No Education,2975,2842,5817
12186,32,State - KERALA,Total,11,Literate with No Education,2767,2673,5440
12187,32,State - KERALA,Total,12,Literate with No Education,2733,2441,5174
12188,32,State - KERALA,Total,13,Literate with No Education,2853,2582,5435
12189,32,State - KERALA,Total,14,Literate with No Education,2831,2529,5360
12190,32,State - KERALA,Total,15,Literate with No Education,2795,2501,5296
12191,32,State - KERALA,Total,16,Literate with No Education,3061,2507,5568
12192,32,State - KERALA,Total,17,Literate with No Education,4099,3608,7707
12193,32,State - KERALA,Total,18,Literate with No Education,6333,5625,11958
12194,32,State - KERALA,Total,19,Literate with No Education,7620,6753,14373
12195,32,State - KERALA,Total,20-24,Literate with No Education,52335,55057,107392
12196,32,State - KERALA,Total,25-29,Literate with No Education,59965,71978,131943
12197,32,State - KERALA,Total,30-34,Literate with No Education,58115,72771,130886
12198,32,State - KERALA,Total,35-39,Literate with No Education,61061,80829,141890
12199,32,State - KERALA,Total,40-44,Literate with No Education,59612,76239,135851
12200,32,State - KERALA,Total,45-49,Literate with No Education,58547,73182,131729
12201,32,State - KERALA,Total,50-54,Literate with No Education,49363,59061,108424
12202,32,State - KERALA,Total,55-59,Literate with No Education,46360,52493,98853
12203,32,State - KERALA,Total,60-64,Literate with No Education,37218,41835,79053
12204,32,State - KERALA,Total,65-69,Literate with No Education,24917,29123,54040
12205,32,State - KERALA,Total,70-74,Literate with No Education,17981,21435,39416
12206,32,State - KERALA,Total,75-79,Literate with No Education,11893,15479,27372
12207,32,State - KERALA,Total,80+,Literate with No Education,11996,17079,29075
12208,32,State - KERALA,Total,Age not stated,Literate with No Education,4744,3378,8122
12209,32,State - KERALA,Rural,All ages,Literate with No Education,311567,365135,676702
12210,32,State - KERALA,Rural,0-6,Literate with No Education,0,0,0
12211,32,State - KERALA,Rural,7,Literate with No Education,1856,1621,3477
12212,32,State - KERALA,Rural,8,Literate with No Education,1459,1289,2748
12213,32,State - KERALA,Rural,9,Literate with No Education,1405,1303,2708
12214,32,State - KERALA,Rural,10,Literate with No Education,1525,1487,3012
12215,32,State - KERALA,Rural,11,Literate with No Education,1423,1419,2842
12216,32,State - KERALA,Rural,12,Literate with No Education,1473,1262,2735
12217,32,State - KERALA,Rural,13,Literate with No Education,1499,1361,2860
12218,32,State - KERALA,Rural,14,Literate with No Education,1440,1343,2783
12219,32,State - KERALA,Rural,15,Literate with No Education,1475,1279,2754
12220,32,State - KERALA,Rural,16,Literate with No Education,1569,1366,2935
12221,32,State - KERALA,Rural,17,Literate with No Education,2209,1937,4146
12222,32,State - KERALA,Rural,18,Literate with No Education,3439,3058,6497
12223,32,State - KERALA,Rural,19,Literate with No Education,4066,3572,7638
12224,32,State - KERALA,Rural,20-24,Literate with No Education,27365,28500,55865
12225,32,State - KERALA,Rural,25-29,Literate with No Education,31399,37134,68533
12226,32,State - KERALA,Rural,30-34,Literate with No Education,30041,37323,67364
12227,32,State - KERALA,Rural,35-39,Literate with No Education,31706,41521,73227
12228,32,State - KERALA,Rural,40-44,Literate with No Education,30412,38722,69134
12229,32,State - KERALA,Rural,45-49,Literate with No Education,30281,37569,67850
12230,32,State - KERALA,Rural,50-54,Literate with No Education,25215,30208,55423
12231,32,State - KERALA,Rural,55-59,Literate with No Education,23843,26600,50443
12232,32,State - KERALA,Rural,60-64,Literate with No Education,18905,20768,39673
12233,32,State - KERALA,Rural,65-69,Literate with No Education,12923,14918,27841
12234,32,State - KERALA,Rural,70-74,Literate with No Education,9235,10828,20063
12235,32,State - KERALA,Rural,75-79,Literate with No Education,6305,8009,14314
12236,32,State - KERALA,Rural,80+,Literate with No Education,6697,8953,15650
12237,32,State - KERALA,Rural,Age not stated,Literate with No Education,2402,1785,4187
12238,32,State - KERALA,Urban,All ages,Literate with No Education,289799,347035,636834
12239,32,State - KERALA,Urban,0-6,Literate with No Education,0,0,0
12240,32,State - KERALA,Urban,7,Literate with No Education,1777,1531,3308
12241,32,State - KERALA,Urban,8,Literate with No Education,1380,1233,2613
12242,32,State - KERALA,Urban,9,Literate with No Education,1315,1193,2508
12243,32,State - KERALA,Urban,10,Literate with No Education,1450,1355,2805
12244,32,State - KERALA,Urban,11,Literate with No Education,1344,1254,2598
12245,32,State - KERALA,Urban,12,Literate with No Education,1260,1179,2439
12246,32,State - KERALA,Urban,13,Literate with No Education,1354,1221,2575
12247,32,State - KERALA,Urban,14,Literate with No Education,1391,1186,2577
12248,32,State - KERALA,Urban,15,Literate with No Education,1320,1222,2542
12249,32,State - KERALA,Urban,16,Literate with No Education,1492,1141,2633
12250,32,State - KERALA,Urban,17,Literate with No Education,1890,1671,3561
12251,32,State - KERALA,Urban,18,Literate with No Education,2894,2567,5461
12252,32,State - KERALA,Urban,19,Literate with No Education,3554,3181,6735
12253,32,State - KERALA,Urban,20-24,Literate with No Education,24970,26557,51527
12254,32,State - KERALA,Urban,25-29,Literate with No Education,28566,34844,63410
12255,32,State - KERALA,Urban,30-34,Literate with No Education,28074,35448,63522
12256,32,State - KERALA,Urban,35-39,Literate with No Education,29355,39308,68663
12257,32,State - KERALA,Urban,40-44,Literate with No Education,29200,37517,66717
12258,32,State - KERALA,Urban,45-49,Literate with No Education,28266,35613,63879
12259,32,State - KERALA,Urban,50-54,Literate with No Education,24148,28853,53001
12260,32,State - KERALA,Urban,55-59,Literate with No Education,22517,25893,48410
12261,32,State - KERALA,Urban,60-64,Literate with No Education,18313,21067,39380
12262,32,State - KERALA,Urban,65-69,Literate with No Education,11994,14205,26199
12263,32,State - KERALA,Urban,70-74,Literate with No Education,8746,10607,19353
12264,32,State - KERALA,Urban,75-79,Literate with No Education,5588,7470,13058
12265,32,State - KERALA,Urban,80+,Literate with No Education,5299,8126,13425
12266,32,State - KERALA,Urban,Age not stated,Literate with No Education,2342,1593,3935
12267,33,State - TAMIL NADU,Total,All ages,Literate with No Education,1188833,1111650,2300483
12268,33,State - TAMIL NADU,Total,0-6,Literate with No Education,0,0,0
12269,33,State - TAMIL NADU,Total,7,Literate with No Education,7548,5994,13542
12270,33,State - TAMIL NADU,Total,8,Literate with No Education,5972,4953,10925
12271,33,State - TAMIL NADU,Total,9,Literate with No Education,6000,5149,11149
12272,33,State - TAMIL NADU,Total,10,Literate with No Education,7316,6057,13373
12273,33,State - TAMIL NADU,Total,11,Literate with No Education,6415,5516,11931
12274,33,State - TAMIL NADU,Total,12,Literate with No Education,6481,5484,11965
12275,33,State - TAMIL NADU,Total,13,Literate with No Education,6732,5721,12453
12276,33,State - TAMIL NADU,Total,14,Literate with No Education,7933,6527,14460
12277,33,State - TAMIL NADU,Total,15,Literate with No Education,10097,8284,18381
12278,33,State - TAMIL NADU,Total,16,Literate with No Education,11520,9404,20924
12279,33,State - TAMIL NADU,Total,17,Literate with No Education,15278,12653,27931
12280,33,State - TAMIL NADU,Total,18,Literate with No Education,20830,18565,39395
12281,33,State - TAMIL NADU,Total,19,Literate with No Education,21495,20040,41535
12282,33,State - TAMIL NADU,Total,20-24,Literate with No Education,130770,134496,265266
12283,33,State - TAMIL NADU,Total,25-29,Literate with No Education,154132,158995,313127
12284,33,State - TAMIL NADU,Total,30-34,Literate with No Education,132110,130252,262362
12285,33,State - TAMIL NADU,Total,35-39,Literate with No Education,123453,125419,248872
12286,33,State - TAMIL NADU,Total,40-44,Literate with No Education,108838,99713,208551
12287,33,State - TAMIL NADU,Total,45-49,Literate with No Education,100175,88901,189076
12288,33,State - TAMIL NADU,Total,50-54,Literate with No Education,78460,67030,145490
12289,33,State - TAMIL NADU,Total,55-59,Literate with No Education,64261,55724,119985
12290,33,State - TAMIL NADU,Total,60-64,Literate with No Education,56563,46980,103543
12291,33,State - TAMIL NADU,Total,65-69,Literate with No Education,36999,31783,68782
12292,33,State - TAMIL NADU,Total,70-74,Literate with No Education,28544,23264,51808
12293,33,State - TAMIL NADU,Total,75-79,Literate with No Education,15196,12745,27941
12294,33,State - TAMIL NADU,Total,80+,Literate with No Education,15395,14780,30175
12295,33,State - TAMIL NADU,Total,Age not stated,Literate with No Education,10320,7221,17541
12296,33,State - TAMIL NADU,Rural,All ages,Literate with No Education,581196,498041,1079237
12297,33,State - TAMIL NADU,Rural,0-6,Literate with No Education,0,0,0
12298,33,State - TAMIL NADU,Rural,7,Literate with No Education,3482,2817,6299
12299,33,State - TAMIL NADU,Rural,8,Literate with No Education,2826,2333,5159
12300,33,State - TAMIL NADU,Rural,9,Literate with No Education,2764,2415,5179
12301,33,State - TAMIL NADU,Rural,10,Literate with No Education,3395,2831,6226
12302,33,State - TAMIL NADU,Rural,11,Literate with No Education,3026,2574,5600
12303,33,State - TAMIL NADU,Rural,12,Literate with No Education,3204,2675,5879
12304,33,State - TAMIL NADU,Rural,13,Literate with No Education,3244,2799,6043
12305,33,State - TAMIL NADU,Rural,14,Literate with No Education,3953,3281,7234
12306,33,State - TAMIL NADU,Rural,15,Literate with No Education,5403,4487,9890
12307,33,State - TAMIL NADU,Rural,16,Literate with No Education,6339,5164,11503
12308,33,State - TAMIL NADU,Rural,17,Literate with No Education,8559,7049,15608
12309,33,State - TAMIL NADU,Rural,18,Literate with No Education,11761,10497,22258
12310,33,State - TAMIL NADU,Rural,19,Literate with No Education,11891,11163,23054
12311,33,State - TAMIL NADU,Rural,20-24,Literate with No Education,68730,68468,137198
12312,33,State - TAMIL NADU,Rural,25-29,Literate with No Education,77464,75273,152737
12313,33,State - TAMIL NADU,Rural,30-34,Literate with No Education,62740,58513,121253
12314,33,State - TAMIL NADU,Rural,35-39,Literate with No Education,58434,54817,113251
12315,33,State - TAMIL NADU,Rural,40-44,Literate with No Education,50805,41930,92735
12316,33,State - TAMIL NADU,Rural,45-49,Literate with No Education,47366,36948,84314
12317,33,State - TAMIL NADU,Rural,50-54,Literate with No Education,36438,26790,63228
12318,33,State - TAMIL NADU,Rural,55-59,Literate with No Education,29959,22228,52187
12319,33,State - TAMIL NADU,Rural,60-64,Literate with No Education,27478,18765,46243
12320,33,State - TAMIL NADU,Rural,65-69,Literate with No Education,18418,12562,30980
12321,33,State - TAMIL NADU,Rural,70-74,Literate with No Education,14182,8838,23020
12322,33,State - TAMIL NADU,Rural,75-79,Literate with No Education,7195,4322,11517
12323,33,State - TAMIL NADU,Rural,80+,Literate with No Education,7250,5025,12275
12324,33,State - TAMIL NADU,Rural,Age not stated,Literate with No Education,4890,3477,8367
12325,33,State - TAMIL NADU,Urban,All ages,Literate with No Education,607637,613609,1221246
12326,33,State - TAMIL NADU,Urban,0-6,Literate with No Education,0,0,0
12327,33,State - TAMIL NADU,Urban,7,Literate with No Education,4066,3177,7243
12328,33,State - TAMIL NADU,Urban,8,Literate with No Education,3146,2620,5766
12329,33,State - TAMIL NADU,Urban,9,Literate with No Education,3236,2734,5970
12330,33,State - TAMIL NADU,Urban,10,Literate with No Education,3921,3226,7147
12331,33,State - TAMIL NADU,Urban,11,Literate with No Education,3389,2942,6331
12332,33,State - TAMIL NADU,Urban,12,Literate with No Education,3277,2809,6086
12333,33,State - TAMIL NADU,Urban,13,Literate with No Education,3488,2922,6410
12334,33,State - TAMIL NADU,Urban,14,Literate with No Education,3980,3246,7226
12335,33,State - TAMIL NADU,Urban,15,Literate with No Education,4694,3797,8491
12336,33,State - TAMIL NADU,Urban,16,Literate with No Education,5181,4240,9421
12337,33,State - TAMIL NADU,Urban,17,Literate with No Education,6719,5604,12323
12338,33,State - TAMIL NADU,Urban,18,Literate with No Education,9069,8068,17137
12339,33,State - TAMIL NADU,Urban,19,Literate with No Education,9604,8877,18481
12340,33,State - TAMIL NADU,Urban,20-24,Literate with No Education,62040,66028,128068
12341,33,State - TAMIL NADU,Urban,25-29,Literate with No Education,76668,83722,160390
12342,33,State - TAMIL NADU,Urban,30-34,Literate with No Education,69370,71739,141109
12343,33,State - TAMIL NADU,Urban,35-39,Literate with No Education,65019,70602,135621
12344,33,State - TAMIL NADU,Urban,40-44,Literate with No Education,58033,57783,115816
12345,33,State - TAMIL NADU,Urban,45-49,Literate with No Education,52809,51953,104762
12346,33,State - TAMIL NADU,Urban,50-54,Literate with No Education,42022,40240,82262
12347,33,State - TAMIL NADU,Urban,55-59,Literate with No Education,34302,33496,67798
12348,33,State - TAMIL NADU,Urban,60-64,Literate with No Education,29085,28215,57300
12349,33,State - TAMIL NADU,Urban,65-69,Literate with No Education,18581,19221,37802
12350,33,State - TAMIL NADU,Urban,70-74,Literate with No Education,14362,14426,28788
12351,33,State - TAMIL NADU,Urban,75-79,Literate with No Education,8001,8423,16424
12352,33,State - TAMIL NADU,Urban,80+,Literate with No Education,8145,9755,17900
12353,33,State - TAMIL NADU,Urban,Age not stated,Literate with No Education,5430,3744,9174
12354,34,State - PUDUCHERRY,Total,All ages,Literate with No Education,11510,12186,23696
12355,34,State - PUDUCHERRY,Total,0-6,Literate with No Education,0,0,0
12356,34,State - PUDUCHERRY,Total,7,Literate with No Education,65,64,129
12357,34,State - PUDUCHERRY,Total,8,Literate with No Education,61,46,107
12358,34,State - PUDUCHERRY,Total,9,Literate with No Education,43,40,83
12359,34,State - PUDUCHERRY,Total,10,Literate with No Education,64,52,116
12360,34,State - PUDUCHERRY,Total,11,Literate with No Education,45,48,93
12361,34,State - PUDUCHERRY,Total,12,Literate with No Education,51,47,98
12362,34,State - PUDUCHERRY,Total,13,Literate with No Education,45,50,95
12363,34,State - PUDUCHERRY,Total,14,Literate with No Education,49,46,95
12364,34,State - PUDUCHERRY,Total,15,Literate with No Education,68,51,119
12365,34,State - PUDUCHERRY,Total,16,Literate with No Education,81,58,139
12366,34,State - PUDUCHERRY,Total,17,Literate with No Education,124,101,225
12367,34,State - PUDUCHERRY,Total,18,Literate with No Education,173,146,319
12368,34,State - PUDUCHERRY,Total,19,Literate with No Education,186,181,367
12369,34,State - PUDUCHERRY,Total,20-24,Literate with No Education,1232,1327,2559
12370,34,State - PUDUCHERRY,Total,25-29,Literate with No Education,1584,1683,3267
12371,34,State - PUDUCHERRY,Total,30-34,Literate with No Education,1439,1578,3017
12372,34,State - PUDUCHERRY,Total,35-39,Literate with No Education,1341,1451,2792
12373,34,State - PUDUCHERRY,Total,40-44,Literate with No Education,1096,1119,2215
12374,34,State - PUDUCHERRY,Total,45-49,Literate with No Education,988,950,1938
12375,34,State - PUDUCHERRY,Total,50-54,Literate with No Education,721,777,1498
12376,34,State - PUDUCHERRY,Total,55-59,Literate with No Education,579,604,1183
12377,34,State - PUDUCHERRY,Total,60-64,Literate with No Education,482,563,1045
12378,34,State - PUDUCHERRY,Total,65-69,Literate with No Education,302,398,700
12379,34,State - PUDUCHERRY,Total,70-74,Literate with No Education,283,315,598
12380,34,State - PUDUCHERRY,Total,75-79,Literate with No Education,168,207,375
12381,34,State - PUDUCHERRY,Total,80+,Literate with No Education,144,219,363
12382,34,State - PUDUCHERRY,Total,Age not stated,Literate with No Education,96,65,161
12383,34,State - PUDUCHERRY,Rural,All ages,Literate with No Education,3669,3389,7058
12384,34,State - PUDUCHERRY,Rural,0-6,Literate with No Education,0,0,0
12385,34,State - PUDUCHERRY,Rural,7,Literate with No Education,25,28,53
12386,34,State - PUDUCHERRY,Rural,8,Literate with No Education,23,7,30
12387,34,State - PUDUCHERRY,Rural,9,Literate with No Education,18,11,29
12388,34,State - PUDUCHERRY,Rural,10,Literate with No Education,21,19,40
12389,34,State - PUDUCHERRY,Rural,11,Literate with No Education,11,10,21
12390,34,State - PUDUCHERRY,Rural,12,Literate with No Education,18,17,35
12391,34,State - PUDUCHERRY,Rural,13,Literate with No Education,15,15,30
12392,34,State - PUDUCHERRY,Rural,14,Literate with No Education,17,14,31
12393,34,State - PUDUCHERRY,Rural,15,Literate with No Education,20,21,41
12394,34,State - PUDUCHERRY,Rural,16,Literate with No Education,28,21,49
12395,34,State - PUDUCHERRY,Rural,17,Literate with No Education,37,41,78
12396,34,State - PUDUCHERRY,Rural,18,Literate with No Education,55,58,113
12397,34,State - PUDUCHERRY,Rural,19,Literate with No Education,60,67,127
12398,34,State - PUDUCHERRY,Rural,20-24,Literate with No Education,444,444,888
12399,34,State - PUDUCHERRY,Rural,25-29,Literate with No Education,523,567,1090
12400,34,State - PUDUCHERRY,Rural,30-34,Literate with No Education,465,446,911
12401,34,State - PUDUCHERRY,Rural,35-39,Literate with No Education,426,365,791
12402,34,State - PUDUCHERRY,Rural,40-44,Literate with No Education,336,251,587
12403,34,State - PUDUCHERRY,Rural,45-49,Literate with No Education,306,223,529
12404,34,State - PUDUCHERRY,Rural,50-54,Literate with No Education,201,186,387
12405,34,State - PUDUCHERRY,Rural,55-59,Literate with No Education,182,153,335
12406,34,State - PUDUCHERRY,Rural,60-64,Literate with No Education,126,129,255
12407,34,State - PUDUCHERRY,Rural,65-69,Literate with No Education,102,107,209
12408,34,State - PUDUCHERRY,Rural,70-74,Literate with No Education,84,66,150
12409,34,State - PUDUCHERRY,Rural,75-79,Literate with No Education,49,53,102
12410,34,State - PUDUCHERRY,Rural,80+,Literate with No Education,48,48,96
12411,34,State - PUDUCHERRY,Rural,Age not stated,Literate with No Education,29,22,51
12412,34,State - PUDUCHERRY,Urban,All ages,Literate with No Education,7841,8797,16638
12413,34,State - PUDUCHERRY,Urban,0-6,Literate with No Education,0,0,0
12414,34,State - PUDUCHERRY,Urban,7,Literate with No Education,40,36,76
12415,34,State - PUDUCHERRY,Urban,8,Literate with No Education,38,39,77
12416,34,State - PUDUCHERRY,Urban,9,Literate with No Education,25,29,54
12417,34,State - PUDUCHERRY,Urban,10,Literate with No Education,43,33,76
12418,34,State - PUDUCHERRY,Urban,11,Literate with No Education,34,38,72
12419,34,State - PUDUCHERRY,Urban,12,Literate with No Education,33,30,63
12420,34,State - PUDUCHERRY,Urban,13,Literate with No Education,30,35,65
12421,34,State - PUDUCHERRY,Urban,14,Literate with No Education,32,32,64
12422,34,State - PUDUCHERRY,Urban,15,Literate with No Education,48,30,78
12423,34,State - PUDUCHERRY,Urban,16,Literate with No Education,53,37,90
12424,34,State - PUDUCHERRY,Urban,17,Literate with No Education,87,60,147
12425,34,State - PUDUCHERRY,Urban,18,Literate with No Education,118,88,206
12426,34,State - PUDUCHERRY,Urban,19,Literate with No Education,126,114,240
12427,34,State - PUDUCHERRY,Urban,20-24,Literate with No Education,788,883,1671
12428,34,State - PUDUCHERRY,Urban,25-29,Literate with No Education,1061,1116,2177
12429,34,State - PUDUCHERRY,Urban,30-34,Literate with No Education,974,1132,2106
12430,34,State - PUDUCHERRY,Urban,35-39,Literate with No Education,915,1086,2001
12431,34,State - PUDUCHERRY,Urban,40-44,Literate with No Education,760,868,1628
12432,34,State - PUDUCHERRY,Urban,45-49,Literate with No Education,682,727,1409
12433,34,State - PUDUCHERRY,Urban,50-54,Literate with No Education,520,591,1111
12434,34,State - PUDUCHERRY,Urban,55-59,Literate with No Education,397,451,848
12435,34,State - PUDUCHERRY,Urban,60-64,Literate with No Education,356,434,790
12436,34,State - PUDUCHERRY,Urban,65-69,Literate with No Education,200,291,491
12437,34,State - PUDUCHERRY,Urban,70-74,Literate with No Education,199,249,448
12438,34,State - PUDUCHERRY,Urban,75-79,Literate with No Education,119,154,273
12439,34,State - PUDUCHERRY,Urban,80+,Literate with No Education,96,171,267
12440,34,State - PUDUCHERRY,Urban,Age not stated,Literate with No Education,67,43,110
12441,35,State - ANDAMAN & NICOBAR ISLANDS,Total,All ages,Literate with No Education,3041,2861,5902
12442,35,State - ANDAMAN & NICOBAR ISLANDS,Total,0-6,Literate with No Education,0,0,0
12443,35,State - ANDAMAN & NICOBAR ISLANDS,Total,7,Literate with No Education,26,21,47
12444,35,State - ANDAMAN & NICOBAR ISLANDS,Total,8,Literate with No Education,15,7,22
12445,35,State - ANDAMAN & NICOBAR ISLANDS,Total,9,Literate with No Education,13,9,22
12446,35,State - ANDAMAN & NICOBAR ISLANDS,Total,10,Literate with No Education,11,15,26
12447,35,State - ANDAMAN & NICOBAR ISLANDS,Total,11,Literate with No Education,23,9,32
12448,35,State - ANDAMAN & NICOBAR ISLANDS,Total,12,Literate with No Education,8,12,20
12449,35,State - ANDAMAN & NICOBAR ISLANDS,Total,13,Literate with No Education,14,11,25
12450,35,State - ANDAMAN & NICOBAR ISLANDS,Total,14,Literate with No Education,13,16,29
12451,35,State - ANDAMAN & NICOBAR ISLANDS,Total,15,Literate with No Education,15,12,27
12452,35,State - ANDAMAN & NICOBAR ISLANDS,Total,16,Literate with No Education,14,14,28
12453,35,State - ANDAMAN & NICOBAR ISLANDS,Total,17,Literate with No Education,18,17,35
12454,35,State - ANDAMAN & NICOBAR ISLANDS,Total,18,Literate with No Education,41,35,76
12455,35,State - ANDAMAN & NICOBAR ISLANDS,Total,19,Literate with No Education,39,32,71
12456,35,State - ANDAMAN & NICOBAR ISLANDS,Total,20-24,Literate with No Education,350,279,629
12457,35,State - ANDAMAN & NICOBAR ISLANDS,Total,25-29,Literate with No Education,439,349,788
12458,35,State - ANDAMAN & NICOBAR ISLANDS,Total,30-34,Literate with No Education,355,333,688
12459,35,State - ANDAMAN & NICOBAR ISLANDS,Total,35-39,Literate with No Education,304,362,666
12460,35,State - ANDAMAN & NICOBAR ISLANDS,Total,40-44,Literate with No Education,298,269,567
12461,35,State - ANDAMAN & NICOBAR ISLANDS,Total,45-49,Literate with No Education,269,298,567
12462,35,State - ANDAMAN & NICOBAR ISLANDS,Total,50-54,Literate with No Education,210,201,411
12463,35,State - ANDAMAN & NICOBAR ISLANDS,Total,55-59,Literate with No Education,157,157,314
12464,35,State - ANDAMAN & NICOBAR ISLANDS,Total,60-64,Literate with No Education,139,147,286
12465,35,State - ANDAMAN & NICOBAR ISLANDS,Total,65-69,Literate with No Education,98,101,199
12466,35,State - ANDAMAN & NICOBAR ISLANDS,Total,70-74,Literate with No Education,67,58,125
12467,35,State - ANDAMAN & NICOBAR ISLANDS,Total,75-79,Literate with No Education,38,32,70
12468,35,State - ANDAMAN & NICOBAR ISLANDS,Total,80+,Literate with No Education,40,42,82
12469,35,State - ANDAMAN & NICOBAR ISLANDS,Total,Age not stated,Literate with No Education,27,23,50
12470,35,State - ANDAMAN & NICOBAR ISLANDS,Rural,All ages,Literate with No Education,1887,1742,3629
12471,35,State - ANDAMAN & NICOBAR ISLANDS,Rural,0-6,Literate with No Education,0,0,0
12472,35,State - ANDAMAN & NICOBAR ISLANDS,Rural,7,Literate with No Education,14,14,28
12473,35,State - ANDAMAN & NICOBAR ISLANDS,Rural,8,Literate with No Education,5,6,11
12474,35,State - ANDAMAN & NICOBAR ISLANDS,Rural,9,Literate with No Education,11,4,15
12475,35,State - ANDAMAN & NICOBAR ISLANDS,Rural,10,Literate with No Education,7,10,17
12476,35,State - ANDAMAN & NICOBAR ISLANDS,Rural,11,Literate with No Education,14,4,18
12477,35,State - ANDAMAN & NICOBAR ISLANDS,Rural,12,Literate with No Education,4,9,13
12478,35,State - ANDAMAN & NICOBAR ISLANDS,Rural,13,Literate with No Education,11,5,16
12479,35,State - ANDAMAN & NICOBAR ISLANDS,Rural,14,Literate with No Education,9,12,21
12480,35,State - ANDAMAN & NICOBAR ISLANDS,Rural,15,Literate with No Education,10,8,18
12481,35,State - ANDAMAN & NICOBAR ISLANDS,Rural,16,Literate with No Education,10,8,18
12482,35,State - ANDAMAN & NICOBAR ISLANDS,Rural,17,Literate with No Education,9,9,18
12483,35,State - ANDAMAN & NICOBAR ISLANDS,Rural,18,Literate with No Education,26,20,46
12484,35,State - ANDAMAN & NICOBAR ISLANDS,Rural,19,Literate with No Education,27,20,47
12485,35,State - ANDAMAN & NICOBAR ISLANDS,Rural,20-24,Literate with No Education,208,169,377
12486,35,State - ANDAMAN & NICOBAR ISLANDS,Rural,25-29,Literate with No Education,256,212,468
12487,35,State - ANDAMAN & NICOBAR ISLANDS,Rural,30-34,Literate with No Education,213,190,403
12488,35,State - ANDAMAN & NICOBAR ISLANDS,Rural,35-39,Literate with No Education,182,205,387
12489,35,State - ANDAMAN & NICOBAR ISLANDS,Rural,40-44,Literate with No Education,165,178,343
12490,35,State - ANDAMAN & NICOBAR ISLANDS,Rural,45-49,Literate with No Education,189,158,347
12491,35,State - ANDAMAN & NICOBAR ISLANDS,Rural,50-54,Literate with No Education,127,122,249
12492,35,State - ANDAMAN & NICOBAR ISLANDS,Rural,55-59,Literate with No Education,100,102,202
12493,35,State - ANDAMAN & NICOBAR ISLANDS,Rural,60-64,Literate with No Education,89,99,188
12494,35,State - ANDAMAN & NICOBAR ISLANDS,Rural,65-69,Literate with No Education,74,69,143
12495,35,State - ANDAMAN & NICOBAR ISLANDS,Rural,70-74,Literate with No Education,47,41,88
12496,35,State - ANDAMAN & NICOBAR ISLANDS,Rural,75-79,Literate with No Education,27,22,49
12497,35,State - ANDAMAN & NICOBAR ISLANDS,Rural,80+,Literate with No Education,34,31,65
12498,35,State - ANDAMAN & NICOBAR ISLANDS,Rural,Age not stated,Literate with No Education,19,15,34
12499,35,State - ANDAMAN & NICOBAR ISLANDS,Urban,All ages,Literate with No Education,1154,1119,2273
12500,35,State - ANDAMAN & NICOBAR ISLANDS,Urban,0-6,Literate with No Education,0,0,0
12501,35,State - ANDAMAN & NICOBAR ISLANDS,Urban,7,Literate with No Education,12,7,19
12502,35,State - ANDAMAN & NICOBAR ISLANDS,Urban,8,Literate with No Education,10,1,11
12503,35,State - ANDAMAN & NICOBAR ISLANDS,Urban,9,Literate with No Education,2,5,7
12504,35,State - ANDAMAN & NICOBAR ISLANDS,Urban,10,Literate with No Education,4,5,9
12505,35,State - ANDAMAN & NICOBAR ISLANDS,Urban,11,Literate with No Education,9,5,14
12506,35,State - ANDAMAN & NICOBAR ISLANDS,Urban,12,Literate with No Education,4,3,7
12507,35,State - ANDAMAN & NICOBAR ISLANDS,Urban,13,Literate with No Education,3,6,9
12508,35,State - ANDAMAN & NICOBAR ISLANDS,Urban,14,Literate with No Education,4,4,8
12509,35,State - ANDAMAN & NICOBAR ISLANDS,Urban,15,Literate with No Education,5,4,9
12510,35,State - ANDAMAN & NICOBAR ISLANDS,Urban,16,Literate with No Education,4,6,10
12511,35,State - ANDAMAN & NICOBAR ISLANDS,Urban,17,Literate with No Education,9,8,17
12512,35,State - ANDAMAN & NICOBAR ISLANDS,Urban,18,Literate with No Education,15,15,30
12513,35,State - ANDAMAN & NICOBAR ISLANDS,Urban,19,Literate with No Education,12,12,24
12514,35,State - ANDAMAN & NICOBAR ISLANDS,Urban,20-24,Literate with No Education,142,110,252
12515,35,State - ANDAMAN & NICOBAR ISLANDS,Urban,25-29,Literate with No Education,183,137,320
12516,35,State - ANDAMAN & NICOBAR ISLANDS,Urban,30-34,Literate with No Education,142,143,285
12517,35,State - ANDAMAN & NICOBAR ISLANDS,Urban,35-39,Literate with No Education,122,157,279
12518,35,State - ANDAMAN & NICOBAR ISLANDS,Urban,40-44,Literate with No Education,133,91,224
12519,35,State - ANDAMAN & NICOBAR ISLANDS,Urban,45-49,Literate with No Education,80,140,220
12520,35,State - ANDAMAN & NICOBAR ISLANDS,Urban,50-54,Literate with No Education,83,79,162
12521,35,State - ANDAMAN & NICOBAR ISLANDS,Urban,55-59,Literate with No Education,57,55,112
12522,35,State - ANDAMAN & NICOBAR ISLANDS,Urban,60-64,Literate with No Education,50,48,98
12523,35,State - ANDAMAN & NICOBAR ISLANDS,Urban,65-69,Literate with No Education,24,32,56
12524,35,State - ANDAMAN & NICOBAR ISLANDS,Urban,70-74,Literate with No Education,20,17,37
12525,35,State - ANDAMAN & NICOBAR ISLANDS,Urban,75-79,Literate with No Education,11,10,21
12526,35,State - ANDAMAN & NICOBAR ISLANDS,Urban,80+,Literate with No Education,6,11,17
12527,35,State - ANDAMAN & NICOBAR ISLANDS,Urban,Age not stated,Literate with No Education,8,8,16
12528,0,INDIA,Total,All ages,Preprimary,78445099,68452498,146897597
12529,0,INDIA,Total,0-6,Preprimary,0,0,0
12530,0,INDIA,Total,7,Preprimary,9190737,8327019,17517756
12531,0,INDIA,Total,8,Preprimary,11793414,10595741,22389155
12532,0,INDIA,Total,9,Preprimary,9579169,8592321,18171490
12533,0,INDIA,Total,10,Preprimary,9528882,8233196,17762078
12534,0,INDIA,Total,11,Preprimary,4237528,3598689,7836217
12535,0,INDIA,Total,12,Preprimary,2596541,2196471,4793012
12536,0,INDIA,Total,13,Preprimary,1194584,1043199,2237783
12537,0,INDIA,Total,14,Preprimary,817001,722789,1539790
12538,0,INDIA,Total,15,Preprimary,722299,603308,1325607
12539,0,INDIA,Total,16,Preprimary,645759,544529,1190288
12540,0,INDIA,Total,17,Preprimary,512329,420112,932441
12541,0,INDIA,Total,18,Preprimary,742554,595424,1337978
12542,0,INDIA,Total,19,Preprimary,479153,441103,920256
12543,0,INDIA,Total,20-24,Preprimary,2791396,2618793,5410189
12544,0,INDIA,Total,25-29,Preprimary,2737935,2762619,5500554
12545,0,INDIA,Total,30-34,Preprimary,2612830,2687279,5300109
12546,0,INDIA,Total,35-39,Preprimary,2856229,2803272,5659501
12547,0,INDIA,Total,40-44,Preprimary,2833671,2450348,5284019
12548,0,INDIA,Total,45-49,Preprimary,2749378,2210382,4959760
12549,0,INDIA,Total,50-54,Preprimary,2284410,1724445,4008855
12550,0,INDIA,Total,55-59,Preprimary,1764346,1421752,3186098
12551,0,INDIA,Total,60-64,Preprimary,1782876,1284827,3067703
12552,0,INDIA,Total,65-69,Preprimary,1430887,950358,2381245
12553,0,INDIA,Total,70-74,Preprimary,1094774,631273,1726047
12554,0,INDIA,Total,75-79,Preprimary,582371,367672,950043
12555,0,INDIA,Total,80+,Preprimary,643700,417793,1061493
12556,0,INDIA,Total,Age not stated,Preprimary,240346,207784,448130
12557,0,INDIA,Rural,All ages,Preprimary,59106785,50537213,109643998
12558,0,INDIA,Rural,0-6,Preprimary,0,0,0
12559,0,INDIA,Rural,7,Preprimary,6528549,5929895,12458444
12560,0,INDIA,Rural,8,Preprimary,8697645,7841046,16538691
12561,0,INDIA,Rural,9,Preprimary,6962530,6302327,13264857
12562,0,INDIA,Rural,10,Preprimary,7200359,6295376,13495735
12563,0,INDIA,Rural,11,Preprimary,3248670,2809546,6058216
12564,0,INDIA,Rural,12,Preprimary,2068456,1786304,3854760
12565,0,INDIA,Rural,13,Preprimary,944703,842859,1787562
12566,0,INDIA,Rural,14,Preprimary,647300,586950,1234250
12567,0,INDIA,Rural,15,Preprimary,574114,490577,1064691
12568,0,INDIA,Rural,16,Preprimary,505127,433745,938872
12569,0,INDIA,Rural,17,Preprimary,385331,323492,708823
12570,0,INDIA,Rural,18,Preprimary,572129,475133,1047262
12571,0,INDIA,Rural,19,Preprimary,360723,348597,709320
12572,0,INDIA,Rural,20-24,Preprimary,2153416,2075265,4228681
12573,0,INDIA,Rural,25-29,Preprimary,2136666,2150116,4286782
12574,0,INDIA,Rural,30-34,Preprimary,2045941,2062366,4108307
12575,0,INDIA,Rural,35-39,Preprimary,2228899,2086694,4315593
12576,0,INDIA,Rural,40-44,Preprimary,2198068,1766982,3965050
12577,0,INDIA,Rural,45-49,Preprimary,2115694,1527041,3642735
12578,0,INDIA,Rural,50-54,Preprimary,1750517,1157451,2907968
12579,0,INDIA,Rural,55-59,Preprimary,1348346,934879,2283225
12580,0,INDIA,Rural,60-64,Preprimary,1379589,818981,2198570
12581,0,INDIA,Rural,65-69,Preprimary,1121884,581385,1703269
12582,0,INDIA,Rural,70-74,Preprimary,846866,356473,1203339
12583,0,INDIA,Rural,75-79,Preprimary,435606,191497,627103
12584,0,INDIA,Rural,80+,Preprimary,478786,216873,695659
12585,0,INDIA,Rural,Age not stated,Preprimary,170871,145363,316234
12586,0,INDIA,Urban,All ages,Preprimary,19338314,17915285,37253599
12587,0,INDIA,Urban,0-6,Preprimary,0,0,0
12588,0,INDIA,Urban,7,Preprimary,2662188,2397124,5059312
12589,0,INDIA,Urban,8,Preprimary,3095769,2754695,5850464
12590,0,INDIA,Urban,9,Preprimary,2616639,2289994,4906633
12591,0,INDIA,Urban,10,Preprimary,2328523,1937820,4266343
12592,0,INDIA,Urban,11,Preprimary,988858,789143,1778001
12593,0,INDIA,Urban,12,Preprimary,528085,410167,938252
12594,0,INDIA,Urban,13,Preprimary,249881,200340,450221
12595,0,INDIA,Urban,14,Preprimary,169701,135839,305540
12596,0,INDIA,Urban,15,Preprimary,148185,112731,260916
12597,0,INDIA,Urban,16,Preprimary,140632,110784,251416
12598,0,INDIA,Urban,17,Preprimary,126998,96620,223618
12599,0,INDIA,Urban,18,Preprimary,170425,120291,290716
12600,0,INDIA,Urban,19,Preprimary,118430,92506,210936
12601,0,INDIA,Urban,20-24,Preprimary,637980,543528,1181508
12602,0,INDIA,Urban,25-29,Preprimary,601269,612503,1213772
12603,0,INDIA,Urban,30-34,Preprimary,566889,624913,1191802
12604,0,INDIA,Urban,35-39,Preprimary,627330,716578,1343908
12605,0,INDIA,Urban,40-44,Preprimary,635603,683366,1318969
12606,0,INDIA,Urban,45-49,Preprimary,633684,683341,1317025
12607,0,INDIA,Urban,50-54,Preprimary,533893,566994,1100887
12608,0,INDIA,Urban,55-59,Preprimary,416000,486873,902873
12609,0,INDIA,Urban,60-64,Preprimary,403287,465846,869133
12610,0,INDIA,Urban,65-69,Preprimary,309003,368973,677976
12611,0,INDIA,Urban,70-74,Preprimary,247908,274800,522708
12612,0,INDIA,Urban,75-79,Preprimary,146765,176175,322940
12613,0,INDIA,Urban,80+,Preprimary,164914,200920,365834
12614,0,INDIA,Urban,Age not stated,Preprimary,69475,62421,131896
12615,1,State - JAMMU & KASHMIR,Total,All ages,Preprimary,541130,446644,987774
12616,1,State - JAMMU & KASHMIR,Total,0-6,Preprimary,0,0,0
12617,1,State - JAMMU & KASHMIR,Total,7,Preprimary,93095,80476,173571
12618,1,State - JAMMU & KASHMIR,Total,8,Preprimary,119170,102032,221202
12619,1,State - JAMMU & KASHMIR,Total,9,Preprimary,99450,84876,184326
12620,1,State - JAMMU & KASHMIR,Total,10,Preprimary,92110,77344,169454
12621,1,State - JAMMU & KASHMIR,Total,11,Preprimary,43037,36010,79047
12622,1,State - JAMMU & KASHMIR,Total,12,Preprimary,16983,14551,31534
12623,1,State - JAMMU & KASHMIR,Total,13,Preprimary,6704,6133,12837
12624,1,State - JAMMU & KASHMIR,Total,14,Preprimary,3535,3306,6841
12625,1,State - JAMMU & KASHMIR,Total,15,Preprimary,2539,2403,4942
12626,1,State - JAMMU & KASHMIR,Total,16,Preprimary,2101,2048,4149
12627,1,State - JAMMU & KASHMIR,Total,17,Preprimary,1622,1542,3164
12628,1,State - JAMMU & KASHMIR,Total,18,Preprimary,2177,2043,4220
12629,1,State - JAMMU & KASHMIR,Total,19,Preprimary,1734,1428,3162
12630,1,State - JAMMU & KASHMIR,Total,20-24,Preprimary,8899,6825,15724
12631,1,State - JAMMU & KASHMIR,Total,25-29,Preprimary,7002,4821,11823
12632,1,State - JAMMU & KASHMIR,Total,30-34,Preprimary,6783,4404,11187
12633,1,State - JAMMU & KASHMIR,Total,35-39,Preprimary,6230,3869,10099
12634,1,State - JAMMU & KASHMIR,Total,40-44,Preprimary,5692,3123,8815
12635,1,State - JAMMU & KASHMIR,Total,45-49,Preprimary,4973,2448,7421
12636,1,State - JAMMU & KASHMIR,Total,50-54,Preprimary,4145,1694,5839
12637,1,State - JAMMU & KASHMIR,Total,55-59,Preprimary,2850,1342,4192
12638,1,State - JAMMU & KASHMIR,Total,60-64,Preprimary,3159,1178,4337
12639,1,State - JAMMU & KASHMIR,Total,65-69,Preprimary,2076,840,2916
12640,1,State - JAMMU & KASHMIR,Total,70-74,Preprimary,2078,724,2802
12641,1,State - JAMMU & KASHMIR,Total,75-79,Preprimary,1072,380,1452
12642,1,State - JAMMU & KASHMIR,Total,80+,Preprimary,1511,499,2010
12643,1,State - JAMMU & KASHMIR,Total,Age not stated,Preprimary,403,305,708
12644,1,State - JAMMU & KASHMIR,Rural,All ages,Preprimary,419327,344263,763590
12645,1,State - JAMMU & KASHMIR,Rural,0-6,Preprimary,0,0,0
12646,1,State - JAMMU & KASHMIR,Rural,7,Preprimary,70847,60933,131780
12647,1,State - JAMMU & KASHMIR,Rural,8,Preprimary,91788,78533,170321
12648,1,State - JAMMU & KASHMIR,Rural,9,Preprimary,76710,65442,142152
12649,1,State - JAMMU & KASHMIR,Rural,10,Preprimary,71040,59987,131027
12650,1,State - JAMMU & KASHMIR,Rural,11,Preprimary,33759,28620,62379
12651,1,State - JAMMU & KASHMIR,Rural,12,Preprimary,13501,11827,25328
12652,1,State - JAMMU & KASHMIR,Rural,13,Preprimary,5348,5024,10372
12653,1,State - JAMMU & KASHMIR,Rural,14,Preprimary,2889,2771,5660
12654,1,State - JAMMU & KASHMIR,Rural,15,Preprimary,2047,2009,4056
12655,1,State - JAMMU & KASHMIR,Rural,16,Preprimary,1665,1733,3398
12656,1,State - JAMMU & KASHMIR,Rural,17,Preprimary,1257,1252,2509
12657,1,State - JAMMU & KASHMIR,Rural,18,Preprimary,1670,1592,3262
12658,1,State - JAMMU & KASHMIR,Rural,19,Preprimary,1245,1047,2292
12659,1,State - JAMMU & KASHMIR,Rural,20-24,Preprimary,6823,5158,11981
12660,1,State - JAMMU & KASHMIR,Rural,25-29,Preprimary,5683,3786,9469
12661,1,State - JAMMU & KASHMIR,Rural,30-34,Preprimary,5575,3377,8952
12662,1,State - JAMMU & KASHMIR,Rural,35-39,Preprimary,4982,2905,7887
12663,1,State - JAMMU & KASHMIR,Rural,40-44,Preprimary,4504,2323,6827
12664,1,State - JAMMU & KASHMIR,Rural,45-49,Preprimary,3940,1759,5699
12665,1,State - JAMMU & KASHMIR,Rural,50-54,Preprimary,3389,1186,4575
12666,1,State - JAMMU & KASHMIR,Rural,55-59,Preprimary,2320,889,3209
12667,1,State - JAMMU & KASHMIR,Rural,60-64,Preprimary,2618,692,3310
12668,1,State - JAMMU & KASHMIR,Rural,65-69,Preprimary,1685,426,2111
12669,1,State - JAMMU & KASHMIR,Rural,70-74,Preprimary,1685,340,2025
12670,1,State - JAMMU & KASHMIR,Rural,75-79,Preprimary,831,166,997
12671,1,State - JAMMU & KASHMIR,Rural,80+,Preprimary,1213,245,1458
12672,1,State - JAMMU & KASHMIR,Rural,Age not stated,Preprimary,313,241,554
12673,1,State - JAMMU & KASHMIR,Urban,All ages,Preprimary,121803,102381,224184
12674,1,State - JAMMU & KASHMIR,Urban,0-6,Preprimary,0,0,0
12675,1,State - JAMMU & KASHMIR,Urban,7,Preprimary,22248,19543,41791
12676,1,State - JAMMU & KASHMIR,Urban,8,Preprimary,27382,23499,50881
12677,1,State - JAMMU & KASHMIR,Urban,9,Preprimary,22740,19434,42174
12678,1,State - JAMMU & KASHMIR,Urban,10,Preprimary,21070,17357,38427
12679,1,State - JAMMU & KASHMIR,Urban,11,Preprimary,9278,7390,16668
12680,1,State - JAMMU & KASHMIR,Urban,12,Preprimary,3482,2724,6206
12681,1,State - JAMMU & KASHMIR,Urban,13,Preprimary,1356,1109,2465
12682,1,State - JAMMU & KASHMIR,Urban,14,Preprimary,646,535,1181
12683,1,State - JAMMU & KASHMIR,Urban,15,Preprimary,492,394,886
12684,1,State - JAMMU & KASHMIR,Urban,16,Preprimary,436,315,751
12685,1,State - JAMMU & KASHMIR,Urban,17,Preprimary,365,290,655
12686,1,State - JAMMU & KASHMIR,Urban,18,Preprimary,507,451,958
12687,1,State - JAMMU & KASHMIR,Urban,19,Preprimary,489,381,870
12688,1,State - JAMMU & KASHMIR,Urban,20-24,Preprimary,2076,1667,3743
12689,1,State - JAMMU & KASHMIR,Urban,25-29,Preprimary,1319,1035,2354
12690,1,State - JAMMU & KASHMIR,Urban,30-34,Preprimary,1208,1027,2235
12691,1,State - JAMMU & KASHMIR,Urban,35-39,Preprimary,1248,964,2212
12692,1,State - JAMMU & KASHMIR,Urban,40-44,Preprimary,1188,800,1988
12693,1,State - JAMMU & KASHMIR,Urban,45-49,Preprimary,1033,689,1722
12694,1,State - JAMMU & KASHMIR,Urban,50-54,Preprimary,756,508,1264
12695,1,State - JAMMU & KASHMIR,Urban,55-59,Preprimary,530,453,983
12696,1,State - JAMMU & KASHMIR,Urban,60-64,Preprimary,541,486,1027
12697,1,State - JAMMU & KASHMIR,Urban,65-69,Preprimary,391,414,805
12698,1,State - JAMMU & KASHMIR,Urban,70-74,Preprimary,393,384,777
12699,1,State - JAMMU & KASHMIR,Urban,75-79,Preprimary,241,214,455
12700,1,State - JAMMU & KASHMIR,Urban,80+,Preprimary,298,254,552
12701,1,State - JAMMU & KASHMIR,Urban,Age not stated,Preprimary,90,64,154
12702,2,State - HIMACHAL PRADESH,Total,All ages,Preprimary,326058,285417,611475
12703,2,State - HIMACHAL PRADESH,Total,0-6,Preprimary,0,0,0
12704,2,State - HIMACHAL PRADESH,Total,7,Preprimary,52985,48035,101020
12705,2,State - HIMACHAL PRADESH,Total,8,Preprimary,58142,51989,110131
12706,2,State - HIMACHAL PRADESH,Total,9,Preprimary,53977,46565,100542
12707,2,State - HIMACHAL PRADESH,Total,10,Preprimary,37525,32050,69575
12708,2,State - HIMACHAL PRADESH,Total,11,Preprimary,12803,10706,23509
12709,2,State - HIMACHAL PRADESH,Total,12,Preprimary,4160,3572,7732
12710,2,State - HIMACHAL PRADESH,Total,13,Preprimary,1771,1538,3309
12711,2,State - HIMACHAL PRADESH,Total,14,Preprimary,1024,919,1943
12712,2,State - HIMACHAL PRADESH,Total,15,Preprimary,931,772,1703
12713,2,State - HIMACHAL PRADESH,Total,16,Preprimary,846,663,1509
12714,2,State - HIMACHAL PRADESH,Total,17,Preprimary,888,642,1530
12715,2,State - HIMACHAL PRADESH,Total,18,Preprimary,1280,857,2137
12716,2,State - HIMACHAL PRADESH,Total,19,Preprimary,1002,788,1790
12717,2,State - HIMACHAL PRADESH,Total,20-24,Preprimary,6014,5018,11032
12718,2,State - HIMACHAL PRADESH,Total,25-29,Preprimary,6873,6807,13680
12719,2,State - HIMACHAL PRADESH,Total,30-34,Preprimary,7991,8812,16803
12720,2,State - HIMACHAL PRADESH,Total,35-39,Preprimary,9509,10486,19995
12721,2,State - HIMACHAL PRADESH,Total,40-44,Preprimary,10588,11208,21796
12722,2,State - HIMACHAL PRADESH,Total,45-49,Preprimary,11957,11691,23648
12723,2,State - HIMACHAL PRADESH,Total,50-54,Preprimary,10255,9943,20198
12724,2,State - HIMACHAL PRADESH,Total,55-59,Preprimary,8201,7791,15992
12725,2,State - HIMACHAL PRADESH,Total,60-64,Preprimary,8032,5851,13883
12726,2,State - HIMACHAL PRADESH,Total,65-69,Preprimary,5985,3444,9429
12727,2,State - HIMACHAL PRADESH,Total,70-74,Preprimary,5259,2373,7632
12728,2,State - HIMACHAL PRADESH,Total,75-79,Preprimary,3217,1189,4406
12729,2,State - HIMACHAL PRADESH,Total,80+,Preprimary,4307,1279,5586
12730,2,State - HIMACHAL PRADESH,Total,Age not stated,Preprimary,536,429,965
12731,2,State - HIMACHAL PRADESH,Rural,All ages,Preprimary,297122,262066,559188
12732,2,State - HIMACHAL PRADESH,Rural,0-6,Preprimary,0,0,0
12733,2,State - HIMACHAL PRADESH,Rural,7,Preprimary,48180,43950,92130
12734,2,State - HIMACHAL PRADESH,Rural,8,Preprimary,52607,47381,99988
12735,2,State - HIMACHAL PRADESH,Rural,9,Preprimary,48831,42360,91191
12736,2,State - HIMACHAL PRADESH,Rural,10,Preprimary,33407,28802,62209
12737,2,State - HIMACHAL PRADESH,Rural,11,Preprimary,11253,9615,20868
12738,2,State - HIMACHAL PRADESH,Rural,12,Preprimary,3654,3215,6869
12739,2,State - HIMACHAL PRADESH,Rural,13,Preprimary,1533,1363,2896
12740,2,State - HIMACHAL PRADESH,Rural,14,Preprimary,881,818,1699
12741,2,State - HIMACHAL PRADESH,Rural,15,Preprimary,788,695,1483
12742,2,State - HIMACHAL PRADESH,Rural,16,Preprimary,740,615,1355
12743,2,State - HIMACHAL PRADESH,Rural,17,Preprimary,767,598,1365
12744,2,State - HIMACHAL PRADESH,Rural,18,Preprimary,1073,794,1867
12745,2,State - HIMACHAL PRADESH,Rural,19,Preprimary,829,741,1570
12746,2,State - HIMACHAL PRADESH,Rural,20-24,Preprimary,5176,4665,9841
12747,2,State - HIMACHAL PRADESH,Rural,25-29,Preprimary,6149,6399,12548
12748,2,State - HIMACHAL PRADESH,Rural,30-34,Preprimary,7321,8318,15639
12749,2,State - HIMACHAL PRADESH,Rural,35-39,Preprimary,8822,9880,18702
12750,2,State - HIMACHAL PRADESH,Rural,40-44,Preprimary,9911,10646,20557
12751,2,State - HIMACHAL PRADESH,Rural,45-49,Preprimary,11275,11090,22365
12752,2,State - HIMACHAL PRADESH,Rural,50-54,Preprimary,9745,9471,19216
12753,2,State - HIMACHAL PRADESH,Rural,55-59,Preprimary,7868,7419,15287
12754,2,State - HIMACHAL PRADESH,Rural,60-64,Preprimary,7741,5524,13265
12755,2,State - HIMACHAL PRADESH,Rural,65-69,Preprimary,5784,3167,8951
12756,2,State - HIMACHAL PRADESH,Rural,70-74,Preprimary,5075,2116,7191
12757,2,State - HIMACHAL PRADESH,Rural,75-79,Preprimary,3090,1002,4092
12758,2,State - HIMACHAL PRADESH,Rural,80+,Preprimary,4118,1024,5142
12759,2,State - HIMACHAL PRADESH,Rural,Age not stated,Preprimary,504,398,902
12760,2,State - HIMACHAL PRADESH,Urban,All ages,Preprimary,28936,23351,52287
12761,2,State - HIMACHAL PRADESH,Urban,0-6,Preprimary,0,0,0
12762,2,State - HIMACHAL PRADESH,Urban,7,Preprimary,4805,4085,8890
12763,2,State - HIMACHAL PRADESH,Urban,8,Preprimary,5535,4608,10143
12764,2,State - HIMACHAL PRADESH,Urban,9,Preprimary,5146,4205,9351
12765,2,State - HIMACHAL PRADESH,Urban,10,Preprimary,4118,3248,7366
12766,2,State - HIMACHAL PRADESH,Urban,11,Preprimary,1550,1091,2641
12767,2,State - HIMACHAL PRADESH,Urban,12,Preprimary,506,357,863
12768,2,State - HIMACHAL PRADESH,Urban,13,Preprimary,238,175,413
12769,2,State - HIMACHAL PRADESH,Urban,14,Preprimary,143,101,244
12770,2,State - HIMACHAL PRADESH,Urban,15,Preprimary,143,77,220
12771,2,State - HIMACHAL PRADESH,Urban,16,Preprimary,106,48,154
12772,2,State - HIMACHAL PRADESH,Urban,17,Preprimary,121,44,165
12773,2,State - HIMACHAL PRADESH,Urban,18,Preprimary,207,63,270
12774,2,State - HIMACHAL PRADESH,Urban,19,Preprimary,173,47,220
12775,2,State - HIMACHAL PRADESH,Urban,20-24,Preprimary,838,353,1191
12776,2,State - HIMACHAL PRADESH,Urban,25-29,Preprimary,724,408,1132
12777,2,State - HIMACHAL PRADESH,Urban,30-34,Preprimary,670,494,1164
12778,2,State - HIMACHAL PRADESH,Urban,35-39,Preprimary,687,606,1293
12779,2,State - HIMACHAL PRADESH,Urban,40-44,Preprimary,677,562,1239
12780,2,State - HIMACHAL PRADESH,Urban,45-49,Preprimary,682,601,1283
12781,2,State - HIMACHAL PRADESH,Urban,50-54,Preprimary,510,472,982
12782,2,State - HIMACHAL PRADESH,Urban,55-59,Preprimary,333,372,705
12783,2,State - HIMACHAL PRADESH,Urban,60-64,Preprimary,291,327,618
12784,2,State - HIMACHAL PRADESH,Urban,65-69,Preprimary,201,277,478
12785,2,State - HIMACHAL PRADESH,Urban,70-74,Preprimary,184,257,441
12786,2,State - HIMACHAL PRADESH,Urban,75-79,Preprimary,127,187,314
12787,2,State - HIMACHAL PRADESH,Urban,80+,Preprimary,189,255,444
12788,2,State - HIMACHAL PRADESH,Urban,Age not stated,Preprimary,32,31,63
12789,3,State - PUNJAB,Total,All ages,Preprimary,1273936,953748,2227684
12790,3,State - PUNJAB,Total,0-6,Preprimary,0,0,0
12791,3,State - PUNJAB,Total,7,Preprimary,196661,164787,361448
12792,3,State - PUNJAB,Total,8,Preprimary,228697,185477,414174
12793,3,State - PUNJAB,Total,9,Preprimary,217609,166277,383886
12794,3,State - PUNJAB,Total,10,Preprimary,204901,147157,352058
12795,3,State - PUNJAB,Total,11,Preprimary,106512,71451,177963
12796,3,State - PUNJAB,Total,12,Preprimary,52414,34624,87038
12797,3,State - PUNJAB,Total,13,Preprimary,23901,16597,40498
12798,3,State - PUNJAB,Total,14,Preprimary,13593,9556,23149
12799,3,State - PUNJAB,Total,15,Preprimary,10113,7199,17312
12800,3,State - PUNJAB,Total,16,Preprimary,8225,5694,13919
12801,3,State - PUNJAB,Total,17,Preprimary,6531,4293,10824
12802,3,State - PUNJAB,Total,18,Preprimary,8403,4800,13203
12803,3,State - PUNJAB,Total,19,Preprimary,5954,3448,9402
12804,3,State - PUNJAB,Total,20-24,Preprimary,28185,16112,44297
12805,3,State - PUNJAB,Total,25-29,Preprimary,21091,13982,35073
12806,3,State - PUNJAB,Total,30-34,Preprimary,18753,14455,33208
12807,3,State - PUNJAB,Total,35-39,Preprimary,20100,15078,35178
12808,3,State - PUNJAB,Total,40-44,Preprimary,18837,14432,33269
12809,3,State - PUNJAB,Total,45-49,Preprimary,17187,12599,29786
12810,3,State - PUNJAB,Total,50-54,Preprimary,14315,10200,24515
12811,3,State - PUNJAB,Total,55-59,Preprimary,10328,8527,18855
12812,3,State - PUNJAB,Total,60-64,Preprimary,11590,9870,21460
12813,3,State - PUNJAB,Total,65-69,Preprimary,9548,6293,15841
12814,3,State - PUNJAB,Total,70-74,Preprimary,7698,4291,11989
12815,3,State - PUNJAB,Total,75-79,Preprimary,4524,2372,6896
12816,3,State - PUNJAB,Total,80+,Preprimary,6436,2776,9212
12817,3,State - PUNJAB,Total,Age not stated,Preprimary,1830,1401,3231
12818,3,State - PUNJAB,Rural,All ages,Preprimary,832909,621429,1454338
12819,3,State - PUNJAB,Rural,0-6,Preprimary,0,0,0
12820,3,State - PUNJAB,Rural,7,Preprimary,124305,104831,229136
12821,3,State - PUNJAB,Rural,8,Preprimary,146875,119886,266761
12822,3,State - PUNJAB,Rural,9,Preprimary,140869,108043,248912
12823,3,State - PUNJAB,Rural,10,Preprimary,133703,96057,229760
12824,3,State - PUNJAB,Rural,11,Preprimary,72123,47648,119771
12825,3,State - PUNJAB,Rural,12,Preprimary,35678,23200,58878
12826,3,State - PUNJAB,Rural,13,Preprimary,15794,10932,26726
12827,3,State - PUNJAB,Rural,14,Preprimary,9078,6383,15461
12828,3,State - PUNJAB,Rural,15,Preprimary,6671,4998,11669
12829,3,State - PUNJAB,Rural,16,Preprimary,5511,4018,9529
12830,3,State - PUNJAB,Rural,17,Preprimary,4267,3024,7291
12831,3,State - PUNJAB,Rural,18,Preprimary,5386,3311,8697
12832,3,State - PUNJAB,Rural,19,Preprimary,3871,2333,6204
12833,3,State - PUNJAB,Rural,20-24,Preprimary,18562,10701,29263
12834,3,State - PUNJAB,Rural,25-29,Preprimary,13575,9111,22686
12835,3,State - PUNJAB,Rural,30-34,Preprimary,12453,9895,22348
12836,3,State - PUNJAB,Rural,35-39,Preprimary,13513,10264,23777
12837,3,State - PUNJAB,Rural,40-44,Preprimary,12963,9975,22938
12838,3,State - PUNJAB,Rural,45-49,Preprimary,11653,8564,20217
12839,3,State - PUNJAB,Rural,50-54,Preprimary,9775,6893,16668
12840,3,State - PUNJAB,Rural,55-59,Preprimary,7152,5623,12775
12841,3,State - PUNJAB,Rural,60-64,Preprimary,8247,6403,14650
12842,3,State - PUNJAB,Rural,65-69,Preprimary,6928,3616,10544
12843,3,State - PUNJAB,Rural,70-74,Preprimary,5336,2215,7551
12844,3,State - PUNJAB,Rural,75-79,Preprimary,2952,1101,4053
12845,3,State - PUNJAB,Rural,80+,Preprimary,4280,1343,5623
12846,3,State - PUNJAB,Rural,Age not stated,Preprimary,1389,1061,2450
12847,3,State - PUNJAB,Urban,All ages,Preprimary,441027,332319,773346
12848,3,State - PUNJAB,Urban,0-6,Preprimary,0,0,0
12849,3,State - PUNJAB,Urban,7,Preprimary,72356,59956,132312
12850,3,State - PUNJAB,Urban,8,Preprimary,81822,65591,147413
12851,3,State - PUNJAB,Urban,9,Preprimary,76740,58234,134974
12852,3,State - PUNJAB,Urban,10,Preprimary,71198,51100,122298
12853,3,State - PUNJAB,Urban,11,Preprimary,34389,23803,58192
12854,3,State - PUNJAB,Urban,12,Preprimary,16736,11424,28160
12855,3,State - PUNJAB,Urban,13,Preprimary,8107,5665,13772
12856,3,State - PUNJAB,Urban,14,Preprimary,4515,3173,7688
12857,3,State - PUNJAB,Urban,15,Preprimary,3442,2201,5643
12858,3,State - PUNJAB,Urban,16,Preprimary,2714,1676,4390
12859,3,State - PUNJAB,Urban,17,Preprimary,2264,1269,3533
12860,3,State - PUNJAB,Urban,18,Preprimary,3017,1489,4506
12861,3,State - PUNJAB,Urban,19,Preprimary,2083,1115,3198
12862,3,State - PUNJAB,Urban,20-24,Preprimary,9623,5411,15034
12863,3,State - PUNJAB,Urban,25-29,Preprimary,7516,4871,12387
12864,3,State - PUNJAB,Urban,30-34,Preprimary,6300,4560,10860
12865,3,State - PUNJAB,Urban,35-39,Preprimary,6587,4814,11401
12866,3,State - PUNJAB,Urban,40-44,Preprimary,5874,4457,10331
12867,3,State - PUNJAB,Urban,45-49,Preprimary,5534,4035,9569
12868,3,State - PUNJAB,Urban,50-54,Preprimary,4540,3307,7847
12869,3,State - PUNJAB,Urban,55-59,Preprimary,3176,2904,6080
12870,3,State - PUNJAB,Urban,60-64,Preprimary,3343,3467,6810
12871,3,State - PUNJAB,Urban,65-69,Preprimary,2620,2677,5297
12872,3,State - PUNJAB,Urban,70-74,Preprimary,2362,2076,4438
12873,3,State - PUNJAB,Urban,75-79,Preprimary,1572,1271,2843
12874,3,State - PUNJAB,Urban,80+,Preprimary,2156,1433,3589
12875,3,State - PUNJAB,Urban,Age not stated,Preprimary,441,340,781
12876,4,State - CHANDIGARH,Total,All ages,Preprimary,51211,39658,90869
12877,4,State - CHANDIGARH,Total,0-6,Preprimary,0,0,0
12878,4,State - CHANDIGARH,Total,7,Preprimary,8203,7004,15207
12879,4,State - CHANDIGARH,Total,8,Preprimary,8622,7149,15771
12880,4,State - CHANDIGARH,Total,9,Preprimary,8411,6884,15295
12881,4,State - CHANDIGARH,Total,10,Preprimary,8169,6194,14363
12882,4,State - CHANDIGARH,Total,11,Preprimary,4049,3092,7141
12883,4,State - CHANDIGARH,Total,12,Preprimary,2176,1625,3801
12884,4,State - CHANDIGARH,Total,13,Preprimary,1087,840,1927
12885,4,State - CHANDIGARH,Total,14,Preprimary,603,519,1122
12886,4,State - CHANDIGARH,Total,15,Preprimary,415,315,730
12887,4,State - CHANDIGARH,Total,16,Preprimary,341,236,577
12888,4,State - CHANDIGARH,Total,17,Preprimary,308,172,480
12889,4,State - CHANDIGARH,Total,18,Preprimary,465,203,668
12890,4,State - CHANDIGARH,Total,19,Preprimary,317,144,461
12891,4,State - CHANDIGARH,Total,20-24,Preprimary,1556,755,2311
12892,4,State - CHANDIGARH,Total,25-29,Preprimary,1257,790,2047
12893,4,State - CHANDIGARH,Total,30-34,Preprimary,1113,718,1831
12894,4,State - CHANDIGARH,Total,35-39,Preprimary,1009,746,1755
12895,4,State - CHANDIGARH,Total,40-44,Preprimary,768,545,1313
12896,4,State - CHANDIGARH,Total,45-49,Preprimary,663,460,1123
12897,4,State - CHANDIGARH,Total,50-54,Preprimary,505,338,843
12898,4,State - CHANDIGARH,Total,55-59,Preprimary,336,249,585
12899,4,State - CHANDIGARH,Total,60-64,Preprimary,324,222,546
12900,4,State - CHANDIGARH,Total,65-69,Preprimary,182,158,340
12901,4,State - CHANDIGARH,Total,70-74,Preprimary,147,106,253
12902,4,State - CHANDIGARH,Total,75-79,Preprimary,71,84,155
12903,4,State - CHANDIGARH,Total,80+,Preprimary,101,103,204
12904,4,State - CHANDIGARH,Total,Age not stated,Preprimary,13,7,20
12905,4,State - CHANDIGARH,Rural,All ages,Preprimary,1738,1259,2997
12906,4,State - CHANDIGARH,Rural,0-6,Preprimary,0,0,0
12907,4,State - CHANDIGARH,Rural,7,Preprimary,248,199,447
12908,4,State - CHANDIGARH,Rural,8,Preprimary,268,227,495
12909,4,State - CHANDIGARH,Rural,9,Preprimary,236,208,444
12910,4,State - CHANDIGARH,Rural,10,Preprimary,267,194,461
12911,4,State - CHANDIGARH,Rural,11,Preprimary,145,113,258
12912,4,State - CHANDIGARH,Rural,12,Preprimary,78,51,129
12913,4,State - CHANDIGARH,Rural,13,Preprimary,30,28,58
12914,4,State - CHANDIGARH,Rural,14,Preprimary,20,25,45
12915,4,State - CHANDIGARH,Rural,15,Preprimary,18,13,31
12916,4,State - CHANDIGARH,Rural,16,Preprimary,15,10,25
12917,4,State - CHANDIGARH,Rural,17,Preprimary,12,6,18
12918,4,State - CHANDIGARH,Rural,18,Preprimary,25,8,33
12919,4,State - CHANDIGARH,Rural,19,Preprimary,14,0,14
12920,4,State - CHANDIGARH,Rural,20-24,Preprimary,82,24,106
12921,4,State - CHANDIGARH,Rural,25-29,Preprimary,73,32,105
12922,4,State - CHANDIGARH,Rural,30-34,Preprimary,53,34,87
12923,4,State - CHANDIGARH,Rural,35-39,Preprimary,57,31,88
12924,4,State - CHANDIGARH,Rural,40-44,Preprimary,33,16,49
12925,4,State - CHANDIGARH,Rural,45-49,Preprimary,21,8,29
12926,4,State - CHANDIGARH,Rural,50-54,Preprimary,8,9,17
12927,4,State - CHANDIGARH,Rural,55-59,Preprimary,8,10,18
12928,4,State - CHANDIGARH,Rural,60-64,Preprimary,8,5,13
12929,4,State - CHANDIGARH,Rural,65-69,Preprimary,7,2,9
12930,4,State - CHANDIGARH,Rural,70-74,Preprimary,6,2,8
12931,4,State - CHANDIGARH,Rural,75-79,Preprimary,2,1,3
12932,4,State - CHANDIGARH,Rural,80+,Preprimary,3,3,6
12933,4,State - CHANDIGARH,Rural,Age not stated,Preprimary,1,0,1
12934,4,State - CHANDIGARH,Urban,All ages,Preprimary,49473,38399,87872
12935,4,State - CHANDIGARH,Urban,0-6,Preprimary,0,0,0
12936,4,State - CHANDIGARH,Urban,7,Preprimary,7955,6805,14760
12937,4,State - CHANDIGARH,Urban,8,Preprimary,8354,6922,15276
12938,4,State - CHANDIGARH,Urban,9,Preprimary,8175,6676,14851
12939,4,State - CHANDIGARH,Urban,10,Preprimary,7902,6000,13902
12940,4,State - CHANDIGARH,Urban,11,Preprimary,3904,2979,6883
12941,4,State - CHANDIGARH,Urban,12,Preprimary,2098,1574,3672
12942,4,State - CHANDIGARH,Urban,13,Preprimary,1057,812,1869
12943,4,State - CHANDIGARH,Urban,14,Preprimary,583,494,1077
12944,4,State - CHANDIGARH,Urban,15,Preprimary,397,302,699
12945,4,State - CHANDIGARH,Urban,16,Preprimary,326,226,552
12946,4,State - CHANDIGARH,Urban,17,Preprimary,296,166,462
12947,4,State - CHANDIGARH,Urban,18,Preprimary,440,195,635
12948,4,State - CHANDIGARH,Urban,19,Preprimary,303,144,447
12949,4,State - CHANDIGARH,Urban,20-24,Preprimary,1474,731,2205
12950,4,State - CHANDIGARH,Urban,25-29,Preprimary,1184,758,1942
12951,4,State - CHANDIGARH,Urban,30-34,Preprimary,1060,684,1744
12952,4,State - CHANDIGARH,Urban,35-39,Preprimary,952,715,1667
12953,4,State - CHANDIGARH,Urban,40-44,Preprimary,735,529,1264
12954,4,State - CHANDIGARH,Urban,45-49,Preprimary,642,452,1094
12955,4,State - CHANDIGARH,Urban,50-54,Preprimary,497,329,826
12956,4,State - CHANDIGARH,Urban,55-59,Preprimary,328,239,567
12957,4,State - CHANDIGARH,Urban,60-64,Preprimary,316,217,533
12958,4,State - CHANDIGARH,Urban,65-69,Preprimary,175,156,331
12959,4,State - CHANDIGARH,Urban,70-74,Preprimary,141,104,245
12960,4,State - CHANDIGARH,Urban,75-79,Preprimary,69,83,152
12961,4,State - CHANDIGARH,Urban,80+,Preprimary,98,100,198
12962,4,State - CHANDIGARH,Urban,Age not stated,Preprimary,12,7,19
12963,5,State - UTTARAKHAND,Total,All ages,Preprimary,554430,480153,1034583
12964,5,State - UTTARAKHAND,Total,0-6,Preprimary,0,0,0
12965,5,State - UTTARAKHAND,Total,7,Preprimary,85069,75948,161017
12966,5,State - UTTARAKHAND,Total,8,Preprimary,102656,90467,193123
12967,5,State - UTTARAKHAND,Total,9,Preprimary,87583,76646,164229
12968,5,State - UTTARAKHAND,Total,10,Preprimary,83071,70190,153261
12969,5,State - UTTARAKHAND,Total,11,Preprimary,41030,34186,75216
12970,5,State - UTTARAKHAND,Total,12,Preprimary,24630,20086,44716
12971,5,State - UTTARAKHAND,Total,13,Preprimary,11077,9343,20420
12972,5,State - UTTARAKHAND,Total,14,Preprimary,6525,5423,11948
12973,5,State - UTTARAKHAND,Total,15,Preprimary,4457,3612,8069
12974,5,State - UTTARAKHAND,Total,16,Preprimary,3472,2950,6422
12975,5,State - UTTARAKHAND,Total,17,Preprimary,2532,2104,4636
12976,5,State - UTTARAKHAND,Total,18,Preprimary,3505,2610,6115
12977,5,State - UTTARAKHAND,Total,19,Preprimary,2423,1735,4158
12978,5,State - UTTARAKHAND,Total,20-24,Preprimary,10955,9367,20322
12979,5,State - UTTARAKHAND,Total,25-29,Preprimary,8557,9336,17893
12980,5,State - UTTARAKHAND,Total,30-34,Preprimary,7973,10151,18124
12981,5,State - UTTARAKHAND,Total,35-39,Preprimary,8943,11045,19988
12982,5,State - UTTARAKHAND,Total,40-44,Preprimary,8237,9758,17995
12983,5,State - UTTARAKHAND,Total,45-49,Preprimary,8193,8757,16950
12984,5,State - UTTARAKHAND,Total,50-54,Preprimary,7195,6941,14136
12985,5,State - UTTARAKHAND,Total,55-59,Preprimary,5788,5854,11642
12986,5,State - UTTARAKHAND,Total,60-64,Preprimary,8852,5200,14052
12987,5,State - UTTARAKHAND,Total,65-69,Preprimary,6624,3221,9845
12988,5,State - UTTARAKHAND,Total,70-74,Preprimary,5769,2125,7894
12989,5,State - UTTARAKHAND,Total,75-79,Preprimary,3621,1151,4772
12990,5,State - UTTARAKHAND,Total,80+,Preprimary,4847,1263,6110
12991,5,State - UTTARAKHAND,Total,Age not stated,Preprimary,846,684,1530
12992,5,State - UTTARAKHAND,Rural,All ages,Preprimary,405044,358745,763789
12993,5,State - UTTARAKHAND,Rural,0-6,Preprimary,0,0,0
12994,5,State - UTTARAKHAND,Rural,7,Preprimary,60893,55533,116426
12995,5,State - UTTARAKHAND,Rural,8,Preprimary,74626,66873,141499
12996,5,State - UTTARAKHAND,Rural,9,Preprimary,63626,57215,120841
12997,5,State - UTTARAKHAND,Rural,10,Preprimary,59710,52167,111877
12998,5,State - UTTARAKHAND,Rural,11,Preprimary,29691,25596,55287
12999,5,State - UTTARAKHAND,Rural,12,Preprimary,17828,14950,32778
13000,5,State - UTTARAKHAND,Rural,13,Preprimary,7816,6874,14690
13001,5,State - UTTARAKHAND,Rural,14,Preprimary,4464,3947,8411
13002,5,State - UTTARAKHAND,Rural,15,Preprimary,3005,2600,5605
13003,5,State - UTTARAKHAND,Rural,16,Preprimary,2326,2164,4490
13004,5,State - UTTARAKHAND,Rural,17,Preprimary,1626,1554,3180
13005,5,State - UTTARAKHAND,Rural,18,Preprimary,2281,1950,4231
13006,5,State - UTTARAKHAND,Rural,19,Preprimary,1572,1323,2895
13007,5,State - UTTARAKHAND,Rural,20-24,Preprimary,7246,7021,14267
13008,5,State - UTTARAKHAND,Rural,25-29,Preprimary,5910,7137,13047
13009,5,State - UTTARAKHAND,Rural,30-34,Preprimary,5744,8146,13890
13010,5,State - UTTARAKHAND,Rural,35-39,Preprimary,6632,8865,15497
13011,5,State - UTTARAKHAND,Rural,40-44,Preprimary,6398,7931,14329
13012,5,State - UTTARAKHAND,Rural,45-49,Preprimary,6444,7020,13464
13013,5,State - UTTARAKHAND,Rural,50-54,Preprimary,5893,5619,11512
13014,5,State - UTTARAKHAND,Rural,55-59,Preprimary,4772,4636,9408
13015,5,State - UTTARAKHAND,Rural,60-64,Preprimary,7654,3997,11651
13016,5,State - UTTARAKHAND,Rural,65-69,Preprimary,5849,2339,8188
13017,5,State - UTTARAKHAND,Rural,70-74,Preprimary,5140,1396,6536
13018,5,State - UTTARAKHAND,Rural,75-79,Preprimary,3199,706,3905
13019,5,State - UTTARAKHAND,Rural,80+,Preprimary,4148,700,4848
13020,5,State - UTTARAKHAND,Rural,Age not stated,Preprimary,551,486,1037
13021,5,State - UTTARAKHAND,Urban,All ages,Preprimary,149386,121408,270794
13022,5,State - UTTARAKHAND,Urban,0-6,Preprimary,0,0,0
13023,5,State - UTTARAKHAND,Urban,7,Preprimary,24176,20415,44591
13024,5,State - UTTARAKHAND,Urban,8,Preprimary,28030,23594,51624
13025,5,State - UTTARAKHAND,Urban,9,Preprimary,23957,19431,43388
13026,5,State - UTTARAKHAND,Urban,10,Preprimary,23361,18023,41384
13027,5,State - UTTARAKHAND,Urban,11,Preprimary,11339,8590,19929
13028,5,State - UTTARAKHAND,Urban,12,Preprimary,6802,5136,11938
13029,5,State - UTTARAKHAND,Urban,13,Preprimary,3261,2469,5730
13030,5,State - UTTARAKHAND,Urban,14,Preprimary,2061,1476,3537
13031,5,State - UTTARAKHAND,Urban,15,Preprimary,1452,1012,2464
13032,5,State - UTTARAKHAND,Urban,16,Preprimary,1146,786,1932
13033,5,State - UTTARAKHAND,Urban,17,Preprimary,906,550,1456
13034,5,State - UTTARAKHAND,Urban,18,Preprimary,1224,660,1884
13035,5,State - UTTARAKHAND,Urban,19,Preprimary,851,412,1263
13036,5,State - UTTARAKHAND,Urban,20-24,Preprimary,3709,2346,6055
13037,5,State - UTTARAKHAND,Urban,25-29,Preprimary,2647,2199,4846
13038,5,State - UTTARAKHAND,Urban,30-34,Preprimary,2229,2005,4234
13039,5,State - UTTARAKHAND,Urban,35-39,Preprimary,2311,2180,4491
13040,5,State - UTTARAKHAND,Urban,40-44,Preprimary,1839,1827,3666
13041,5,State - UTTARAKHAND,Urban,45-49,Preprimary,1749,1737,3486
13042,5,State - UTTARAKHAND,Urban,50-54,Preprimary,1302,1322,2624
13043,5,State - UTTARAKHAND,Urban,55-59,Preprimary,1016,1218,2234
13044,5,State - UTTARAKHAND,Urban,60-64,Preprimary,1198,1203,2401
13045,5,State - UTTARAKHAND,Urban,65-69,Preprimary,775,882,1657
13046,5,State - UTTARAKHAND,Urban,70-74,Preprimary,629,729,1358
13047,5,State - UTTARAKHAND,Urban,75-79,Preprimary,422,445,867
13048,5,State - UTTARAKHAND,Urban,80+,Preprimary,699,563,1262
13049,5,State - UTTARAKHAND,Urban,Age not stated,Preprimary,295,198,493
13050,6,State - HARYANA,Total,All ages,Preprimary,1403012,1070133,2473145
13051,6,State - HARYANA,Total,0-6,Preprimary,0,0,0
13052,6,State - HARYANA,Total,7,Preprimary,212296,173606,385902
13053,6,State - HARYANA,Total,8,Preprimary,250189,200953,451142
13054,6,State - HARYANA,Total,9,Preprimary,221572,172486,394058
13055,6,State - HARYANA,Total,10,Preprimary,216183,162110,378293
13056,6,State - HARYANA,Total,11,Preprimary,111441,82571,194012
13057,6,State - HARYANA,Total,12,Preprimary,61608,46379,107987
13058,6,State - HARYANA,Total,13,Preprimary,27526,22340,49866
13059,6,State - HARYANA,Total,14,Preprimary,16094,13353,29447
13060,6,State - HARYANA,Total,15,Preprimary,11810,9680,21490
13061,6,State - HARYANA,Total,16,Preprimary,9609,7732,17341
13062,6,State - HARYANA,Total,17,Preprimary,7397,5603,13000
13063,6,State - HARYANA,Total,18,Preprimary,10199,6939,17138
13064,6,State - HARYANA,Total,19,Preprimary,7194,4911,12105
13065,6,State - HARYANA,Total,20-24,Preprimary,35867,24605,60472
13066,6,State - HARYANA,Total,25-29,Preprimary,30562,24452,55014
13067,6,State - HARYANA,Total,30-34,Preprimary,27139,24455,51594
13068,6,State - HARYANA,Total,35-39,Preprimary,27450,21718,49168
13069,6,State - HARYANA,Total,40-44,Preprimary,25368,16711,42079
13070,6,State - HARYANA,Total,45-49,Preprimary,20913,12012,32925
13071,6,State - HARYANA,Total,50-54,Preprimary,14508,8633,23141
13072,6,State - HARYANA,Total,55-59,Preprimary,10491,6896,17387
13073,6,State - HARYANA,Total,60-64,Preprimary,15142,8403,23545
13074,6,State - HARYANA,Total,65-69,Preprimary,9773,4640,14413
13075,6,State - HARYANA,Total,70-74,Preprimary,8097,3434,11531
13076,6,State - HARYANA,Total,75-79,Preprimary,5366,1937,7303
13077,6,State - HARYANA,Total,80+,Preprimary,7419,2310,9729
13078,6,State - HARYANA,Total,Age not stated,Preprimary,1799,1264,3063
13079,6,State - HARYANA,Rural,All ages,Preprimary,979683,741819,1721502
13080,6,State - HARYANA,Rural,0-6,Preprimary,0,0,0
13081,6,State - HARYANA,Rural,7,Preprimary,142216,116512,258728
13082,6,State - HARYANA,Rural,8,Preprimary,170158,136961,307119
13083,6,State - HARYANA,Rural,9,Preprimary,150665,117748,268413
13084,6,State - HARYANA,Rural,10,Preprimary,148652,112862,261514
13085,6,State - HARYANA,Rural,11,Preprimary,79090,59200,138290
13086,6,State - HARYANA,Rural,12,Preprimary,43707,33294,77001
13087,6,State - HARYANA,Rural,13,Preprimary,19236,15762,34998
13088,6,State - HARYANA,Rural,14,Preprimary,11211,9688,20899
13089,6,State - HARYANA,Rural,15,Preprimary,8249,7085,15334
13090,6,State - HARYANA,Rural,16,Preprimary,6948,5865,12813
13091,6,State - HARYANA,Rural,17,Preprimary,5310,4265,9575
13092,6,State - HARYANA,Rural,18,Preprimary,7456,5279,12735
13093,6,State - HARYANA,Rural,19,Preprimary,5185,3735,8920
13094,6,State - HARYANA,Rural,20-24,Preprimary,26596,18444,45040
13095,6,State - HARYANA,Rural,25-29,Preprimary,23170,18551,41721
13096,6,State - HARYANA,Rural,30-34,Preprimary,20790,18596,39386
13097,6,State - HARYANA,Rural,35-39,Preprimary,20998,16198,37196
13098,6,State - HARYANA,Rural,40-44,Preprimary,19478,12300,31778
13099,6,State - HARYANA,Rural,45-49,Preprimary,15831,8267,24098
13100,6,State - HARYANA,Rural,50-54,Preprimary,10855,5696,16551
13101,6,State - HARYANA,Rural,55-59,Preprimary,7941,4325,12266
13102,6,State - HARYANA,Rural,60-64,Preprimary,11677,5040,16717
13103,6,State - HARYANA,Rural,65-69,Preprimary,7574,2261,9835
13104,6,State - HARYANA,Rural,70-74,Preprimary,6092,1419,7511
13105,6,State - HARYANA,Rural,75-79,Preprimary,3945,699,4644
13106,6,State - HARYANA,Rural,80+,Preprimary,5334,864,6198
13107,6,State - HARYANA,Rural,Age not stated,Preprimary,1319,903,2222
13108,6,State - HARYANA,Urban,All ages,Preprimary,423329,328314,751643
13109,6,State - HARYANA,Urban,0-6,Preprimary,0,0,0
13110,6,State - HARYANA,Urban,7,Preprimary,70080,57094,127174
13111,6,State - HARYANA,Urban,8,Preprimary,80031,63992,144023
13112,6,State - HARYANA,Urban,9,Preprimary,70907,54738,125645
13113,6,State - HARYANA,Urban,10,Preprimary,67531,49248,116779
13114,6,State - HARYANA,Urban,11,Preprimary,32351,23371,55722
13115,6,State - HARYANA,Urban,12,Preprimary,17901,13085,30986
13116,6,State - HARYANA,Urban,13,Preprimary,8290,6578,14868
13117,6,State - HARYANA,Urban,14,Preprimary,4883,3665,8548
13118,6,State - HARYANA,Urban,15,Preprimary,3561,2595,6156
13119,6,State - HARYANA,Urban,16,Preprimary,2661,1867,4528
13120,6,State - HARYANA,Urban,17,Preprimary,2087,1338,3425
13121,6,State - HARYANA,Urban,18,Preprimary,2743,1660,4403
13122,6,State - HARYANA,Urban,19,Preprimary,2009,1176,3185
13123,6,State - HARYANA,Urban,20-24,Preprimary,9271,6161,15432
13124,6,State - HARYANA,Urban,25-29,Preprimary,7392,5901,13293
13125,6,State - HARYANA,Urban,30-34,Preprimary,6349,5859,12208
13126,6,State - HARYANA,Urban,35-39,Preprimary,6452,5520,11972
13127,6,State - HARYANA,Urban,40-44,Preprimary,5890,4411,10301
13128,6,State - HARYANA,Urban,45-49,Preprimary,5082,3745,8827
13129,6,State - HARYANA,Urban,50-54,Preprimary,3653,2937,6590
13130,6,State - HARYANA,Urban,55-59,Preprimary,2550,2571,5121
13131,6,State - HARYANA,Urban,60-64,Preprimary,3465,3363,6828
13132,6,State - HARYANA,Urban,65-69,Preprimary,2199,2379,4578
13133,6,State - HARYANA,Urban,70-74,Preprimary,2005,2015,4020
13134,6,State - HARYANA,Urban,75-79,Preprimary,1421,1238,2659
13135,6,State - HARYANA,Urban,80+,Preprimary,2085,1446,3531
13136,6,State - HARYANA,Urban,Age not stated,Preprimary,480,361,841
13137,7,State - NCT OF DELHI,Total,All ages,Preprimary,796975,661086,1458061
13138,7,State - NCT OF DELHI,Total,0-6,Preprimary,0,0,0
13139,7,State - NCT OF DELHI,Total,7,Preprimary,128785,111988,240773
13140,7,State - NCT OF DELHI,Total,8,Preprimary,151036,127887,278923
13141,7,State - NCT OF DELHI,Total,9,Preprimary,135099,111519,246618
13142,7,State - NCT OF DELHI,Total,10,Preprimary,132777,104628,237405
13143,7,State - NCT OF DELHI,Total,11,Preprimary,61331,47804,109135
13144,7,State - NCT OF DELHI,Total,12,Preprimary,31575,24418,55993
13145,7,State - NCT OF DELHI,Total,13,Preprimary,13791,11223,25014
13146,7,State - NCT OF DELHI,Total,14,Preprimary,7975,6341,14316
13147,7,State - NCT OF DELHI,Total,15,Preprimary,5733,4134,9867
13148,7,State - NCT OF DELHI,Total,16,Preprimary,4575,3258,7833
13149,7,State - NCT OF DELHI,Total,17,Preprimary,3858,2476,6334
13150,7,State - NCT OF DELHI,Total,18,Preprimary,5739,3185,8924
13151,7,State - NCT OF DELHI,Total,19,Preprimary,3824,2327,6151
13152,7,State - NCT OF DELHI,Total,20-24,Preprimary,18908,12969,31877
13153,7,State - NCT OF DELHI,Total,25-29,Preprimary,15237,13633,28870
13154,7,State - NCT OF DELHI,Total,30-34,Preprimary,13253,13011,26264
13155,7,State - NCT OF DELHI,Total,35-39,Preprimary,13027,12616,25643
13156,7,State - NCT OF DELHI,Total,40-44,Preprimary,11361,10152,21513
13157,7,State - NCT OF DELHI,Total,45-49,Preprimary,10002,8323,18325
13158,7,State - NCT OF DELHI,Total,50-54,Preprimary,7106,5955,13061
13159,7,State - NCT OF DELHI,Total,55-59,Preprimary,4767,5115,9882
13160,7,State - NCT OF DELHI,Total,60-64,Preprimary,6200,6245,12445
13161,7,State - NCT OF DELHI,Total,65-69,Preprimary,3620,3847,7467
13162,7,State - NCT OF DELHI,Total,70-74,Preprimary,2788,3171,5959
13163,7,State - NCT OF DELHI,Total,75-79,Preprimary,1677,1949,3626
13164,7,State - NCT OF DELHI,Total,80+,Preprimary,2134,2263,4397
13165,7,State - NCT OF DELHI,Total,Age not stated,Preprimary,797,649,1446
13166,7,State - NCT OF DELHI,Rural,All ages,Preprimary,22595,17799,40394
13167,7,State - NCT OF DELHI,Rural,0-6,Preprimary,0,0,0
13168,7,State - NCT OF DELHI,Rural,7,Preprimary,3744,3014,6758
13169,7,State - NCT OF DELHI,Rural,8,Preprimary,4281,3465,7746
13170,7,State - NCT OF DELHI,Rural,9,Preprimary,3825,2874,6699
13171,7,State - NCT OF DELHI,Rural,10,Preprimary,3847,2951,6798
13172,7,State - NCT OF DELHI,Rural,11,Preprimary,1778,1269,3047
13173,7,State - NCT OF DELHI,Rural,12,Preprimary,999,767,1766
13174,7,State - NCT OF DELHI,Rural,13,Preprimary,453,339,792
13175,7,State - NCT OF DELHI,Rural,14,Preprimary,234,201,435
13176,7,State - NCT OF DELHI,Rural,15,Preprimary,164,118,282
13177,7,State - NCT OF DELHI,Rural,16,Preprimary,125,129,254
13178,7,State - NCT OF DELHI,Rural,17,Preprimary,87,65,152
13179,7,State - NCT OF DELHI,Rural,18,Preprimary,180,116,296
13180,7,State - NCT OF DELHI,Rural,19,Preprimary,117,57,174
13181,7,State - NCT OF DELHI,Rural,20-24,Preprimary,483,374,857
13182,7,State - NCT OF DELHI,Rural,25-29,Preprimary,357,332,689
13183,7,State - NCT OF DELHI,Rural,30-34,Preprimary,326,316,642
13184,7,State - NCT OF DELHI,Rural,35-39,Preprimary,326,343,669
13185,7,State - NCT OF DELHI,Rural,40-44,Preprimary,300,282,582
13186,7,State - NCT OF DELHI,Rural,45-49,Preprimary,224,225,449
13187,7,State - NCT OF DELHI,Rural,50-54,Preprimary,178,145,323
13188,7,State - NCT OF DELHI,Rural,55-59,Preprimary,111,113,224
13189,7,State - NCT OF DELHI,Rural,60-64,Preprimary,170,148,318
13190,7,State - NCT OF DELHI,Rural,65-69,Preprimary,80,70,150
13191,7,State - NCT OF DELHI,Rural,70-74,Preprimary,67,30,97
13192,7,State - NCT OF DELHI,Rural,75-79,Preprimary,47,12,59
13193,7,State - NCT OF DELHI,Rural,80+,Preprimary,61,12,73
13194,7,State - NCT OF DELHI,Rural,Age not stated,Preprimary,31,32,63
13195,7,State - NCT OF DELHI,Urban,All ages,Preprimary,774380,643287,1417667
13196,7,State - NCT OF DELHI,Urban,0-6,Preprimary,0,0,0
13197,7,State - NCT OF DELHI,Urban,7,Preprimary,125041,108974,234015
13198,7,State - NCT OF DELHI,Urban,8,Preprimary,146755,124422,271177
13199,7,State - NCT OF DELHI,Urban,9,Preprimary,131274,108645,239919
13200,7,State - NCT OF DELHI,Urban,10,Preprimary,128930,101677,230607
13201,7,State - NCT OF DELHI,Urban,11,Preprimary,59553,46535,106088
13202,7,State - NCT OF DELHI,Urban,12,Preprimary,30576,23651,54227
13203,7,State - NCT OF DELHI,Urban,13,Preprimary,13338,10884,24222
13204,7,State - NCT OF DELHI,Urban,14,Preprimary,7741,6140,13881
13205,7,State - NCT OF DELHI,Urban,15,Preprimary,5569,4016,9585
13206,7,State - NCT OF DELHI,Urban,16,Preprimary,4450,3129,7579
13207,7,State - NCT OF DELHI,Urban,17,Preprimary,3771,2411,6182
13208,7,State - NCT OF DELHI,Urban,18,Preprimary,5559,3069,8628
13209,7,State - NCT OF DELHI,Urban,19,Preprimary,3707,2270,5977
13210,7,State - NCT OF DELHI,Urban,20-24,Preprimary,18425,12595,31020
13211,7,State - NCT OF DELHI,Urban,25-29,Preprimary,14880,13301,28181
13212,7,State - NCT OF DELHI,Urban,30-34,Preprimary,12927,12695,25622
13213,7,State - NCT OF DELHI,Urban,35-39,Preprimary,12701,12273,24974
13214,7,State - NCT OF DELHI,Urban,40-44,Preprimary,11061,9870,20931
13215,7,State - NCT OF DELHI,Urban,45-49,Preprimary,9778,8098,17876
13216,7,State - NCT OF DELHI,Urban,50-54,Preprimary,6928,5810,12738
13217,7,State - NCT OF DELHI,Urban,55-59,Preprimary,4656,5002,9658
13218,7,State - NCT OF DELHI,Urban,60-64,Preprimary,6030,6097,12127
13219,7,State - NCT OF DELHI,Urban,65-69,Preprimary,3540,3777,7317
13220,7,State - NCT OF DELHI,Urban,70-74,Preprimary,2721,3141,5862
13221,7,State - NCT OF DELHI,Urban,75-79,Preprimary,1630,1937,3567
13222,7,State - NCT OF DELHI,Urban,80+,Preprimary,2073,2251,4324
13223,7,State - NCT OF DELHI,Urban,Age not stated,Preprimary,766,617,1383
13224,8,State - RAJASTHAN,Total,All ages,Preprimary,4423518,3660309,8083827
13225,8,State - RAJASTHAN,Total,0-6,Preprimary,0,0,0
13226,8,State - RAJASTHAN,Total,7,Preprimary,562425,470365,1032790
13227,8,State - RAJASTHAN,Total,8,Preprimary,784758,654588,1439346
13228,8,State - RAJASTHAN,Total,9,Preprimary,570046,480989,1051035
13229,8,State - RAJASTHAN,Total,10,Preprimary,616794,520569,1137363
13230,8,State - RAJASTHAN,Total,11,Preprimary,285010,251505,536515
13231,8,State - RAJASTHAN,Total,12,Preprimary,191055,177576,368631
13232,8,State - RAJASTHAN,Total,13,Preprimary,83324,89789,173113
13233,8,State - RAJASTHAN,Total,14,Preprimary,52697,63243,115940
13234,8,State - RAJASTHAN,Total,15,Preprimary,43667,53173,96840
13235,8,State - RAJASTHAN,Total,16,Preprimary,35227,45435,80662
13236,8,State - RAJASTHAN,Total,17,Preprimary,24277,30427,54704
13237,8,State - RAJASTHAN,Total,18,Preprimary,41205,46372,87577
13238,8,State - RAJASTHAN,Total,19,Preprimary,23224,27673,50897
13239,8,State - RAJASTHAN,Total,20-24,Preprimary,151291,150316,301607
13240,8,State - RAJASTHAN,Total,25-29,Preprimary,135192,127185,262377
13241,8,State - RAJASTHAN,Total,30-34,Preprimary,126799,112314,239113
13242,8,State - RAJASTHAN,Total,35-39,Preprimary,122582,91691,214273
13243,8,State - RAJASTHAN,Total,40-44,Preprimary,115146,69148,184294
13244,8,State - RAJASTHAN,Total,45-49,Preprimary,104437,52632,157069
13245,8,State - RAJASTHAN,Total,50-54,Preprimary,90051,37476,127527
13246,8,State - RAJASTHAN,Total,55-59,Preprimary,64323,28504,92827
13247,8,State - RAJASTHAN,Total,60-64,Preprimary,63376,24003,87379
13248,8,State - RAJASTHAN,Total,65-69,Preprimary,45610,17004,62614
13249,8,State - RAJASTHAN,Total,70-74,Preprimary,37225,11480,48705
13250,8,State - RAJASTHAN,Total,75-79,Preprimary,18129,6450,24579
13251,8,State - RAJASTHAN,Total,80+,Preprimary,19959,7133,27092
13252,8,State - RAJASTHAN,Total,Age not stated,Preprimary,15689,13269,28958
13253,8,State - RAJASTHAN,Rural,All ages,Preprimary,3506792,2844029,6350821
13254,8,State - RAJASTHAN,Rural,0-6,Preprimary,0,0,0
13255,8,State - RAJASTHAN,Rural,7,Preprimary,431352,358114,789466
13256,8,State - RAJASTHAN,Rural,8,Preprimary,616991,513915,1130906
13257,8,State - RAJASTHAN,Rural,9,Preprimary,443070,376337,819407
13258,8,State - RAJASTHAN,Rural,10,Preprimary,489901,418937,908838
13259,8,State - RAJASTHAN,Rural,11,Preprimary,226491,203059,429550
13260,8,State - RAJASTHAN,Rural,12,Preprimary,152835,146038,298873
13261,8,State - RAJASTHAN,Rural,13,Preprimary,65397,73505,138902
13262,8,State - RAJASTHAN,Rural,14,Preprimary,41586,52785,94371
13263,8,State - RAJASTHAN,Rural,15,Preprimary,34366,44787,79153
13264,8,State - RAJASTHAN,Rural,16,Preprimary,27969,38355,66324
13265,8,State - RAJASTHAN,Rural,17,Preprimary,18725,24971,43696
13266,8,State - RAJASTHAN,Rural,18,Preprimary,32717,38454,71171
13267,8,State - RAJASTHAN,Rural,19,Preprimary,17914,22331,40245
13268,8,State - RAJASTHAN,Rural,20-24,Preprimary,121838,120189,242027
13269,8,State - RAJASTHAN,Rural,25-29,Preprimary,111904,99055,210959
13270,8,State - RAJASTHAN,Rural,30-34,Preprimary,105347,85048,190395
13271,8,State - RAJASTHAN,Rural,35-39,Preprimary,101068,66312,167380
13272,8,State - RAJASTHAN,Rural,40-44,Preprimary,95057,47666,142723
13273,8,State - RAJASTHAN,Rural,45-49,Preprimary,85716,33729,119445
13274,8,State - RAJASTHAN,Rural,50-54,Preprimary,73841,22415,96256
13275,8,State - RAJASTHAN,Rural,55-59,Preprimary,52684,16052,68736
13276,8,State - RAJASTHAN,Rural,60-64,Preprimary,52108,12732,64840
13277,8,State - RAJASTHAN,Rural,65-69,Preprimary,37097,8140,45237
13278,8,State - RAJASTHAN,Rural,70-74,Preprimary,29587,4816,34403
13279,8,State - RAJASTHAN,Rural,75-79,Preprimary,13650,2419,16069
13280,8,State - RAJASTHAN,Rural,80+,Preprimary,14479,2888,17367
13281,8,State - RAJASTHAN,Rural,Age not stated,Preprimary,13102,10980,24082
13282,8,State - RAJASTHAN,Urban,All ages,Preprimary,916726,816280,1733006
13283,8,State - RAJASTHAN,Urban,0-6,Preprimary,0,0,0
13284,8,State - RAJASTHAN,Urban,7,Preprimary,131073,112251,243324
13285,8,State - RAJASTHAN,Urban,8,Preprimary,167767,140673,308440
13286,8,State - RAJASTHAN,Urban,9,Preprimary,126976,104652,231628
13287,8,State - RAJASTHAN,Urban,10,Preprimary,126893,101632,228525
13288,8,State - RAJASTHAN,Urban,11,Preprimary,58519,48446,106965
13289,8,State - RAJASTHAN,Urban,12,Preprimary,38220,31538,69758
13290,8,State - RAJASTHAN,Urban,13,Preprimary,17927,16284,34211
13291,8,State - RAJASTHAN,Urban,14,Preprimary,11111,10458,21569
13292,8,State - RAJASTHAN,Urban,15,Preprimary,9301,8386,17687
13293,8,State - RAJASTHAN,Urban,16,Preprimary,7258,7080,14338
13294,8,State - RAJASTHAN,Urban,17,Preprimary,5552,5456,11008
13295,8,State - RAJASTHAN,Urban,18,Preprimary,8488,7918,16406
13296,8,State - RAJASTHAN,Urban,19,Preprimary,5310,5342,10652
13297,8,State - RAJASTHAN,Urban,20-24,Preprimary,29453,30127,59580
13298,8,State - RAJASTHAN,Urban,25-29,Preprimary,23288,28130,51418
13299,8,State - RAJASTHAN,Urban,30-34,Preprimary,21452,27266,48718
13300,8,State - RAJASTHAN,Urban,35-39,Preprimary,21514,25379,46893
13301,8,State - RAJASTHAN,Urban,40-44,Preprimary,20089,21482,41571
13302,8,State - RAJASTHAN,Urban,45-49,Preprimary,18721,18903,37624
13303,8,State - RAJASTHAN,Urban,50-54,Preprimary,16210,15061,31271
13304,8,State - RAJASTHAN,Urban,55-59,Preprimary,11639,12452,24091
13305,8,State - RAJASTHAN,Urban,60-64,Preprimary,11268,11271,22539
13306,8,State - RAJASTHAN,Urban,65-69,Preprimary,8513,8864,17377
13307,8,State - RAJASTHAN,Urban,70-74,Preprimary,7638,6664,14302
13308,8,State - RAJASTHAN,Urban,75-79,Preprimary,4479,4031,8510
13309,8,State - RAJASTHAN,Urban,80+,Preprimary,5480,4245,9725
13310,8,State - RAJASTHAN,Urban,Age not stated,Preprimary,2587,2289,4876
13311,9,State - UTTAR PRADESH,Total,All ages,Preprimary,11763367,9661113,21424480
13312,9,State - UTTAR PRADESH,Total,0-6,Preprimary,0,0,0
13313,9,State - UTTAR PRADESH,Total,7,Preprimary,1712411,1495543,3207954
13314,9,State - UTTAR PRADESH,Total,8,Preprimary,2321397,2010755,4332152
13315,9,State - UTTAR PRADESH,Total,9,Preprimary,1662183,1447833,3110016
13316,9,State - UTTAR PRADESH,Total,10,Preprimary,2000350,1668261,3668611
13317,9,State - UTTAR PRADESH,Total,11,Preprimary,934369,773920,1708289
13318,9,State - UTTAR PRADESH,Total,12,Preprimary,692399,561238,1253637
13319,9,State - UTTAR PRADESH,Total,13,Preprimary,306329,255206,561535
13320,9,State - UTTAR PRADESH,Total,14,Preprimary,198746,164119,362865
13321,9,State - UTTAR PRADESH,Total,15,Preprimary,141362,110565,251927
13322,9,State - UTTAR PRADESH,Total,16,Preprimary,101261,81948,183209
13323,9,State - UTTAR PRADESH,Total,17,Preprimary,63626,49804,113430
13324,9,State - UTTAR PRADESH,Total,18,Preprimary,90937,63472,154409
13325,9,State - UTTAR PRADESH,Total,19,Preprimary,50897,37134,88031
13326,9,State - UTTAR PRADESH,Total,20-24,Preprimary,244205,173587,417792
13327,9,State - UTTAR PRADESH,Total,25-29,Preprimary,170627,132375,303002
13328,9,State - UTTAR PRADESH,Total,30-34,Preprimary,152495,121658,274153
13329,9,State - UTTAR PRADESH,Total,35-39,Preprimary,150056,105546,255602
13330,9,State - UTTAR PRADESH,Total,40-44,Preprimary,125349,77482,202831
13331,9,State - UTTAR PRADESH,Total,45-49,Preprimary,103179,61465,164644
13332,9,State - UTTAR PRADESH,Total,50-54,Preprimary,86393,44610,131003
13333,9,State - UTTAR PRADESH,Total,55-59,Preprimary,66756,40138,106894
13334,9,State - UTTAR PRADESH,Total,60-64,Preprimary,94304,40984,135288
13335,9,State - UTTAR PRADESH,Total,65-69,Preprimary,68283,26473,94756
13336,9,State - UTTAR PRADESH,Total,70-74,Preprimary,58469,18480,76949
13337,9,State - UTTAR PRADESH,Total,75-79,Preprimary,28497,9230,37727
13338,9,State - UTTAR PRADESH,Total,80+,Preprimary,48246,15928,64174
13339,9,State - UTTAR PRADESH,Total,Age not stated,Preprimary,90241,73359,163600
13340,9,State - UTTAR PRADESH,Rural,All ages,Preprimary,9646918,7931689,17578607
13341,9,State - UTTAR PRADESH,Rural,0-6,Preprimary,0,0,0
13342,9,State - UTTAR PRADESH,Rural,7,Preprimary,1390966,1216576,2607542
13343,9,State - UTTAR PRADESH,Rural,8,Preprimary,1920052,1669358,3589410
13344,9,State - UTTAR PRADESH,Rural,9,Preprimary,1368484,1200011,2568495
13345,9,State - UTTAR PRADESH,Rural,10,Preprimary,1676714,1408674,3085388
13346,9,State - UTTAR PRADESH,Rural,11,Preprimary,770535,644398,1414933
13347,9,State - UTTAR PRADESH,Rural,12,Preprimary,575188,469543,1044731
13348,9,State - UTTAR PRADESH,Rural,13,Preprimary,250099,210001,460100
13349,9,State - UTTAR PRADESH,Rural,14,Preprimary,159629,133711,293340
13350,9,State - UTTAR PRADESH,Rural,15,Preprimary,113340,90003,203343
13351,9,State - UTTAR PRADESH,Rural,16,Preprimary,79033,65663,144696
13352,9,State - UTTAR PRADESH,Rural,17,Preprimary,47951,38844,86795
13353,9,State - UTTAR PRADESH,Rural,18,Preprimary,69458,50119,119577
13354,9,State - UTTAR PRADESH,Rural,19,Preprimary,37515,28750,66265
13355,9,State - UTTAR PRADESH,Rural,20-24,Preprimary,184574,135321,319895
13356,9,State - UTTAR PRADESH,Rural,25-29,Preprimary,133147,103348,236495
13357,9,State - UTTAR PRADESH,Rural,30-34,Preprimary,122160,94969,217129
13358,9,State - UTTAR PRADESH,Rural,35-39,Preprimary,120589,79889,200478
13359,9,State - UTTAR PRADESH,Rural,40-44,Preprimary,100019,56613,156632
13360,9,State - UTTAR PRADESH,Rural,45-49,Preprimary,81826,43628,125454
13361,9,State - UTTAR PRADESH,Rural,50-54,Preprimary,69517,31235,100752
13362,9,State - UTTAR PRADESH,Rural,55-59,Preprimary,54463,28393,82856
13363,9,State - UTTAR PRADESH,Rural,60-64,Preprimary,79327,29239,108566
13364,9,State - UTTAR PRADESH,Rural,65-69,Preprimary,58310,18240,76550
13365,9,State - UTTAR PRADESH,Rural,70-74,Preprimary,50056,12343,62399
13366,9,State - UTTAR PRADESH,Rural,75-79,Preprimary,24116,5782,29898
13367,9,State - UTTAR PRADESH,Rural,80+,Preprimary,40494,10651,51145
13368,9,State - UTTAR PRADESH,Rural,Age not stated,Preprimary,69356,56387,125743
13369,9,State - UTTAR PRADESH,Urban,All ages,Preprimary,2116449,1729424,3845873
13370,9,State - UTTAR PRADESH,Urban,0-6,Preprimary,0,0,0
13371,9,State - UTTAR PRADESH,Urban,7,Preprimary,321445,278967,600412
13372,9,State - UTTAR PRADESH,Urban,8,Preprimary,401345,341397,742742
13373,9,State - UTTAR PRADESH,Urban,9,Preprimary,293699,247822,541521
13374,9,State - UTTAR PRADESH,Urban,10,Preprimary,323636,259587,583223
13375,9,State - UTTAR PRADESH,Urban,11,Preprimary,163834,129522,293356
13376,9,State - UTTAR PRADESH,Urban,12,Preprimary,117211,91695,208906
13377,9,State - UTTAR PRADESH,Urban,13,Preprimary,56230,45205,101435
13378,9,State - UTTAR PRADESH,Urban,14,Preprimary,39117,30408,69525
13379,9,State - UTTAR PRADESH,Urban,15,Preprimary,28022,20562,48584
13380,9,State - UTTAR PRADESH,Urban,16,Preprimary,22228,16285,38513
13381,9,State - UTTAR PRADESH,Urban,17,Preprimary,15675,10960,26635
13382,9,State - UTTAR PRADESH,Urban,18,Preprimary,21479,13353,34832
13383,9,State - UTTAR PRADESH,Urban,19,Preprimary,13382,8384,21766
13384,9,State - UTTAR PRADESH,Urban,20-24,Preprimary,59631,38266,97897
13385,9,State - UTTAR PRADESH,Urban,25-29,Preprimary,37480,29027,66507
13386,9,State - UTTAR PRADESH,Urban,30-34,Preprimary,30335,26689,57024
13387,9,State - UTTAR PRADESH,Urban,35-39,Preprimary,29467,25657,55124
13388,9,State - UTTAR PRADESH,Urban,40-44,Preprimary,25330,20869,46199
13389,9,State - UTTAR PRADESH,Urban,45-49,Preprimary,21353,17837,39190
13390,9,State - UTTAR PRADESH,Urban,50-54,Preprimary,16876,13375,30251
13391,9,State - UTTAR PRADESH,Urban,55-59,Preprimary,12293,11745,24038
13392,9,State - UTTAR PRADESH,Urban,60-64,Preprimary,14977,11745,26722
13393,9,State - UTTAR PRADESH,Urban,65-69,Preprimary,9973,8233,18206
13394,9,State - UTTAR PRADESH,Urban,70-74,Preprimary,8413,6137,14550
13395,9,State - UTTAR PRADESH,Urban,75-79,Preprimary,4381,3448,7829
13396,9,State - UTTAR PRADESH,Urban,80+,Preprimary,7752,5277,13029
13397,9,State - UTTAR PRADESH,Urban,Age not stated,Preprimary,20885,16972,37857
13398,10,State - BIHAR,Total,All ages,Preprimary,7308358,6393622,13701980
13399,10,State - BIHAR,Total,0-6,Preprimary,0,0,0
13400,10,State - BIHAR,Total,7,Preprimary,872861,777132,1649993
13401,10,State - BIHAR,Total,8,Preprimary,1356394,1201603,2557997
13402,10,State - BIHAR,Total,9,Preprimary,908564,810795,1719359
13403,10,State - BIHAR,Total,10,Preprimary,1224043,1068988,2293031
13404,10,State - BIHAR,Total,11,Preprimary,525739,469236,994975
13405,10,State - BIHAR,Total,12,Preprimary,428004,387077,815081
13406,10,State - BIHAR,Total,13,Preprimary,177219,166507,343726
13407,10,State - BIHAR,Total,14,Preprimary,114755,105741,220496
13408,10,State - BIHAR,Total,15,Preprimary,95951,76141,172092
13409,10,State - BIHAR,Total,16,Preprimary,74319,55776,130095
13410,10,State - BIHAR,Total,17,Preprimary,44107,31694,75801
13411,10,State - BIHAR,Total,18,Preprimary,77804,52053,129857
13412,10,State - BIHAR,Total,19,Preprimary,40223,35362,75585
13413,10,State - BIHAR,Total,20-24,Preprimary,229697,213802,443499
13414,10,State - BIHAR,Total,25-29,Preprimary,201817,211079,412896
13415,10,State - BIHAR,Total,30-34,Preprimary,180809,188350,369159
13416,10,State - BIHAR,Total,35-39,Preprimary,159864,148170,308034
13417,10,State - BIHAR,Total,40-44,Preprimary,125184,101163,226347
13418,10,State - BIHAR,Total,45-49,Preprimary,99078,76641,175719
13419,10,State - BIHAR,Total,50-54,Preprimary,80557,51837,132394
13420,10,State - BIHAR,Total,55-59,Preprimary,58685,45839,104524
13421,10,State - BIHAR,Total,60-64,Preprimary,76763,43718,120481
13422,10,State - BIHAR,Total,65-69,Preprimary,56801,26124,82925
13423,10,State - BIHAR,Total,70-74,Preprimary,39899,14291,54190
13424,10,State - BIHAR,Total,75-79,Preprimary,16494,6417,22911
13425,10,State - BIHAR,Total,80+,Preprimary,20695,9383,30078
13426,10,State - BIHAR,Total,Age not stated,Preprimary,22032,18703,40735
13427,10,State - BIHAR,Rural,All ages,Preprimary,6611758,5759159,12370917
13428,10,State - BIHAR,Rural,0-6,Preprimary,0,0,0
13429,10,State - BIHAR,Rural,7,Preprimary,780419,694709,1475128
13430,10,State - BIHAR,Rural,8,Preprimary,1224082,1084712,2308794
13431,10,State - BIHAR,Rural,9,Preprimary,819866,732700,1552566
13432,10,State - BIHAR,Rural,10,Preprimary,1112893,972628,2085521
13433,10,State - BIHAR,Rural,11,Preprimary,475074,425147,900221
13434,10,State - BIHAR,Rural,12,Preprimary,388578,352791,741369
13435,10,State - BIHAR,Rural,13,Preprimary,160986,151816,312802
13436,10,State - BIHAR,Rural,14,Preprimary,104224,96604,200828
13437,10,State - BIHAR,Rural,15,Preprimary,87648,69706,157354
13438,10,State - BIHAR,Rural,16,Preprimary,67619,50544,118163
13439,10,State - BIHAR,Rural,17,Preprimary,39710,28575,68285
13440,10,State - BIHAR,Rural,18,Preprimary,70241,46774,117015
13441,10,State - BIHAR,Rural,19,Preprimary,36263,32140,68403
13442,10,State - BIHAR,Rural,20-24,Preprimary,208113,194383,402496
13443,10,State - BIHAR,Rural,25-29,Preprimary,185017,190980,375997
13444,10,State - BIHAR,Rural,30-34,Preprimary,165651,169526,335177
13445,10,State - BIHAR,Rural,35-39,Preprimary,145599,131411,277010
13446,10,State - BIHAR,Rural,40-44,Preprimary,113210,88242,201452
13447,10,State - BIHAR,Rural,45-49,Preprimary,89407,65604,155011
13448,10,State - BIHAR,Rural,50-54,Preprimary,72707,43459,116166
13449,10,State - BIHAR,Rural,55-59,Preprimary,53103,38543,91646
13450,10,State - BIHAR,Rural,60-64,Preprimary,69989,36383,106372
13451,10,State - BIHAR,Rural,65-69,Preprimary,51829,21336,73165
13452,10,State - BIHAR,Rural,70-74,Preprimary,36254,11353,47607
13453,10,State - BIHAR,Rural,75-79,Preprimary,14888,4922,19810
13454,10,State - BIHAR,Rural,80+,Preprimary,18664,7544,26208
13455,10,State - BIHAR,Rural,Age not stated,Preprimary,19724,16627,36351
13456,10,State - BIHAR,Urban,All ages,Preprimary,696600,634463,1331063
13457,10,State - BIHAR,Urban,0-6,Preprimary,0,0,0
13458,10,State - BIHAR,Urban,7,Preprimary,92442,82423,174865
13459,10,State - BIHAR,Urban,8,Preprimary,132312,116891,249203
13460,10,State - BIHAR,Urban,9,Preprimary,88698,78095,166793
13461,10,State - BIHAR,Urban,10,Preprimary,111150,96360,207510
13462,10,State - BIHAR,Urban,11,Preprimary,50665,44089,94754
13463,10,State - BIHAR,Urban,12,Preprimary,39426,34286,73712
13464,10,State - BIHAR,Urban,13,Preprimary,16233,14691,30924
13465,10,State - BIHAR,Urban,14,Preprimary,10531,9137,19668
13466,10,State - BIHAR,Urban,15,Preprimary,8303,6435,14738
13467,10,State - BIHAR,Urban,16,Preprimary,6700,5232,11932
13468,10,State - BIHAR,Urban,17,Preprimary,4397,3119,7516
13469,10,State - BIHAR,Urban,18,Preprimary,7563,5279,12842
13470,10,State - BIHAR,Urban,19,Preprimary,3960,3222,7182
13471,10,State - BIHAR,Urban,20-24,Preprimary,21584,19419,41003
13472,10,State - BIHAR,Urban,25-29,Preprimary,16800,20099,36899
13473,10,State - BIHAR,Urban,30-34,Preprimary,15158,18824,33982
13474,10,State - BIHAR,Urban,35-39,Preprimary,14265,16759,31024
13475,10,State - BIHAR,Urban,40-44,Preprimary,11974,12921,24895
13476,10,State - BIHAR,Urban,45-49,Preprimary,9671,11037,20708
13477,10,State - BIHAR,Urban,50-54,Preprimary,7850,8378,16228
13478,10,State - BIHAR,Urban,55-59,Preprimary,5582,7296,12878
13479,10,State - BIHAR,Urban,60-64,Preprimary,6774,7335,14109
13480,10,State - BIHAR,Urban,65-69,Preprimary,4972,4788,9760
13481,10,State - BIHAR,Urban,70-74,Preprimary,3645,2938,6583
13482,10,State - BIHAR,Urban,75-79,Preprimary,1606,1495,3101
13483,10,State - BIHAR,Urban,80+,Preprimary,2031,1839,3870
13484,10,State - BIHAR,Urban,Age not stated,Preprimary,2308,2076,4384
13485,11,State - SIKKIM,Total,All ages,Preprimary,66658,49442,116100
13486,11,State - SIKKIM,Total,0-6,Preprimary,0,0,0
13487,11,State - SIKKIM,Total,7,Preprimary,4521,4450,8971
13488,11,State - SIKKIM,Total,8,Preprimary,4839,4888,9727
13489,11,State - SIKKIM,Total,9,Preprimary,4830,4714,9544
13490,11,State - SIKKIM,Total,10,Preprimary,4480,4102,8582
13491,11,State - SIKKIM,Total,11,Preprimary,3286,2874,6160
13492,11,State - SIKKIM,Total,12,Preprimary,2508,1918,4426
13493,11,State - SIKKIM,Total,13,Preprimary,1771,1331,3102
13494,11,State - SIKKIM,Total,14,Preprimary,1333,939,2272
13495,11,State - SIKKIM,Total,15,Preprimary,1096,698,1794
13496,11,State - SIKKIM,Total,16,Preprimary,993,676,1669
13497,11,State - SIKKIM,Total,17,Preprimary,992,638,1630
13498,11,State - SIKKIM,Total,18,Preprimary,1186,704,1890
13499,11,State - SIKKIM,Total,19,Preprimary,1051,698,1749
13500,11,State - SIKKIM,Total,20-24,Preprimary,5541,3886,9427
13501,11,State - SIKKIM,Total,25-29,Preprimary,4672,3725,8397
13502,11,State - SIKKIM,Total,30-34,Preprimary,4032,3277,7309
13503,11,State - SIKKIM,Total,35-39,Preprimary,3471,2914,6385
13504,11,State - SIKKIM,Total,40-44,Preprimary,2998,2177,5175
13505,11,State - SIKKIM,Total,45-49,Preprimary,2868,1650,4518
13506,11,State - SIKKIM,Total,50-54,Preprimary,2842,1144,3986
13507,11,State - SIKKIM,Total,55-59,Preprimary,2181,722,2903
13508,11,State - SIKKIM,Total,60-64,Preprimary,1763,520,2283
13509,11,State - SIKKIM,Total,65-69,Preprimary,1346,336,1682
13510,11,State - SIKKIM,Total,70-74,Preprimary,958,181,1139
13511,11,State - SIKKIM,Total,75-79,Preprimary,517,87,604
13512,11,State - SIKKIM,Total,80+,Preprimary,456,92,548
13513,11,State - SIKKIM,Total,Age not stated,Preprimary,127,101,228
13514,11,State - SIKKIM,Rural,All ages,Preprimary,56198,40135,96333
13515,11,State - SIKKIM,Rural,0-6,Preprimary,0,0,0
13516,11,State - SIKKIM,Rural,7,Preprimary,3487,3452,6939
13517,11,State - SIKKIM,Rural,8,Preprimary,3695,3768,7463
13518,11,State - SIKKIM,Rural,9,Preprimary,3834,3725,7559
13519,11,State - SIKKIM,Rural,10,Preprimary,3617,3350,6967
13520,11,State - SIKKIM,Rural,11,Preprimary,2784,2365,5149
13521,11,State - SIKKIM,Rural,12,Preprimary,2167,1612,3779
13522,11,State - SIKKIM,Rural,13,Preprimary,1535,1092,2627
13523,11,State - SIKKIM,Rural,14,Preprimary,1164,787,1951
13524,11,State - SIKKIM,Rural,15,Preprimary,934,544,1478
13525,11,State - SIKKIM,Rural,16,Preprimary,870,530,1400
13526,11,State - SIKKIM,Rural,17,Preprimary,857,507,1364
13527,11,State - SIKKIM,Rural,18,Preprimary,1011,579,1590
13528,11,State - SIKKIM,Rural,19,Preprimary,918,583,1501
13529,11,State - SIKKIM,Rural,20-24,Preprimary,4856,3291,8147
13530,11,State - SIKKIM,Rural,25-29,Preprimary,4060,3187,7247
13531,11,State - SIKKIM,Rural,30-34,Preprimary,3513,2791,6304
13532,11,State - SIKKIM,Rural,35-39,Preprimary,2963,2441,5404
13533,11,State - SIKKIM,Rural,40-44,Preprimary,2541,1785,4326
13534,11,State - SIKKIM,Rural,45-49,Preprimary,2456,1322,3778
13535,11,State - SIKKIM,Rural,50-54,Preprimary,2480,915,3395
13536,11,State - SIKKIM,Rural,55-59,Preprimary,1904,550,2454
13537,11,State - SIKKIM,Rural,60-64,Preprimary,1567,392,1959
13538,11,State - SIKKIM,Rural,65-69,Preprimary,1194,242,1436
13539,11,State - SIKKIM,Rural,70-74,Preprimary,839,125,964
13540,11,State - SIKKIM,Rural,75-79,Preprimary,465,53,518
13541,11,State - SIKKIM,Rural,80+,Preprimary,371,56,427
13542,11,State - SIKKIM,Rural,Age not stated,Preprimary,116,91,207
13543,11,State - SIKKIM,Urban,All ages,Preprimary,10460,9307,19767
13544,11,State - SIKKIM,Urban,0-6,Preprimary,0,0,0
13545,11,State - SIKKIM,Urban,7,Preprimary,1034,998,2032
13546,11,State - SIKKIM,Urban,8,Preprimary,1144,1120,2264
13547,11,State - SIKKIM,Urban,9,Preprimary,996,989,1985
13548,11,State - SIKKIM,Urban,10,Preprimary,863,752,1615
13549,11,State - SIKKIM,Urban,11,Preprimary,502,509,1011
13550,11,State - SIKKIM,Urban,12,Preprimary,341,306,647
13551,11,State - SIKKIM,Urban,13,Preprimary,236,239,475
13552,11,State - SIKKIM,Urban,14,Preprimary,169,152,321
13553,11,State - SIKKIM,Urban,15,Preprimary,162,154,316
13554,11,State - SIKKIM,Urban,16,Preprimary,123,146,269
13555,11,State - SIKKIM,Urban,17,Preprimary,135,131,266
13556,11,State - SIKKIM,Urban,18,Preprimary,175,125,300
13557,11,State - SIKKIM,Urban,19,Preprimary,133,115,248
13558,11,State - SIKKIM,Urban,20-24,Preprimary,685,595,1280
13559,11,State - SIKKIM,Urban,25-29,Preprimary,612,538,1150
13560,11,State - SIKKIM,Urban,30-34,Preprimary,519,486,1005
13561,11,State - SIKKIM,Urban,35-39,Preprimary,508,473,981
13562,11,State - SIKKIM,Urban,40-44,Preprimary,457,392,849
13563,11,State - SIKKIM,Urban,45-49,Preprimary,412,328,740
13564,11,State - SIKKIM,Urban,50-54,Preprimary,362,229,591
13565,11,State - SIKKIM,Urban,55-59,Preprimary,277,172,449
13566,11,State - SIKKIM,Urban,60-64,Preprimary,196,128,324
13567,11,State - SIKKIM,Urban,65-69,Preprimary,152,94,246
13568,11,State - SIKKIM,Urban,70-74,Preprimary,119,56,175
13569,11,State - SIKKIM,Urban,75-79,Preprimary,52,34,86
13570,11,State - SIKKIM,Urban,80+,Preprimary,85,36,121
13571,11,State - SIKKIM,Urban,Age not stated,Preprimary,11,10,21
13572,12,State - ARUNACHAL PRADESH,Total,All ages,Preprimary,88788,76188,164976
13573,12,State - ARUNACHAL PRADESH,Total,0-6,Preprimary,0,0,0
13574,12,State - ARUNACHAL PRADESH,Total,7,Preprimary,9369,8886,18255
13575,12,State - ARUNACHAL PRADESH,Total,8,Preprimary,12254,11277,23531
13576,12,State - ARUNACHAL PRADESH,Total,9,Preprimary,10340,9587,19927
13577,12,State - ARUNACHAL PRADESH,Total,10,Preprimary,11096,10270,21366
13578,12,State - ARUNACHAL PRADESH,Total,11,Preprimary,6997,6307,13304
13579,12,State - ARUNACHAL PRADESH,Total,12,Preprimary,5530,5114,10644
13580,12,State - ARUNACHAL PRADESH,Total,13,Preprimary,3105,2782,5887
13581,12,State - ARUNACHAL PRADESH,Total,14,Preprimary,2223,1991,4214
13582,12,State - ARUNACHAL PRADESH,Total,15,Preprimary,1528,1410,2938
13583,12,State - ARUNACHAL PRADESH,Total,16,Preprimary,1188,1049,2237
13584,12,State - ARUNACHAL PRADESH,Total,17,Preprimary,840,656,1496
13585,12,State - ARUNACHAL PRADESH,Total,18,Preprimary,1080,850,1930
13586,12,State - ARUNACHAL PRADESH,Total,19,Preprimary,725,621,1346
13587,12,State - ARUNACHAL PRADESH,Total,20-24,Preprimary,3534,3213,6747
13588,12,State - ARUNACHAL PRADESH,Total,25-29,Preprimary,3312,2978,6290
13589,12,State - ARUNACHAL PRADESH,Total,30-34,Preprimary,2764,2519,5283
13590,12,State - ARUNACHAL PRADESH,Total,35-39,Preprimary,2816,2304,5120
13591,12,State - ARUNACHAL PRADESH,Total,40-44,Preprimary,2438,1581,4019
13592,12,State - ARUNACHAL PRADESH,Total,45-49,Preprimary,2243,1158,3401
13593,12,State - ARUNACHAL PRADESH,Total,50-54,Preprimary,1843,656,2499
13594,12,State - ARUNACHAL PRADESH,Total,55-59,Preprimary,1282,316,1598
13595,12,State - ARUNACHAL PRADESH,Total,60-64,Preprimary,954,268,1222
13596,12,State - ARUNACHAL PRADESH,Total,65-69,Preprimary,572,148,720
13597,12,State - ARUNACHAL PRADESH,Total,70-74,Preprimary,335,89,424
13598,12,State - ARUNACHAL PRADESH,Total,75-79,Preprimary,166,33,199
13599,12,State - ARUNACHAL PRADESH,Total,80+,Preprimary,190,88,278
13600,12,State - ARUNACHAL PRADESH,Total,Age not stated,Preprimary,64,37,101
13601,12,State - ARUNACHAL PRADESH,Rural,All ages,Preprimary,70679,59383,130062
13602,12,State - ARUNACHAL PRADESH,Rural,0-6,Preprimary,0,0,0
13603,12,State - ARUNACHAL PRADESH,Rural,7,Preprimary,6998,6519,13517
13604,12,State - ARUNACHAL PRADESH,Rural,8,Preprimary,9449,8602,18051
13605,12,State - ARUNACHAL PRADESH,Rural,9,Preprimary,7973,7309,15282
13606,12,State - ARUNACHAL PRADESH,Rural,10,Preprimary,8671,8053,16724
13607,12,State - ARUNACHAL PRADESH,Rural,11,Preprimary,5558,4982,10540
13608,12,State - ARUNACHAL PRADESH,Rural,12,Preprimary,4603,4215,8818
13609,12,State - ARUNACHAL PRADESH,Rural,13,Preprimary,2604,2285,4889
13610,12,State - ARUNACHAL PRADESH,Rural,14,Preprimary,1905,1671,3576
13611,12,State - ARUNACHAL PRADESH,Rural,15,Preprimary,1317,1176,2493
13612,12,State - ARUNACHAL PRADESH,Rural,16,Preprimary,1030,882,1912
13613,12,State - ARUNACHAL PRADESH,Rural,17,Preprimary,694,532,1226
13614,12,State - ARUNACHAL PRADESH,Rural,18,Preprimary,880,695,1575
13615,12,State - ARUNACHAL PRADESH,Rural,19,Preprimary,582,501,1083
13616,12,State - ARUNACHAL PRADESH,Rural,20-24,Preprimary,2892,2613,5505
13617,12,State - ARUNACHAL PRADESH,Rural,25-29,Preprimary,2718,2377,5095
13618,12,State - ARUNACHAL PRADESH,Rural,30-34,Preprimary,2311,1981,4292
13619,12,State - ARUNACHAL PRADESH,Rural,35-39,Preprimary,2315,1750,4065
13620,12,State - ARUNACHAL PRADESH,Rural,40-44,Preprimary,1939,1161,3100
13621,12,State - ARUNACHAL PRADESH,Rural,45-49,Preprimary,1781,843,2624
13622,12,State - ARUNACHAL PRADESH,Rural,50-54,Preprimary,1491,494,1985
13623,12,State - ARUNACHAL PRADESH,Rural,55-59,Preprimary,1045,245,1290
13624,12,State - ARUNACHAL PRADESH,Rural,60-64,Preprimary,806,200,1006
13625,12,State - ARUNACHAL PRADESH,Rural,65-69,Preprimary,480,110,590
13626,12,State - ARUNACHAL PRADESH,Rural,70-74,Preprimary,285,67,352
13627,12,State - ARUNACHAL PRADESH,Rural,75-79,Preprimary,142,25,167
13628,12,State - ARUNACHAL PRADESH,Rural,80+,Preprimary,155,62,217
13629,12,State - ARUNACHAL PRADESH,Rural,Age not stated,Preprimary,55,33,88
13630,12,State - ARUNACHAL PRADESH,Urban,All ages,Preprimary,18109,16805,34914
13631,12,State - ARUNACHAL PRADESH,Urban,0-6,Preprimary,0,0,0
13632,12,State - ARUNACHAL PRADESH,Urban,7,Preprimary,2371,2367,4738
13633,12,State - ARUNACHAL PRADESH,Urban,8,Preprimary,2805,2675,5480
13634,12,State - ARUNACHAL PRADESH,Urban,9,Preprimary,2367,2278,4645
13635,12,State - ARUNACHAL PRADESH,Urban,10,Preprimary,2425,2217,4642
13636,12,State - ARUNACHAL PRADESH,Urban,11,Preprimary,1439,1325,2764
13637,12,State - ARUNACHAL PRADESH,Urban,12,Preprimary,927,899,1826
13638,12,State - ARUNACHAL PRADESH,Urban,13,Preprimary,501,497,998
13639,12,State - ARUNACHAL PRADESH,Urban,14,Preprimary,318,320,638
13640,12,State - ARUNACHAL PRADESH,Urban,15,Preprimary,211,234,445
13641,12,State - ARUNACHAL PRADESH,Urban,16,Preprimary,158,167,325
13642,12,State - ARUNACHAL PRADESH,Urban,17,Preprimary,146,124,270
13643,12,State - ARUNACHAL PRADESH,Urban,18,Preprimary,200,155,355
13644,12,State - ARUNACHAL PRADESH,Urban,19,Preprimary,143,120,263
13645,12,State - ARUNACHAL PRADESH,Urban,20-24,Preprimary,642,600,1242
13646,12,State - ARUNACHAL PRADESH,Urban,25-29,Preprimary,594,601,1195
13647,12,State - ARUNACHAL PRADESH,Urban,30-34,Preprimary,453,538,991
13648,12,State - ARUNACHAL PRADESH,Urban,35-39,Preprimary,501,554,1055
13649,12,State - ARUNACHAL PRADESH,Urban,40-44,Preprimary,499,420,919
13650,12,State - ARUNACHAL PRADESH,Urban,45-49,Preprimary,462,315,777
13651,12,State - ARUNACHAL PRADESH,Urban,50-54,Preprimary,352,162,514
13652,12,State - ARUNACHAL PRADESH,Urban,55-59,Preprimary,237,71,308
13653,12,State - ARUNACHAL PRADESH,Urban,60-64,Preprimary,148,68,216
13654,12,State - ARUNACHAL PRADESH,Urban,65-69,Preprimary,92,38,130
13655,12,State - ARUNACHAL PRADESH,Urban,70-74,Preprimary,50,22,72
13656,12,State - ARUNACHAL PRADESH,Urban,75-79,Preprimary,24,8,32
13657,12,State - ARUNACHAL PRADESH,Urban,80+,Preprimary,35,26,61
13658,12,State - ARUNACHAL PRADESH,Urban,Age not stated,Preprimary,9,4,13
13659,13,State - NAGALAND,Total,All ages,Preprimary,134218,124376,258594
13660,13,State - NAGALAND,Total,0-6,Preprimary,0,0,0
13661,13,State - NAGALAND,Total,7,Preprimary,14342,13351,27693
13662,13,State - NAGALAND,Total,8,Preprimary,17891,16599,34490
13663,13,State - NAGALAND,Total,9,Preprimary,16274,15161,31435
13664,13,State - NAGALAND,Total,10,Preprimary,16144,14610,30754
13665,13,State - NAGALAND,Total,11,Preprimary,9589,8289,17878
13666,13,State - NAGALAND,Total,12,Preprimary,5966,4999,10965
13667,13,State - NAGALAND,Total,13,Preprimary,3606,3079,6685
13668,13,State - NAGALAND,Total,14,Preprimary,2352,2020,4372
13669,13,State - NAGALAND,Total,15,Preprimary,2064,1817,3881
13670,13,State - NAGALAND,Total,16,Preprimary,1687,1418,3105
13671,13,State - NAGALAND,Total,17,Preprimary,1338,1256,2594
13672,13,State - NAGALAND,Total,18,Preprimary,1632,1441,3073
13673,13,State - NAGALAND,Total,19,Preprimary,1286,1133,2419
13674,13,State - NAGALAND,Total,20-24,Preprimary,6171,6048,12219
13675,13,State - NAGALAND,Total,25-29,Preprimary,5008,5299,10307
13676,13,State - NAGALAND,Total,30-34,Preprimary,4401,4755,9156
13677,13,State - NAGALAND,Total,35-39,Preprimary,4107,4648,8755
13678,13,State - NAGALAND,Total,40-44,Preprimary,3917,4357,8274
13679,13,State - NAGALAND,Total,45-49,Preprimary,3883,3809,7692
13680,13,State - NAGALAND,Total,50-54,Preprimary,3225,3087,6312
13681,13,State - NAGALAND,Total,55-59,Preprimary,2408,2146,4554
13682,13,State - NAGALAND,Total,60-64,Preprimary,2327,1839,4166
13683,13,State - NAGALAND,Total,65-69,Preprimary,1566,1217,2783
13684,13,State - NAGALAND,Total,70-74,Preprimary,1146,878,2024
13685,13,State - NAGALAND,Total,75-79,Preprimary,820,492,1312
13686,13,State - NAGALAND,Total,80+,Preprimary,991,561,1552
13687,13,State - NAGALAND,Total,Age not stated,Preprimary,77,67,144
13688,13,State - NAGALAND,Rural,All ages,Preprimary,101132,93908,195040
13689,13,State - NAGALAND,Rural,0-6,Preprimary,0,0,0
13690,13,State - NAGALAND,Rural,7,Preprimary,9912,9119,19031
13691,13,State - NAGALAND,Rural,8,Preprimary,12720,11780,24500
13692,13,State - NAGALAND,Rural,9,Preprimary,11612,10790,22402
13693,13,State - NAGALAND,Rural,10,Preprimary,12150,10904,23054
13694,13,State - NAGALAND,Rural,11,Preprimary,7465,6518,13983
13695,13,State - NAGALAND,Rural,12,Preprimary,4758,4020,8778
13696,13,State - NAGALAND,Rural,13,Preprimary,2873,2475,5348
13697,13,State - NAGALAND,Rural,14,Preprimary,1856,1586,3442
13698,13,State - NAGALAND,Rural,15,Preprimary,1627,1423,3050
13699,13,State - NAGALAND,Rural,16,Preprimary,1334,1094,2428
13700,13,State - NAGALAND,Rural,17,Preprimary,1030,978,2008
13701,13,State - NAGALAND,Rural,18,Preprimary,1239,1154,2393
13702,13,State - NAGALAND,Rural,19,Preprimary,955,898,1853
13703,13,State - NAGALAND,Rural,20-24,Preprimary,4836,4846,9682
13704,13,State - NAGALAND,Rural,25-29,Preprimary,3876,4310,8186
13705,13,State - NAGALAND,Rural,30-34,Preprimary,3525,3876,7401
13706,13,State - NAGALAND,Rural,35-39,Preprimary,3220,3709,6929
13707,13,State - NAGALAND,Rural,40-44,Preprimary,3064,3459,6523
13708,13,State - NAGALAND,Rural,45-49,Preprimary,3015,2999,6014
13709,13,State - NAGALAND,Rural,50-54,Preprimary,2532,2445,4977
13710,13,State - NAGALAND,Rural,55-59,Preprimary,1874,1699,3573
13711,13,State - NAGALAND,Rural,60-64,Preprimary,1862,1439,3301
13712,13,State - NAGALAND,Rural,65-69,Preprimary,1289,911,2200
13713,13,State - NAGALAND,Rural,70-74,Preprimary,952,639,1591
13714,13,State - NAGALAND,Rural,75-79,Preprimary,670,377,1047
13715,13,State - NAGALAND,Rural,80+,Preprimary,816,403,1219
13716,13,State - NAGALAND,Rural,Age not stated,Preprimary,70,57,127
13717,13,State - NAGALAND,Urban,All ages,Preprimary,33086,30468,63554
13718,13,State - NAGALAND,Urban,0-6,Preprimary,0,0,0
13719,13,State - NAGALAND,Urban,7,Preprimary,4430,4232,8662
13720,13,State - NAGALAND,Urban,8,Preprimary,5171,4819,9990
13721,13,State - NAGALAND,Urban,9,Preprimary,4662,4371,9033
13722,13,State - NAGALAND,Urban,10,Preprimary,3994,3706,7700
13723,13,State - NAGALAND,Urban,11,Preprimary,2124,1771,3895
13724,13,State - NAGALAND,Urban,12,Preprimary,1208,979,2187
13725,13,State - NAGALAND,Urban,13,Preprimary,733,604,1337
13726,13,State - NAGALAND,Urban,14,Preprimary,496,434,930
13727,13,State - NAGALAND,Urban,15,Preprimary,437,394,831
13728,13,State - NAGALAND,Urban,16,Preprimary,353,324,677
13729,13,State - NAGALAND,Urban,17,Preprimary,308,278,586
13730,13,State - NAGALAND,Urban,18,Preprimary,393,287,680
13731,13,State - NAGALAND,Urban,19,Preprimary,331,235,566
13732,13,State - NAGALAND,Urban,20-24,Preprimary,1335,1202,2537
13733,13,State - NAGALAND,Urban,25-29,Preprimary,1132,989,2121
13734,13,State - NAGALAND,Urban,30-34,Preprimary,876,879,1755
13735,13,State - NAGALAND,Urban,35-39,Preprimary,887,939,1826
13736,13,State - NAGALAND,Urban,40-44,Preprimary,853,898,1751
13737,13,State - NAGALAND,Urban,45-49,Preprimary,868,810,1678
13738,13,State - NAGALAND,Urban,50-54,Preprimary,693,642,1335
13739,13,State - NAGALAND,Urban,55-59,Preprimary,534,447,981
13740,13,State - NAGALAND,Urban,60-64,Preprimary,465,400,865
13741,13,State - NAGALAND,Urban,65-69,Preprimary,277,306,583
13742,13,State - NAGALAND,Urban,70-74,Preprimary,194,239,433
13743,13,State - NAGALAND,Urban,75-79,Preprimary,150,115,265
13744,13,State - NAGALAND,Urban,80+,Preprimary,175,158,333
13745,13,State - NAGALAND,Urban,Age not stated,Preprimary,7,10,17
13746,14,State - MANIPUR,Total,All ages,Preprimary,123662,119904,243566
13747,14,State - MANIPUR,Total,0-6,Preprimary,0,0,0
13748,14,State - MANIPUR,Total,7,Preprimary,18519,17545,36064
13749,14,State - MANIPUR,Total,8,Preprimary,22235,20716,42951
13750,14,State - MANIPUR,Total,9,Preprimary,17188,15829,33017
13751,14,State - MANIPUR,Total,10,Preprimary,17353,15668,33021
13752,14,State - MANIPUR,Total,11,Preprimary,9641,8904,18545
13753,14,State - MANIPUR,Total,12,Preprimary,6068,5394,11462
13754,14,State - MANIPUR,Total,13,Preprimary,3116,2897,6013
13755,14,State - MANIPUR,Total,14,Preprimary,1690,1540,3230
13756,14,State - MANIPUR,Total,15,Preprimary,1144,1180,2324
13757,14,State - MANIPUR,Total,16,Preprimary,826,865,1691
13758,14,State - MANIPUR,Total,17,Preprimary,661,654,1315
13759,14,State - MANIPUR,Total,18,Preprimary,745,895,1640
13760,14,State - MANIPUR,Total,19,Preprimary,554,603,1157
13761,14,State - MANIPUR,Total,20-24,Preprimary,2710,3489,6199
13762,14,State - MANIPUR,Total,25-29,Preprimary,2420,3427,5847
13763,14,State - MANIPUR,Total,30-34,Preprimary,2143,3071,5214
13764,14,State - MANIPUR,Total,35-39,Preprimary,2075,3128,5203
13765,14,State - MANIPUR,Total,40-44,Preprimary,2023,2831,4854
13766,14,State - MANIPUR,Total,45-49,Preprimary,2003,2841,4844
13767,14,State - MANIPUR,Total,50-54,Preprimary,2008,2392,4400
13768,14,State - MANIPUR,Total,55-59,Preprimary,1684,1930,3614
13769,14,State - MANIPUR,Total,60-64,Preprimary,1764,1539,3303
13770,14,State - MANIPUR,Total,65-69,Preprimary,1393,962,2355
13771,14,State - MANIPUR,Total,70-74,Preprimary,1290,663,1953
13772,14,State - MANIPUR,Total,75-79,Preprimary,949,313,1262
13773,14,State - MANIPUR,Total,80+,Preprimary,1152,342,1494
13774,14,State - MANIPUR,Total,Age not stated,Preprimary,308,286,594
13775,14,State - MANIPUR,Rural,All ages,Preprimary,92797,89359,182156
13776,14,State - MANIPUR,Rural,0-6,Preprimary,0,0,0
13777,14,State - MANIPUR,Rural,7,Preprimary,13132,12236,25368
13778,14,State - MANIPUR,Rural,8,Preprimary,15934,14704,30638
13779,14,State - MANIPUR,Rural,9,Preprimary,12208,11205,23413
13780,14,State - MANIPUR,Rural,10,Preprimary,12619,11418,24037
13781,14,State - MANIPUR,Rural,11,Preprimary,7292,6671,13963
13782,14,State - MANIPUR,Rural,12,Preprimary,4854,4263,9117
13783,14,State - MANIPUR,Rural,13,Preprimary,2541,2369,4910
13784,14,State - MANIPUR,Rural,14,Preprimary,1422,1298,2720
13785,14,State - MANIPUR,Rural,15,Preprimary,956,988,1944
13786,14,State - MANIPUR,Rural,16,Preprimary,710,731,1441
13787,14,State - MANIPUR,Rural,17,Preprimary,537,551,1088
13788,14,State - MANIPUR,Rural,18,Preprimary,586,747,1333
13789,14,State - MANIPUR,Rural,19,Preprimary,458,519,977
13790,14,State - MANIPUR,Rural,20-24,Preprimary,2302,2961,5263
13791,14,State - MANIPUR,Rural,25-29,Preprimary,2076,2905,4981
13792,14,State - MANIPUR,Rural,30-34,Preprimary,1801,2582,4383
13793,14,State - MANIPUR,Rural,35-39,Preprimary,1733,2565,4298
13794,14,State - MANIPUR,Rural,40-44,Preprimary,1701,2251,3952
13795,14,State - MANIPUR,Rural,45-49,Preprimary,1671,2261,3932
13796,14,State - MANIPUR,Rural,50-54,Preprimary,1666,1852,3518
13797,14,State - MANIPUR,Rural,55-59,Preprimary,1410,1403,2813
13798,14,State - MANIPUR,Rural,60-64,Preprimary,1434,1123,2557
13799,14,State - MANIPUR,Rural,65-69,Preprimary,1087,675,1762
13800,14,State - MANIPUR,Rural,70-74,Preprimary,985,428,1413
13801,14,State - MANIPUR,Rural,75-79,Preprimary,663,208,871
13802,14,State - MANIPUR,Rural,80+,Preprimary,788,225,1013
13803,14,State - MANIPUR,Rural,Age not stated,Preprimary,231,220,451
13804,14,State - MANIPUR,Urban,All ages,Preprimary,30865,30545,61410
13805,14,State - MANIPUR,Urban,0-6,Preprimary,0,0,0
13806,14,State - MANIPUR,Urban,7,Preprimary,5387,5309,10696
13807,14,State - MANIPUR,Urban,8,Preprimary,6301,6012,12313
13808,14,State - MANIPUR,Urban,9,Preprimary,4980,4624,9604
13809,14,State - MANIPUR,Urban,10,Preprimary,4734,4250,8984
13810,14,State - MANIPUR,Urban,11,Preprimary,2349,2233,4582
13811,14,State - MANIPUR,Urban,12,Preprimary,1214,1131,2345
13812,14,State - MANIPUR,Urban,13,Preprimary,575,528,1103
13813,14,State - MANIPUR,Urban,14,Preprimary,268,242,510
13814,14,State - MANIPUR,Urban,15,Preprimary,188,192,380
13815,14,State - MANIPUR,Urban,16,Preprimary,116,134,250
13816,14,State - MANIPUR,Urban,17,Preprimary,124,103,227
13817,14,State - MANIPUR,Urban,18,Preprimary,159,148,307
13818,14,State - MANIPUR,Urban,19,Preprimary,96,84,180
13819,14,State - MANIPUR,Urban,20-24,Preprimary,408,528,936
13820,14,State - MANIPUR,Urban,25-29,Preprimary,344,522,866
13821,14,State - MANIPUR,Urban,30-34,Preprimary,342,489,831
13822,14,State - MANIPUR,Urban,35-39,Preprimary,342,563,905
13823,14,State - MANIPUR,Urban,40-44,Preprimary,322,580,902
13824,14,State - MANIPUR,Urban,45-49,Preprimary,332,580,912
13825,14,State - MANIPUR,Urban,50-54,Preprimary,342,540,882
13826,14,State - MANIPUR,Urban,55-59,Preprimary,274,527,801
13827,14,State - MANIPUR,Urban,60-64,Preprimary,330,416,746
13828,14,State - MANIPUR,Urban,65-69,Preprimary,306,287,593
13829,14,State - MANIPUR,Urban,70-74,Preprimary,305,235,540
13830,14,State - MANIPUR,Urban,75-79,Preprimary,286,105,391
13831,14,State - MANIPUR,Urban,80+,Preprimary,364,117,481
13832,14,State - MANIPUR,Urban,Age not stated,Preprimary,77,66,143
13833,15,State - MIZORAM,Total,All ages,Preprimary,105262,110603,215865
13834,15,State - MIZORAM,Total,0-6,Preprimary,0,0,0
13835,15,State - MIZORAM,Total,7,Preprimary,9510,9273,18783
13836,15,State - MIZORAM,Total,8,Preprimary,10626,10042,20668
13837,15,State - MIZORAM,Total,9,Preprimary,9691,8807,18498
13838,15,State - MIZORAM,Total,10,Preprimary,7901,6948,14849
13839,15,State - MIZORAM,Total,11,Preprimary,4223,3362,7585
13840,15,State - MIZORAM,Total,12,Preprimary,2356,1954,4310
13841,15,State - MIZORAM,Total,13,Preprimary,1523,1216,2739
13842,15,State - MIZORAM,Total,14,Preprimary,983,820,1803
13843,15,State - MIZORAM,Total,15,Preprimary,783,693,1476
13844,15,State - MIZORAM,Total,16,Preprimary,706,643,1349
13845,15,State - MIZORAM,Total,17,Preprimary,701,697,1398
13846,15,State - MIZORAM,Total,18,Preprimary,863,794,1657
13847,15,State - MIZORAM,Total,19,Preprimary,772,729,1501
13848,15,State - MIZORAM,Total,20-24,Preprimary,4723,4586,9309
13849,15,State - MIZORAM,Total,25-29,Preprimary,5282,4982,10264
13850,15,State - MIZORAM,Total,30-34,Preprimary,4807,5005,9812
13851,15,State - MIZORAM,Total,35-39,Preprimary,4636,4953,9589
13852,15,State - MIZORAM,Total,40-44,Preprimary,4491,5359,9850
13853,15,State - MIZORAM,Total,45-49,Preprimary,5175,6847,12022
13854,15,State - MIZORAM,Total,50-54,Preprimary,5915,7995,13910
13855,15,State - MIZORAM,Total,55-59,Preprimary,5192,7014,12206
13856,15,State - MIZORAM,Total,60-64,Preprimary,4099,5866,9965
13857,15,State - MIZORAM,Total,65-69,Preprimary,3346,4459,7805
13858,15,State - MIZORAM,Total,70-74,Preprimary,2812,3352,6164
13859,15,State - MIZORAM,Total,75-79,Preprimary,1988,2151,4139
13860,15,State - MIZORAM,Total,80+,Preprimary,2121,2025,4146
13861,15,State - MIZORAM,Total,Age not stated,Preprimary,37,31,68
13862,15,State - MIZORAM,Rural,All ages,Preprimary,63665,61252,124917
13863,15,State - MIZORAM,Rural,0-6,Preprimary,0,0,0
13864,15,State - MIZORAM,Rural,7,Preprimary,4807,4615,9422
13865,15,State - MIZORAM,Rural,8,Preprimary,5538,5065,10603
13866,15,State - MIZORAM,Rural,9,Preprimary,4945,4344,9289
13867,15,State - MIZORAM,Rural,10,Preprimary,4316,3778,8094
13868,15,State - MIZORAM,Rural,11,Preprimary,2813,2218,5031
13869,15,State - MIZORAM,Rural,12,Preprimary,1819,1531,3350
13870,15,State - MIZORAM,Rural,13,Preprimary,1250,997,2247
13871,15,State - MIZORAM,Rural,14,Preprimary,826,671,1497
13872,15,State - MIZORAM,Rural,15,Preprimary,612,547,1159
13873,15,State - MIZORAM,Rural,16,Preprimary,525,476,1001
13874,15,State - MIZORAM,Rural,17,Preprimary,514,491,1005
13875,15,State - MIZORAM,Rural,18,Preprimary,610,550,1160
13876,15,State - MIZORAM,Rural,19,Preprimary,546,510,1056
13877,15,State - MIZORAM,Rural,20-24,Preprimary,3376,3259,6635
13878,15,State - MIZORAM,Rural,25-29,Preprimary,3685,3440,7125
13879,15,State - MIZORAM,Rural,30-34,Preprimary,3298,3195,6493
13880,15,State - MIZORAM,Rural,35-39,Preprimary,3075,3055,6130
13881,15,State - MIZORAM,Rural,40-44,Preprimary,2875,3065,5940
13882,15,State - MIZORAM,Rural,45-49,Preprimary,3307,3837,7144
13883,15,State - MIZORAM,Rural,50-54,Preprimary,3703,4174,7877
13884,15,State - MIZORAM,Rural,55-59,Preprimary,3225,3502,6727
13885,15,State - MIZORAM,Rural,60-64,Preprimary,2422,2826,5248
13886,15,State - MIZORAM,Rural,65-69,Preprimary,1964,2056,4020
13887,15,State - MIZORAM,Rural,70-74,Preprimary,1559,1392,2951
13888,15,State - MIZORAM,Rural,75-79,Preprimary,1056,854,1910
13889,15,State - MIZORAM,Rural,80+,Preprimary,978,784,1762
13890,15,State - MIZORAM,Rural,Age not stated,Preprimary,21,20,41
13891,15,State - MIZORAM,Urban,All ages,Preprimary,41597,49351,90948
13892,15,State - MIZORAM,Urban,0-6,Preprimary,0,0,0
13893,15,State - MIZORAM,Urban,7,Preprimary,4703,4658,9361
13894,15,State - MIZORAM,Urban,8,Preprimary,5088,4977,10065
13895,15,State - MIZORAM,Urban,9,Preprimary,4746,4463,9209
13896,15,State - MIZORAM,Urban,10,Preprimary,3585,3170,6755
13897,15,State - MIZORAM,Urban,11,Preprimary,1410,1144,2554
13898,15,State - MIZORAM,Urban,12,Preprimary,537,423,960
13899,15,State - MIZORAM,Urban,13,Preprimary,273,219,492
13900,15,State - MIZORAM,Urban,14,Preprimary,157,149,306
13901,15,State - MIZORAM,Urban,15,Preprimary,171,146,317
13902,15,State - MIZORAM,Urban,16,Preprimary,181,167,348
13903,15,State - MIZORAM,Urban,17,Preprimary,187,206,393
13904,15,State - MIZORAM,Urban,18,Preprimary,253,244,497
13905,15,State - MIZORAM,Urban,19,Preprimary,226,219,445
13906,15,State - MIZORAM,Urban,20-24,Preprimary,1347,1327,2674
13907,15,State - MIZORAM,Urban,25-29,Preprimary,1597,1542,3139
13908,15,State - MIZORAM,Urban,30-34,Preprimary,1509,1810,3319
13909,15,State - MIZORAM,Urban,35-39,Preprimary,1561,1898,3459
13910,15,State - MIZORAM,Urban,40-44,Preprimary,1616,2294,3910
13911,15,State - MIZORAM,Urban,45-49,Preprimary,1868,3010,4878
13912,15,State - MIZORAM,Urban,50-54,Preprimary,2212,3821,6033
13913,15,State - MIZORAM,Urban,55-59,Preprimary,1967,3512,5479
13914,15,State - MIZORAM,Urban,60-64,Preprimary,1677,3040,4717
13915,15,State - MIZORAM,Urban,65-69,Preprimary,1382,2403,3785
13916,15,State - MIZORAM,Urban,70-74,Preprimary,1253,1960,3213
13917,15,State - MIZORAM,Urban,75-79,Preprimary,932,1297,2229
13918,15,State - MIZORAM,Urban,80+,Preprimary,1143,1241,2384
13919,15,State - MIZORAM,Urban,Age not stated,Preprimary,16,11,27
13920,16,State - TRIPURA,Total,All ages,Preprimary,363853,361608,725461
13921,16,State - TRIPURA,Total,0-6,Preprimary,0,0,0
13922,16,State - TRIPURA,Total,7,Preprimary,27314,26091,53405
13923,16,State - TRIPURA,Total,8,Preprimary,32206,30748,62954
13924,16,State - TRIPURA,Total,9,Preprimary,30599,29566,60165
13925,16,State - TRIPURA,Total,10,Preprimary,28055,26098,54153
13926,16,State - TRIPURA,Total,11,Preprimary,13426,12368,25794
13927,16,State - TRIPURA,Total,12,Preprimary,6526,5839,12365
13928,16,State - TRIPURA,Total,13,Preprimary,3340,3072,6412
13929,16,State - TRIPURA,Total,14,Preprimary,2632,2386,5018
13930,16,State - TRIPURA,Total,15,Preprimary,2761,2454,5215
13931,16,State - TRIPURA,Total,16,Preprimary,2878,2477,5355
13932,16,State - TRIPURA,Total,17,Preprimary,3086,2572,5658
13933,16,State - TRIPURA,Total,18,Preprimary,4210,4080,8290
13934,16,State - TRIPURA,Total,19,Preprimary,3615,3866,7481
13935,16,State - TRIPURA,Total,20-24,Preprimary,22667,24788,47455
13936,16,State - TRIPURA,Total,25-29,Preprimary,24348,26754,51102
13937,16,State - TRIPURA,Total,30-34,Preprimary,22174,23667,45841
13938,16,State - TRIPURA,Total,35-39,Preprimary,23520,26667,50187
13939,16,State - TRIPURA,Total,40-44,Preprimary,22624,25219,47843
13940,16,State - TRIPURA,Total,45-49,Preprimary,22203,22770,44973
13941,16,State - TRIPURA,Total,50-54,Preprimary,18355,16988,35343
13942,16,State - TRIPURA,Total,55-59,Preprimary,12571,12318,24889
13943,16,State - TRIPURA,Total,60-64,Preprimary,10989,10719,21708
13944,16,State - TRIPURA,Total,65-69,Preprimary,8675,7798,16473
13945,16,State - TRIPURA,Total,70-74,Preprimary,6726,5490,12216
13946,16,State - TRIPURA,Total,75-79,Preprimary,3852,3065,6917
13947,16,State - TRIPURA,Total,80+,Preprimary,4440,3656,8096
13948,16,State - TRIPURA,Total,Age not stated,Preprimary,61,92,153
13949,16,State - TRIPURA,Rural,All ages,Preprimary,294874,284597,579471
13950,16,State - TRIPURA,Rural,0-6,Preprimary,0,0,0
13951,16,State - TRIPURA,Rural,7,Preprimary,21163,20117,41280
13952,16,State - TRIPURA,Rural,8,Preprimary,25043,23925,48968
13953,16,State - TRIPURA,Rural,9,Preprimary,23749,22997,46746
13954,16,State - TRIPURA,Rural,10,Preprimary,22301,20814,43115
13955,16,State - TRIPURA,Rural,11,Preprimary,11222,10485,21707
13956,16,State - TRIPURA,Rural,12,Preprimary,5754,5181,10935
13957,16,State - TRIPURA,Rural,13,Preprimary,2933,2732,5665
13958,16,State - TRIPURA,Rural,14,Preprimary,2261,2083,4344
13959,16,State - TRIPURA,Rural,15,Preprimary,2366,2159,4525
13960,16,State - TRIPURA,Rural,16,Preprimary,2437,2155,4592
13961,16,State - TRIPURA,Rural,17,Preprimary,2571,2173,4744
13962,16,State - TRIPURA,Rural,18,Preprimary,3531,3501,7032
13963,16,State - TRIPURA,Rural,19,Preprimary,2936,3210,6146
13964,16,State - TRIPURA,Rural,20-24,Preprimary,18573,20645,39218
13965,16,State - TRIPURA,Rural,25-29,Preprimary,19914,21842,41756
13966,16,State - TRIPURA,Rural,30-34,Preprimary,18134,19004,37138
13967,16,State - TRIPURA,Rural,35-39,Preprimary,19121,21070,40191
13968,16,State - TRIPURA,Rural,40-44,Preprimary,18439,19727,38166
13969,16,State - TRIPURA,Rural,45-49,Preprimary,18218,17612,35830
13970,16,State - TRIPURA,Rural,50-54,Preprimary,15070,12958,28028
13971,16,State - TRIPURA,Rural,55-59,Preprimary,10379,9212,19591
13972,16,State - TRIPURA,Rural,60-64,Preprimary,9180,7848,17028
13973,16,State - TRIPURA,Rural,65-69,Preprimary,7215,5484,12699
13974,16,State - TRIPURA,Rural,70-74,Preprimary,5530,3619,9149
13975,16,State - TRIPURA,Rural,75-79,Preprimary,3156,1825,4981
13976,16,State - TRIPURA,Rural,80+,Preprimary,3641,2163,5804
13977,16,State - TRIPURA,Rural,Age not stated,Preprimary,37,56,93
13978,16,State - TRIPURA,Urban,All ages,Preprimary,68979,77011,145990
13979,16,State - TRIPURA,Urban,0-6,Preprimary,0,0,0
13980,16,State - TRIPURA,Urban,7,Preprimary,6151,5974,12125
13981,16,State - TRIPURA,Urban,8,Preprimary,7163,6823,13986
13982,16,State - TRIPURA,Urban,9,Preprimary,6850,6569,13419
13983,16,State - TRIPURA,Urban,10,Preprimary,5754,5284,11038
13984,16,State - TRIPURA,Urban,11,Preprimary,2204,1883,4087
13985,16,State - TRIPURA,Urban,12,Preprimary,772,658,1430
13986,16,State - TRIPURA,Urban,13,Preprimary,407,340,747
13987,16,State - TRIPURA,Urban,14,Preprimary,371,303,674
13988,16,State - TRIPURA,Urban,15,Preprimary,395,295,690
13989,16,State - TRIPURA,Urban,16,Preprimary,441,322,763
13990,16,State - TRIPURA,Urban,17,Preprimary,515,399,914
13991,16,State - TRIPURA,Urban,18,Preprimary,679,579,1258
13992,16,State - TRIPURA,Urban,19,Preprimary,679,656,1335
13993,16,State - TRIPURA,Urban,20-24,Preprimary,4094,4143,8237
13994,16,State - TRIPURA,Urban,25-29,Preprimary,4434,4912,9346
13995,16,State - TRIPURA,Urban,30-34,Preprimary,4040,4663,8703
13996,16,State - TRIPURA,Urban,35-39,Preprimary,4399,5597,9996
13997,16,State - TRIPURA,Urban,40-44,Preprimary,4185,5492,9677
13998,16,State - TRIPURA,Urban,45-49,Preprimary,3985,5158,9143
13999,16,State - TRIPURA,Urban,50-54,Preprimary,3285,4030,7315
14000,16,State - TRIPURA,Urban,55-59,Preprimary,2192,3106,5298
14001,16,State - TRIPURA,Urban,60-64,Preprimary,1809,2871,4680
14002,16,State - TRIPURA,Urban,65-69,Preprimary,1460,2314,3774
14003,16,State - TRIPURA,Urban,70-74,Preprimary,1196,1871,3067
14004,16,State - TRIPURA,Urban,75-79,Preprimary,696,1240,1936
14005,16,State - TRIPURA,Urban,80+,Preprimary,799,1493,2292
14006,16,State - TRIPURA,Urban,Age not stated,Preprimary,24,36,60
14007,17,State - MEGHALAYA,Total,All ages,Preprimary,311818,297246,609064
14008,17,State - MEGHALAYA,Total,0-6,Preprimary,0,0,0
14009,17,State - MEGHALAYA,Total,7,Preprimary,20176,20626,40802
14010,17,State - MEGHALAYA,Total,8,Preprimary,25816,26559,52375
14011,17,State - MEGHALAYA,Total,9,Preprimary,24468,24255,48723
14012,17,State - MEGHALAYA,Total,10,Preprimary,26112,25489,51601
14013,17,State - MEGHALAYA,Total,11,Preprimary,20272,18637,38909
14014,17,State - MEGHALAYA,Total,12,Preprimary,16657,14897,31554
14015,17,State - MEGHALAYA,Total,13,Preprimary,12122,10531,22653
14016,17,State - MEGHALAYA,Total,14,Preprimary,9220,7460,16680
14017,17,State - MEGHALAYA,Total,15,Preprimary,7530,5580,13110
14018,17,State - MEGHALAYA,Total,16,Preprimary,6376,4514,10890
14019,17,State - MEGHALAYA,Total,17,Preprimary,5386,3844,9230
14020,17,State - MEGHALAYA,Total,18,Preprimary,5593,4519,10112
14021,17,State - MEGHALAYA,Total,19,Preprimary,4527,4171,8698
14022,17,State - MEGHALAYA,Total,20-24,Preprimary,22644,23175,45819
14023,17,State - MEGHALAYA,Total,25-29,Preprimary,20730,21926,42656
14024,17,State - MEGHALAYA,Total,30-34,Preprimary,16468,16784,33252
14025,17,State - MEGHALAYA,Total,35-39,Preprimary,15258,15646,30904
14026,17,State - MEGHALAYA,Total,40-44,Preprimary,12914,13166,26080
14027,17,State - MEGHALAYA,Total,45-49,Preprimary,11643,11131,22774
14028,17,State - MEGHALAYA,Total,50-54,Preprimary,8526,7910,16436
14029,17,State - MEGHALAYA,Total,55-59,Preprimary,5796,5154,10950
14030,17,State - MEGHALAYA,Total,60-64,Preprimary,5075,4098,9173
14031,17,State - MEGHALAYA,Total,65-69,Preprimary,3502,2919,6421
14032,17,State - MEGHALAYA,Total,70-74,Preprimary,2124,1766,3890
14033,17,State - MEGHALAYA,Total,75-79,Preprimary,1133,929,2062
14034,17,State - MEGHALAYA,Total,80+,Preprimary,1314,1159,2473
14035,17,State - MEGHALAYA,Total,Age not stated,Preprimary,436,401,837
14036,17,State - MEGHALAYA,Rural,All ages,Preprimary,271443,255903,527346
14037,17,State - MEGHALAYA,Rural,0-6,Preprimary,0,0,0
14038,17,State - MEGHALAYA,Rural,7,Preprimary,15852,16362,32214
14039,17,State - MEGHALAYA,Rural,8,Preprimary,20724,21448,42172
14040,17,State - MEGHALAYA,Rural,9,Preprimary,19735,19759,39494
14041,17,State - MEGHALAYA,Rural,10,Preprimary,21640,21327,42967
14042,17,State - MEGHALAYA,Rural,11,Preprimary,17613,16454,34067
14043,17,State - MEGHALAYA,Rural,12,Preprimary,14963,13538,28501
14044,17,State - MEGHALAYA,Rural,13,Preprimary,10989,9576,20565
14045,17,State - MEGHALAYA,Rural,14,Preprimary,8438,6763,15201
14046,17,State - MEGHALAYA,Rural,15,Preprimary,6960,5126,12086
14047,17,State - MEGHALAYA,Rural,16,Preprimary,5813,4126,9939
14048,17,State - MEGHALAYA,Rural,17,Preprimary,4897,3484,8381
14049,17,State - MEGHALAYA,Rural,18,Preprimary,5044,4131,9175
14050,17,State - MEGHALAYA,Rural,19,Preprimary,4096,3819,7915
14051,17,State - MEGHALAYA,Rural,20-24,Preprimary,20543,21067,41610
14052,17,State - MEGHALAYA,Rural,25-29,Preprimary,18749,19673,38422
14053,17,State - MEGHALAYA,Rural,30-34,Preprimary,14807,14872,29679
14054,17,State - MEGHALAYA,Rural,35-39,Preprimary,13712,13673,27385
14055,17,State - MEGHALAYA,Rural,40-44,Preprimary,11572,11507,23079
14056,17,State - MEGHALAYA,Rural,45-49,Preprimary,10419,9484,19903
14057,17,State - MEGHALAYA,Rural,50-54,Preprimary,7641,6602,14243
14058,17,State - MEGHALAYA,Rural,55-59,Preprimary,5188,4236,9424
14059,17,State - MEGHALAYA,Rural,60-64,Preprimary,4520,3361,7881
14060,17,State - MEGHALAYA,Rural,65-69,Preprimary,3127,2317,5444
14061,17,State - MEGHALAYA,Rural,70-74,Preprimary,1868,1341,3209
14062,17,State - MEGHALAYA,Rural,75-79,Preprimary,982,667,1649
14063,17,State - MEGHALAYA,Rural,80+,Preprimary,1139,826,1965
14064,17,State - MEGHALAYA,Rural,Age not stated,Preprimary,412,364,776
14065,17,State - MEGHALAYA,Urban,All ages,Preprimary,40375,41343,81718
14066,17,State - MEGHALAYA,Urban,0-6,Preprimary,0,0,0
14067,17,State - MEGHALAYA,Urban,7,Preprimary,4324,4264,8588
14068,17,State - MEGHALAYA,Urban,8,Preprimary,5092,5111,10203
14069,17,State - MEGHALAYA,Urban,9,Preprimary,4733,4496,9229
14070,17,State - MEGHALAYA,Urban,10,Preprimary,4472,4162,8634
14071,17,State - MEGHALAYA,Urban,11,Preprimary,2659,2183,4842
14072,17,State - MEGHALAYA,Urban,12,Preprimary,1694,1359,3053
14073,17,State - MEGHALAYA,Urban,13,Preprimary,1133,955,2088
14074,17,State - MEGHALAYA,Urban,14,Preprimary,782,697,1479
14075,17,State - MEGHALAYA,Urban,15,Preprimary,570,454,1024
14076,17,State - MEGHALAYA,Urban,16,Preprimary,563,388,951
14077,17,State - MEGHALAYA,Urban,17,Preprimary,489,360,849
14078,17,State - MEGHALAYA,Urban,18,Preprimary,549,388,937
14079,17,State - MEGHALAYA,Urban,19,Preprimary,431,352,783
14080,17,State - MEGHALAYA,Urban,20-24,Preprimary,2101,2108,4209
14081,17,State - MEGHALAYA,Urban,25-29,Preprimary,1981,2253,4234
14082,17,State - MEGHALAYA,Urban,30-34,Preprimary,1661,1912,3573
14083,17,State - MEGHALAYA,Urban,35-39,Preprimary,1546,1973,3519
14084,17,State - MEGHALAYA,Urban,40-44,Preprimary,1342,1659,3001
14085,17,State - MEGHALAYA,Urban,45-49,Preprimary,1224,1647,2871
14086,17,State - MEGHALAYA,Urban,50-54,Preprimary,885,1308,2193
14087,17,State - MEGHALAYA,Urban,55-59,Preprimary,608,918,1526
14088,17,State - MEGHALAYA,Urban,60-64,Preprimary,555,737,1292
14089,17,State - MEGHALAYA,Urban,65-69,Preprimary,375,602,977
14090,17,State - MEGHALAYA,Urban,70-74,Preprimary,256,425,681
14091,17,State - MEGHALAYA,Urban,75-79,Preprimary,151,262,413
14092,17,State - MEGHALAYA,Urban,80+,Preprimary,175,333,508
14093,17,State - MEGHALAYA,Urban,Age not stated,Preprimary,24,37,61
14094,18,State - ASSAM,Total,All ages,Preprimary,2469904,2080535,4550439
14095,18,State - ASSAM,Total,0-6,Preprimary,0,0,0
14096,18,State - ASSAM,Total,7,Preprimary,255196,244889,500085
14097,18,State - ASSAM,Total,8,Preprimary,297531,283443,580974
14098,18,State - ASSAM,Total,9,Preprimary,237036,226250,463286
14099,18,State - ASSAM,Total,10,Preprimary,215648,195582,411230
14100,18,State - ASSAM,Total,11,Preprimary,107855,96019,203874
14101,18,State - ASSAM,Total,12,Preprimary,69635,57408,127043
14102,18,State - ASSAM,Total,13,Preprimary,39163,30900,70063
14103,18,State - ASSAM,Total,14,Preprimary,31323,23147,54470
14104,18,State - ASSAM,Total,15,Preprimary,32064,21354,53418
14105,18,State - ASSAM,Total,16,Preprimary,30598,19527,50125
14106,18,State - ASSAM,Total,17,Preprimary,25729,16343,42072
14107,18,State - ASSAM,Total,18,Preprimary,36316,25605,61921
14108,18,State - ASSAM,Total,19,Preprimary,25370,21561,46931
14109,18,State - ASSAM,Total,20-24,Preprimary,141892,121883,263775
14110,18,State - ASSAM,Total,25-29,Preprimary,137437,117717,255154
14111,18,State - ASSAM,Total,30-34,Preprimary,113009,95496,208505
14112,18,State - ASSAM,Total,35-39,Preprimary,120145,99081,219226
14113,18,State - ASSAM,Total,40-44,Preprimary,108564,83733,192297
14114,18,State - ASSAM,Total,45-49,Preprimary,108169,79373,187542
14115,18,State - ASSAM,Total,50-54,Preprimary,87447,60175,147622
14116,18,State - ASSAM,Total,55-59,Preprimary,66763,46100,112863
14117,18,State - ASSAM,Total,60-64,Preprimary,61955,43813,105768
14118,18,State - ASSAM,Total,65-69,Preprimary,44763,30239,75002
14119,18,State - ASSAM,Total,70-74,Preprimary,35677,20019,55696
14120,18,State - ASSAM,Total,75-79,Preprimary,18877,9625,28502
14121,18,State - ASSAM,Total,80+,Preprimary,20884,10493,31377
14122,18,State - ASSAM,Total,Age not stated,Preprimary,858,760,1618
14123,18,State - ASSAM,Rural,All ages,Preprimary,2219933,1839077,4059010
14124,18,State - ASSAM,Rural,0-6,Preprimary,0,0,0
14125,18,State - ASSAM,Rural,7,Preprimary,224027,215549,439576
14126,18,State - ASSAM,Rural,8,Preprimary,263962,251687,515649
14127,18,State - ASSAM,Rural,9,Preprimary,209962,201104,411066
14128,18,State - ASSAM,Rural,10,Preprimary,193973,176783,370756
14129,18,State - ASSAM,Rural,11,Preprimary,98158,87532,185690
14130,18,State - ASSAM,Rural,12,Preprimary,64650,53277,117927
14131,18,State - ASSAM,Rural,13,Preprimary,36534,28627,65161
14132,18,State - ASSAM,Rural,14,Preprimary,29222,21409,50631
14133,18,State - ASSAM,Rural,15,Preprimary,29951,19633,49584
14134,18,State - ASSAM,Rural,16,Preprimary,28510,18035,46545
14135,18,State - ASSAM,Rural,17,Preprimary,23723,14912,38635
14136,18,State - ASSAM,Rural,18,Preprimary,33594,23556,57150
14137,18,State - ASSAM,Rural,19,Preprimary,23230,19727,42957
14138,18,State - ASSAM,Rural,20-24,Preprimary,129863,110821,240684
14139,18,State - ASSAM,Rural,25-29,Preprimary,125264,105857,231121
14140,18,State - ASSAM,Rural,30-34,Preprimary,102179,84432,186611
14141,18,State - ASSAM,Rural,35-39,Preprimary,107506,86262,193768
14142,18,State - ASSAM,Rural,40-44,Preprimary,96546,72170,168716
14143,18,State - ASSAM,Rural,45-49,Preprimary,96442,67574,164016
14144,18,State - ASSAM,Rural,50-54,Preprimary,78058,50951,129009
14145,18,State - ASSAM,Rural,55-59,Preprimary,59717,38566,98283
14146,18,State - ASSAM,Rural,60-64,Preprimary,55786,35954,91740
14147,18,State - ASSAM,Rural,65-69,Preprimary,40407,24214,64621
14148,18,State - ASSAM,Rural,70-74,Preprimary,32284,15370,47654
14149,18,State - ASSAM,Rural,75-79,Preprimary,16858,6917,23775
14150,18,State - ASSAM,Rural,80+,Preprimary,18804,7531,26335
14151,18,State - ASSAM,Rural,Age not stated,Preprimary,723,627,1350
14152,18,State - ASSAM,Urban,All ages,Preprimary,249971,241458,491429
14153,18,State - ASSAM,Urban,0-6,Preprimary,0,0,0
14154,18,State - ASSAM,Urban,7,Preprimary,31169,29340,60509
14155,18,State - ASSAM,Urban,8,Preprimary,33569,31756,65325
14156,18,State - ASSAM,Urban,9,Preprimary,27074,25146,52220
14157,18,State - ASSAM,Urban,10,Preprimary,21675,18799,40474
14158,18,State - ASSAM,Urban,11,Preprimary,9697,8487,18184
14159,18,State - ASSAM,Urban,12,Preprimary,4985,4131,9116
14160,18,State - ASSAM,Urban,13,Preprimary,2629,2273,4902
14161,18,State - ASSAM,Urban,14,Preprimary,2101,1738,3839
14162,18,State - ASSAM,Urban,15,Preprimary,2113,1721,3834
14163,18,State - ASSAM,Urban,16,Preprimary,2088,1492,3580
14164,18,State - ASSAM,Urban,17,Preprimary,2006,1431,3437
14165,18,State - ASSAM,Urban,18,Preprimary,2722,2049,4771
14166,18,State - ASSAM,Urban,19,Preprimary,2140,1834,3974
14167,18,State - ASSAM,Urban,20-24,Preprimary,12029,11062,23091
14168,18,State - ASSAM,Urban,25-29,Preprimary,12173,11860,24033
14169,18,State - ASSAM,Urban,30-34,Preprimary,10830,11064,21894
14170,18,State - ASSAM,Urban,35-39,Preprimary,12639,12819,25458
14171,18,State - ASSAM,Urban,40-44,Preprimary,12018,11563,23581
14172,18,State - ASSAM,Urban,45-49,Preprimary,11727,11799,23526
14173,18,State - ASSAM,Urban,50-54,Preprimary,9389,9224,18613
14174,18,State - ASSAM,Urban,55-59,Preprimary,7046,7534,14580
14175,18,State - ASSAM,Urban,60-64,Preprimary,6169,7859,14028
14176,18,State - ASSAM,Urban,65-69,Preprimary,4356,6025,10381
14177,18,State - ASSAM,Urban,70-74,Preprimary,3393,4649,8042
14178,18,State - ASSAM,Urban,75-79,Preprimary,2019,2708,4727
14179,18,State - ASSAM,Urban,80+,Preprimary,2080,2962,5042
14180,18,State - ASSAM,Urban,Age not stated,Preprimary,135,133,268
14181,19,State - WEST BENGAL,Total,All ages,Preprimary,8437465,7465147,15902612
14182,19,State - WEST BENGAL,Total,0-6,Preprimary,0,0,0
14183,19,State - WEST BENGAL,Total,7,Preprimary,645977,622162,1268139
14184,19,State - WEST BENGAL,Total,8,Preprimary,769454,732236,1501690
14185,19,State - WEST BENGAL,Total,9,Preprimary,636427,608398,1244825
14186,19,State - WEST BENGAL,Total,10,Preprimary,561812,508132,1069944
14187,19,State - WEST BENGAL,Total,11,Preprimary,276456,243049,519505
14188,19,State - WEST BENGAL,Total,12,Preprimary,190057,153893,343950
14189,19,State - WEST BENGAL,Total,13,Preprimary,113124,89077,202201
14190,19,State - WEST BENGAL,Total,14,Preprimary,101389,74062,175451
14191,19,State - WEST BENGAL,Total,15,Preprimary,105567,72675,178242
14192,19,State - WEST BENGAL,Total,16,Preprimary,109969,73931,183900
14193,19,State - WEST BENGAL,Total,17,Preprimary,102180,67001,169181
14194,19,State - WEST BENGAL,Total,18,Preprimary,148413,112480,260893
14195,19,State - WEST BENGAL,Total,19,Preprimary,105767,95098,200865
14196,19,State - WEST BENGAL,Total,20-24,Preprimary,613142,564529,1177671
14197,19,State - WEST BENGAL,Total,25-29,Preprimary,586926,573650,1160576
14198,19,State - WEST BENGAL,Total,30-34,Preprimary,511377,506842,1018219
14199,19,State - WEST BENGAL,Total,35-39,Preprimary,546249,540936,1087185
14200,19,State - WEST BENGAL,Total,40-44,Preprimary,511831,443504,955335
14201,19,State - WEST BENGAL,Total,45-49,Preprimary,470030,374301,844331
14202,19,State - WEST BENGAL,Total,50-54,Preprimary,376776,273747,650523
14203,19,State - WEST BENGAL,Total,55-59,Preprimary,275688,216702,492390
14204,19,State - WEST BENGAL,Total,60-64,Preprimary,234515,179742,414257
14205,19,State - WEST BENGAL,Total,65-69,Preprimary,177713,136292,314005
14206,19,State - WEST BENGAL,Total,70-74,Preprimary,121474,88374,209848
14207,19,State - WEST BENGAL,Total,75-79,Preprimary,66160,50854,117014
14208,19,State - WEST BENGAL,Total,80+,Preprimary,73881,59105,132986
14209,19,State - WEST BENGAL,Total,Age not stated,Preprimary,5111,4375,9486
14210,19,State - WEST BENGAL,Rural,All ages,Preprimary,6421511,5548626,11970137
14211,19,State - WEST BENGAL,Rural,0-6,Preprimary,0,0,0
14212,19,State - WEST BENGAL,Rural,7,Preprimary,460125,445728,905853
14213,19,State - WEST BENGAL,Rural,8,Preprimary,561487,537181,1098668
14214,19,State - WEST BENGAL,Rural,9,Preprimary,468194,451472,919666
14215,19,State - WEST BENGAL,Rural,10,Preprimary,421119,383501,804620
14216,19,State - WEST BENGAL,Rural,11,Preprimary,209970,186310,396280
14217,19,State - WEST BENGAL,Rural,12,Preprimary,147949,120428,268377
14218,19,State - WEST BENGAL,Rural,13,Preprimary,88878,69347,158225
14219,19,State - WEST BENGAL,Rural,14,Preprimary,79860,57380,137240
14220,19,State - WEST BENGAL,Rural,15,Preprimary,83466,56351,139817
14221,19,State - WEST BENGAL,Rural,16,Preprimary,87389,57234,144623
14222,19,State - WEST BENGAL,Rural,17,Preprimary,80301,51208,131509
14223,19,State - WEST BENGAL,Rural,18,Preprimary,116955,87806,204761
14224,19,State - WEST BENGAL,Rural,19,Preprimary,82915,74717,157632
14225,19,State - WEST BENGAL,Rural,20-24,Preprimary,483689,446718,930407
14226,19,State - WEST BENGAL,Rural,25-29,Preprimary,459623,448288,907911
14227,19,State - WEST BENGAL,Rural,30-34,Preprimary,396227,391561,787788
14228,19,State - WEST BENGAL,Rural,35-39,Preprimary,421884,413226,835110
14229,19,State - WEST BENGAL,Rural,40-44,Preprimary,393753,333864,727617
14230,19,State - WEST BENGAL,Rural,45-49,Preprimary,358723,273189,631912
14231,19,State - WEST BENGAL,Rural,50-54,Preprimary,288900,194743,483643
14232,19,State - WEST BENGAL,Rural,55-59,Preprimary,210590,152048,362638
14233,19,State - WEST BENGAL,Rural,60-64,Preprimary,179464,120226,299690
14234,19,State - WEST BENGAL,Rural,65-69,Preprimary,138301,87677,225978
14235,19,State - WEST BENGAL,Rural,70-74,Preprimary,92869,50295,143164
14236,19,State - WEST BENGAL,Rural,75-79,Preprimary,50428,26366,76794
14237,19,State - WEST BENGAL,Rural,80+,Preprimary,55372,29295,84667
14238,19,State - WEST BENGAL,Rural,Age not stated,Preprimary,3080,2467,5547
14239,19,State - WEST BENGAL,Urban,All ages,Preprimary,2015954,1916521,3932475
14240,19,State - WEST BENGAL,Urban,0-6,Preprimary,0,0,0
14241,19,State - WEST BENGAL,Urban,7,Preprimary,185852,176434,362286
14242,19,State - WEST BENGAL,Urban,8,Preprimary,207967,195055,403022
14243,19,State - WEST BENGAL,Urban,9,Preprimary,168233,156926,325159
14244,19,State - WEST BENGAL,Urban,10,Preprimary,140693,124631,265324
14245,19,State - WEST BENGAL,Urban,11,Preprimary,66486,56739,123225
14246,19,State - WEST BENGAL,Urban,12,Preprimary,42108,33465,75573
14247,19,State - WEST BENGAL,Urban,13,Preprimary,24246,19730,43976
14248,19,State - WEST BENGAL,Urban,14,Preprimary,21529,16682,38211
14249,19,State - WEST BENGAL,Urban,15,Preprimary,22101,16324,38425
14250,19,State - WEST BENGAL,Urban,16,Preprimary,22580,16697,39277
14251,19,State - WEST BENGAL,Urban,17,Preprimary,21879,15793,37672
14252,19,State - WEST BENGAL,Urban,18,Preprimary,31458,24674,56132
14253,19,State - WEST BENGAL,Urban,19,Preprimary,22852,20381,43233
14254,19,State - WEST BENGAL,Urban,20-24,Preprimary,129453,117811,247264
14255,19,State - WEST BENGAL,Urban,25-29,Preprimary,127303,125362,252665
14256,19,State - WEST BENGAL,Urban,30-34,Preprimary,115150,115281,230431
14257,19,State - WEST BENGAL,Urban,35-39,Preprimary,124365,127710,252075
14258,19,State - WEST BENGAL,Urban,40-44,Preprimary,118078,109640,227718
14259,19,State - WEST BENGAL,Urban,45-49,Preprimary,111307,101112,212419
14260,19,State - WEST BENGAL,Urban,50-54,Preprimary,87876,79004,166880
14261,19,State - WEST BENGAL,Urban,55-59,Preprimary,65098,64654,129752
14262,19,State - WEST BENGAL,Urban,60-64,Preprimary,55051,59516,114567
14263,19,State - WEST BENGAL,Urban,65-69,Preprimary,39412,48615,88027
14264,19,State - WEST BENGAL,Urban,70-74,Preprimary,28605,38079,66684
14265,19,State - WEST BENGAL,Urban,75-79,Preprimary,15732,24488,40220
14266,19,State - WEST BENGAL,Urban,80+,Preprimary,18509,29810,48319
14267,19,State - WEST BENGAL,Urban,Age not stated,Preprimary,2031,1908,3939
14268,20,State - JHARKHAND,Total,All ages,Preprimary,2292684,2000731,4293415
14269,20,State - JHARKHAND,Total,0-6,Preprimary,0,0,0
14270,20,State - JHARKHAND,Total,7,Preprimary,273779,255743,529522
14271,20,State - JHARKHAND,Total,8,Preprimary,386803,357983,744786
14272,20,State - JHARKHAND,Total,9,Preprimary,275100,259365,534465
14273,20,State - JHARKHAND,Total,10,Preprimary,346633,313178,659811
14274,20,State - JHARKHAND,Total,11,Preprimary,155511,143347,298858
14275,20,State - JHARKHAND,Total,12,Preprimary,122253,111543,233796
14276,20,State - JHARKHAND,Total,13,Preprimary,48690,46728,95418
14277,20,State - JHARKHAND,Total,14,Preprimary,29979,28652,58631
14278,20,State - JHARKHAND,Total,15,Preprimary,25877,21572,47449
14279,20,State - JHARKHAND,Total,16,Preprimary,19547,16401,35948
14280,20,State - JHARKHAND,Total,17,Preprimary,12764,10568,23332
14281,20,State - JHARKHAND,Total,18,Preprimary,22586,18856,41442
14282,20,State - JHARKHAND,Total,19,Preprimary,11852,13036,24888
14283,20,State - JHARKHAND,Total,20-24,Preprimary,79494,79141,158635
14284,20,State - JHARKHAND,Total,25-29,Preprimary,80127,74142,154269
14285,20,State - JHARKHAND,Total,30-34,Preprimary,69787,60412,130199
14286,20,State - JHARKHAND,Total,35-39,Preprimary,65839,49983,115822
14287,20,State - JHARKHAND,Total,40-44,Preprimary,56766,36486,93252
14288,20,State - JHARKHAND,Total,45-49,Preprimary,50161,28385,78546
14289,20,State - JHARKHAND,Total,50-54,Preprimary,38850,20150,59000
14290,20,State - JHARKHAND,Total,55-59,Preprimary,30369,16433,46802
14291,20,State - JHARKHAND,Total,60-64,Preprimary,31928,14176,46104
14292,20,State - JHARKHAND,Total,65-69,Preprimary,22382,8470,30852
14293,20,State - JHARKHAND,Total,70-74,Preprimary,14974,4801,19775
14294,20,State - JHARKHAND,Total,75-79,Preprimary,6413,2332,8745
14295,20,State - JHARKHAND,Total,80+,Preprimary,7362,2866,10228
14296,20,State - JHARKHAND,Total,Age not stated,Preprimary,6858,5982,12840
14297,20,State - JHARKHAND,Rural,All ages,Preprimary,1851175,1595042,3446217
14298,20,State - JHARKHAND,Rural,0-6,Preprimary,0,0,0
14299,20,State - JHARKHAND,Rural,7,Preprimary,208824,197035,405859
14300,20,State - JHARKHAND,Rural,8,Preprimary,307834,286797,594631
14301,20,State - JHARKHAND,Rural,9,Preprimary,215781,205797,421578
14302,20,State - JHARKHAND,Rural,10,Preprimary,279576,255494,535070
14303,20,State - JHARKHAND,Rural,11,Preprimary,123662,116018,239680
14304,20,State - JHARKHAND,Rural,12,Preprimary,101341,94084,195425
14305,20,State - JHARKHAND,Rural,13,Preprimary,40170,39378,79548
14306,20,State - JHARKHAND,Rural,14,Preprimary,25046,24466,49512
14307,20,State - JHARKHAND,Rural,15,Preprimary,22057,18620,40677
14308,20,State - JHARKHAND,Rural,16,Preprimary,16374,13983,30357
14309,20,State - JHARKHAND,Rural,17,Preprimary,10463,8826,19289
14310,20,State - JHARKHAND,Rural,18,Preprimary,18860,16066,34926
14311,20,State - JHARKHAND,Rural,19,Preprimary,9749,11106,20855
14312,20,State - JHARKHAND,Rural,20-24,Preprimary,67471,66782,134253
14313,20,State - JHARKHAND,Rural,25-29,Preprimary,69053,61170,130223
14314,20,State - JHARKHAND,Rural,30-34,Preprimary,60036,48523,108559
14315,20,State - JHARKHAND,Rural,35-39,Preprimary,55780,38179,93959
14316,20,State - JHARKHAND,Rural,40-44,Preprimary,47462,26812,74274
14317,20,State - JHARKHAND,Rural,45-49,Preprimary,41491,19696,61187
14318,20,State - JHARKHAND,Rural,50-54,Preprimary,32069,13313,45382
14319,20,State - JHARKHAND,Rural,55-59,Preprimary,24997,10623,35620
14320,20,State - JHARKHAND,Rural,60-64,Preprimary,26808,8971,35779
14321,20,State - JHARKHAND,Rural,65-69,Preprimary,18941,4984,23925
14322,20,State - JHARKHAND,Rural,70-74,Preprimary,12582,2549,15131
14323,20,State - JHARKHAND,Rural,75-79,Preprimary,5280,1142,6422
14324,20,State - JHARKHAND,Rural,80+,Preprimary,5958,1534,7492
14325,20,State - JHARKHAND,Rural,Age not stated,Preprimary,3510,3094,6604
14326,20,State - JHARKHAND,Urban,All ages,Preprimary,441509,405689,847198
14327,20,State - JHARKHAND,Urban,0-6,Preprimary,0,0,0
14328,20,State - JHARKHAND,Urban,7,Preprimary,64955,58708,123663
14329,20,State - JHARKHAND,Urban,8,Preprimary,78969,71186,150155
14330,20,State - JHARKHAND,Urban,9,Preprimary,59319,53568,112887
14331,20,State - JHARKHAND,Urban,10,Preprimary,67057,57684,124741
14332,20,State - JHARKHAND,Urban,11,Preprimary,31849,27329,59178
14333,20,State - JHARKHAND,Urban,12,Preprimary,20912,17459,38371
14334,20,State - JHARKHAND,Urban,13,Preprimary,8520,7350,15870
14335,20,State - JHARKHAND,Urban,14,Preprimary,4933,4186,9119
14336,20,State - JHARKHAND,Urban,15,Preprimary,3820,2952,6772
14337,20,State - JHARKHAND,Urban,16,Preprimary,3173,2418,5591
14338,20,State - JHARKHAND,Urban,17,Preprimary,2301,1742,4043
14339,20,State - JHARKHAND,Urban,18,Preprimary,3726,2790,6516
14340,20,State - JHARKHAND,Urban,19,Preprimary,2103,1930,4033
14341,20,State - JHARKHAND,Urban,20-24,Preprimary,12023,12359,24382
14342,20,State - JHARKHAND,Urban,25-29,Preprimary,11074,12972,24046
14343,20,State - JHARKHAND,Urban,30-34,Preprimary,9751,11889,21640
14344,20,State - JHARKHAND,Urban,35-39,Preprimary,10059,11804,21863
14345,20,State - JHARKHAND,Urban,40-44,Preprimary,9304,9674,18978
14346,20,State - JHARKHAND,Urban,45-49,Preprimary,8670,8689,17359
14347,20,State - JHARKHAND,Urban,50-54,Preprimary,6781,6837,13618
14348,20,State - JHARKHAND,Urban,55-59,Preprimary,5372,5810,11182
14349,20,State - JHARKHAND,Urban,60-64,Preprimary,5120,5205,10325
14350,20,State - JHARKHAND,Urban,65-69,Preprimary,3441,3486,6927
14351,20,State - JHARKHAND,Urban,70-74,Preprimary,2392,2252,4644
14352,20,State - JHARKHAND,Urban,75-79,Preprimary,1133,1190,2323
14353,20,State - JHARKHAND,Urban,80+,Preprimary,1404,1332,2736
14354,20,State - JHARKHAND,Urban,Age not stated,Preprimary,3348,2888,6236
14355,21,State - ODISHA,Total,All ages,Preprimary,3126770,2759801,5886571
14356,21,State - ODISHA,Total,0-6,Preprimary,0,0,0
14357,21,State - ODISHA,Total,7,Preprimary,292650,280143,572793
14358,21,State - ODISHA,Total,8,Preprimary,365503,345338,710841
14359,21,State - ODISHA,Total,9,Preprimary,318451,302569,621020
14360,21,State - ODISHA,Total,10,Preprimary,253972,233160,487132
14361,21,State - ODISHA,Total,11,Preprimary,100617,91159,191776
14362,21,State - ODISHA,Total,12,Preprimary,52353,47552,99905
14363,21,State - ODISHA,Total,13,Preprimary,25528,24544,50072
14364,21,State - ODISHA,Total,14,Preprimary,20020,19896,39916
14365,21,State - ODISHA,Total,15,Preprimary,22255,21696,43951
14366,21,State - ODISHA,Total,16,Preprimary,19779,20183,39962
14367,21,State - ODISHA,Total,17,Preprimary,16613,17978,34591
14368,21,State - ODISHA,Total,18,Preprimary,26374,26988,53362
14369,21,State - ODISHA,Total,19,Preprimary,17369,19167,36536
14370,21,State - ODISHA,Total,20-24,Preprimary,112877,127036,239913
14371,21,State - ODISHA,Total,25-29,Preprimary,132121,152694,284815
14372,21,State - ODISHA,Total,30-34,Preprimary,138882,159440,298322
14373,21,State - ODISHA,Total,35-39,Preprimary,170369,171473,341842
14374,21,State - ODISHA,Total,40-44,Preprimary,174474,153592,328066
14375,21,State - ODISHA,Total,45-49,Preprimary,174339,138919,313258
14376,21,State - ODISHA,Total,50-54,Preprimary,143174,111212,254386
14377,21,State - ODISHA,Total,55-59,Preprimary,115714,92101,207815
14378,21,State - ODISHA,Total,60-64,Preprimary,136870,79902,216772
14379,21,State - ODISHA,Total,65-69,Preprimary,105532,50615,156147
14380,21,State - ODISHA,Total,70-74,Preprimary,88864,34246,123110
14381,21,State - ODISHA,Total,75-79,Preprimary,46610,16851,63461
14382,21,State - ODISHA,Total,80+,Preprimary,48894,15208,64102
14383,21,State - ODISHA,Total,Age not stated,Preprimary,6566,6139,12705
14384,21,State - ODISHA,Rural,All ages,Preprimary,2761589,2393228,5154817
14385,21,State - ODISHA,Rural,0-6,Preprimary,0,0,0
14386,21,State - ODISHA,Rural,7,Preprimary,243578,234525,478103
14387,21,State - ODISHA,Rural,8,Preprimary,309951,294721,604672
14388,21,State - ODISHA,Rural,9,Preprimary,271418,260597,532015
14389,21,State - ODISHA,Rural,10,Preprimary,217774,202041,419815
14390,21,State - ODISHA,Rural,11,Preprimary,87019,79764,166783
14391,21,State - ODISHA,Rural,12,Preprimary,45941,42167,88108
14392,21,State - ODISHA,Rural,13,Preprimary,22539,21895,44434
14393,21,State - ODISHA,Rural,14,Preprimary,17604,17764,35368
14394,21,State - ODISHA,Rural,15,Preprimary,19679,19498,39177
14395,21,State - ODISHA,Rural,16,Preprimary,17509,18098,35607
14396,21,State - ODISHA,Rural,17,Preprimary,14463,16002,30465
14397,21,State - ODISHA,Rural,18,Preprimary,23103,24149,47252
14398,21,State - ODISHA,Rural,19,Preprimary,15200,16962,32162
14399,21,State - ODISHA,Rural,20-24,Preprimary,100083,113236,213319
14400,21,State - ODISHA,Rural,25-29,Preprimary,118838,135759,254597
14401,21,State - ODISHA,Rural,30-34,Preprimary,125953,141834,267787
14402,21,State - ODISHA,Rural,35-39,Preprimary,155155,151575,306730
14403,21,State - ODISHA,Rural,40-44,Preprimary,159023,135210,294233
14404,21,State - ODISHA,Rural,45-49,Preprimary,159405,121035,280440
14405,21,State - ODISHA,Rural,50-54,Preprimary,131002,96628,227630
14406,21,State - ODISHA,Rural,55-59,Preprimary,106200,80359,186559
14407,21,State - ODISHA,Rural,60-64,Preprimary,126730,68672,195402
14408,21,State - ODISHA,Rural,65-69,Preprimary,98230,42750,140980
14409,21,State - ODISHA,Rural,70-74,Preprimary,82034,28117,110151
14410,21,State - ODISHA,Rural,75-79,Preprimary,42961,13293,56254
14411,21,State - ODISHA,Rural,80+,Preprimary,44525,11388,55913
14412,21,State - ODISHA,Rural,Age not stated,Preprimary,5672,5189,10861
14413,21,State - ODISHA,Urban,All ages,Preprimary,365181,366573,731754
14414,21,State - ODISHA,Urban,0-6,Preprimary,0,0,0
14415,21,State - ODISHA,Urban,7,Preprimary,49072,45618,94690
14416,21,State - ODISHA,Urban,8,Preprimary,55552,50617,106169
14417,21,State - ODISHA,Urban,9,Preprimary,47033,41972,89005
14418,21,State - ODISHA,Urban,10,Preprimary,36198,31119,67317
14419,21,State - ODISHA,Urban,11,Preprimary,13598,11395,24993
14420,21,State - ODISHA,Urban,12,Preprimary,6412,5385,11797
14421,21,State - ODISHA,Urban,13,Preprimary,2989,2649,5638
14422,21,State - ODISHA,Urban,14,Preprimary,2416,2132,4548
14423,21,State - ODISHA,Urban,15,Preprimary,2576,2198,4774
14424,21,State - ODISHA,Urban,16,Preprimary,2270,2085,4355
14425,21,State - ODISHA,Urban,17,Preprimary,2150,1976,4126
14426,21,State - ODISHA,Urban,18,Preprimary,3271,2839,6110
14427,21,State - ODISHA,Urban,19,Preprimary,2169,2205,4374
14428,21,State - ODISHA,Urban,20-24,Preprimary,12794,13800,26594
14429,21,State - ODISHA,Urban,25-29,Preprimary,13283,16935,30218
14430,21,State - ODISHA,Urban,30-34,Preprimary,12929,17606,30535
14431,21,State - ODISHA,Urban,35-39,Preprimary,15214,19898,35112
14432,21,State - ODISHA,Urban,40-44,Preprimary,15451,18382,33833
14433,21,State - ODISHA,Urban,45-49,Preprimary,14934,17884,32818
14434,21,State - ODISHA,Urban,50-54,Preprimary,12172,14584,26756
14435,21,State - ODISHA,Urban,55-59,Preprimary,9514,11742,21256
14436,21,State - ODISHA,Urban,60-64,Preprimary,10140,11230,21370
14437,21,State - ODISHA,Urban,65-69,Preprimary,7302,7865,15167
14438,21,State - ODISHA,Urban,70-74,Preprimary,6830,6129,12959
14439,21,State - ODISHA,Urban,75-79,Preprimary,3649,3558,7207
14440,21,State - ODISHA,Urban,80+,Preprimary,4369,3820,8189
14441,21,State - ODISHA,Urban,Age not stated,Preprimary,894,950,1844
14442,22,State - CHHATTISGARH,Total,All ages,Preprimary,2011523,1675846,3687369
14443,22,State - CHHATTISGARH,Total,0-6,Preprimary,0,0,0
14444,22,State - CHHATTISGARH,Total,7,Preprimary,184007,177371,361378
14445,22,State - CHHATTISGARH,Total,8,Preprimary,251237,238441,489678
14446,22,State - CHHATTISGARH,Total,9,Preprimary,233333,225225,458558
14447,22,State - CHHATTISGARH,Total,10,Preprimary,248234,232944,481178
14448,22,State - CHHATTISGARH,Total,11,Preprimary,130616,121338,251954
14449,22,State - CHHATTISGARH,Total,12,Preprimary,64233,58069,122302
14450,22,State - CHHATTISGARH,Total,13,Preprimary,27576,25401,52977
14451,22,State - CHHATTISGARH,Total,14,Preprimary,18693,16896,35589
14452,22,State - CHHATTISGARH,Total,15,Preprimary,17231,15045,32276
14453,22,State - CHHATTISGARH,Total,16,Preprimary,14920,14486,29406
14454,22,State - CHHATTISGARH,Total,17,Preprimary,12191,11804,23995
14455,22,State - CHHATTISGARH,Total,18,Preprimary,17657,16565,34222
14456,22,State - CHHATTISGARH,Total,19,Preprimary,11592,11950,23542
14457,22,State - CHHATTISGARH,Total,20-24,Preprimary,66317,70255,136572
14458,22,State - CHHATTISGARH,Total,25-29,Preprimary,65841,68054,133895
14459,22,State - CHHATTISGARH,Total,30-34,Preprimary,67320,72502,139822
14460,22,State - CHHATTISGARH,Total,35-39,Preprimary,82647,71025,153672
14461,22,State - CHHATTISGARH,Total,40-44,Preprimary,89693,59751,149444
14462,22,State - CHHATTISGARH,Total,45-49,Preprimary,96232,46907,143139
14463,22,State - CHHATTISGARH,Total,50-54,Preprimary,73098,34072,107170
14464,22,State - CHHATTISGARH,Total,55-59,Preprimary,56866,26631,83497
14465,22,State - CHHATTISGARH,Total,60-64,Preprimary,56480,23783,80263
14466,22,State - CHHATTISGARH,Total,65-69,Preprimary,49943,16411,66354
14467,22,State - CHHATTISGARH,Total,70-74,Preprimary,38291,9885,48176
14468,22,State - CHHATTISGARH,Total,75-79,Preprimary,18098,4771,22869
14469,22,State - CHHATTISGARH,Total,80+,Preprimary,17593,4899,22492
14470,22,State - CHHATTISGARH,Total,Age not stated,Preprimary,1584,1365,2949
14471,22,State - CHHATTISGARH,Rural,All ages,Preprimary,1642972,1340802,2983774
14472,22,State - CHHATTISGARH,Rural,0-6,Preprimary,0,0,0
14473,22,State - CHHATTISGARH,Rural,7,Preprimary,139396,134919,274315
14474,22,State - CHHATTISGARH,Rural,8,Preprimary,197800,189199,386999
14475,22,State - CHHATTISGARH,Rural,9,Preprimary,186116,181647,367763
14476,22,State - CHHATTISGARH,Rural,10,Preprimary,202252,192189,394441
14477,22,State - CHHATTISGARH,Rural,11,Preprimary,109293,103005,212298
14478,22,State - CHHATTISGARH,Rural,12,Preprimary,53735,49598,103333
14479,22,State - CHHATTISGARH,Rural,13,Preprimary,22904,21532,44436
14480,22,State - CHHATTISGARH,Rural,14,Preprimary,15332,14351,29683
14481,22,State - CHHATTISGARH,Rural,15,Preprimary,14088,12722,26810
14482,22,State - CHHATTISGARH,Rural,16,Preprimary,11985,12354,24339
14483,22,State - CHHATTISGARH,Rural,17,Preprimary,9591,9891,19482
14484,22,State - CHHATTISGARH,Rural,18,Preprimary,13950,14006,27956
14485,22,State - CHHATTISGARH,Rural,19,Preprimary,9021,9913,18934
14486,22,State - CHHATTISGARH,Rural,20-24,Preprimary,53303,58613,111916
14487,22,State - CHHATTISGARH,Rural,25-29,Preprimary,54073,55412,109485
14488,22,State - CHHATTISGARH,Rural,30-34,Preprimary,55999,58954,114953
14489,22,State - CHHATTISGARH,Rural,35-39,Preprimary,69576,56753,126329
14490,22,State - CHHATTISGARH,Rural,40-44,Preprimary,76199,46674,122873
14491,22,State - CHHATTISGARH,Rural,45-49,Preprimary,82057,35196,117253
14492,22,State - CHHATTISGARH,Rural,50-54,Preprimary,62130,25182,87312
14493,22,State - CHHATTISGARH,Rural,55-59,Preprimary,48791,19572,68363
14494,22,State - CHHATTISGARH,Rural,60-64,Preprimary,48688,16654,65342
14495,22,State - CHHATTISGARH,Rural,65-69,Preprimary,43254,10604,53858
14496,22,State - CHHATTISGARH,Rural,70-74,Preprimary,32627,5798,38425
14497,22,State - CHHATTISGARH,Rural,75-79,Preprimary,15088,2544,17632
14498,22,State - CHHATTISGARH,Rural,80+,Preprimary,14718,2647,17365
14499,22,State - CHHATTISGARH,Rural,Age not stated,Preprimary,1006,873,1879
14500,22,State - CHHATTISGARH,Urban,All ages,Preprimary,368551,335044,703595
14501,22,State - CHHATTISGARH,Urban,0-6,Preprimary,0,0,0
14502,22,State - CHHATTISGARH,Urban,7,Preprimary,44611,42452,87063
14503,22,State - CHHATTISGARH,Urban,8,Preprimary,53437,49242,102679
14504,22,State - CHHATTISGARH,Urban,9,Preprimary,47217,43578,90795
14505,22,State - CHHATTISGARH,Urban,10,Preprimary,45982,40755,86737
14506,22,State - CHHATTISGARH,Urban,11,Preprimary,21323,18333,39656
14507,22,State - CHHATTISGARH,Urban,12,Preprimary,10498,8471,18969
14508,22,State - CHHATTISGARH,Urban,13,Preprimary,4672,3869,8541
14509,22,State - CHHATTISGARH,Urban,14,Preprimary,3361,2545,5906
14510,22,State - CHHATTISGARH,Urban,15,Preprimary,3143,2323,5466
14511,22,State - CHHATTISGARH,Urban,16,Preprimary,2935,2132,5067
14512,22,State - CHHATTISGARH,Urban,17,Preprimary,2600,1913,4513
14513,22,State - CHHATTISGARH,Urban,18,Preprimary,3707,2559,6266
14514,22,State - CHHATTISGARH,Urban,19,Preprimary,2571,2037,4608
14515,22,State - CHHATTISGARH,Urban,20-24,Preprimary,13014,11642,24656
14516,22,State - CHHATTISGARH,Urban,25-29,Preprimary,11768,12642,24410
14517,22,State - CHHATTISGARH,Urban,30-34,Preprimary,11321,13548,24869
14518,22,State - CHHATTISGARH,Urban,35-39,Preprimary,13071,14272,27343
14519,22,State - CHHATTISGARH,Urban,40-44,Preprimary,13494,13077,26571
14520,22,State - CHHATTISGARH,Urban,45-49,Preprimary,14175,11711,25886
14521,22,State - CHHATTISGARH,Urban,50-54,Preprimary,10968,8890,19858
14522,22,State - CHHATTISGARH,Urban,55-59,Preprimary,8075,7059,15134
14523,22,State - CHHATTISGARH,Urban,60-64,Preprimary,7792,7129,14921
14524,22,State - CHHATTISGARH,Urban,65-69,Preprimary,6689,5807,12496
14525,22,State - CHHATTISGARH,Urban,70-74,Preprimary,5664,4087,9751
14526,22,State - CHHATTISGARH,Urban,75-79,Preprimary,3010,2227,5237
14527,22,State - CHHATTISGARH,Urban,80+,Preprimary,2875,2252,5127
14528,22,State - CHHATTISGARH,Urban,Age not stated,Preprimary,578,492,1070
14529,23,State - MADHYA PRADESH,Total,All ages,Preprimary,5242949,4339265,9582214
14530,23,State - MADHYA PRADESH,Total,0-6,Preprimary,0,0,0
14531,23,State - MADHYA PRADESH,Total,7,Preprimary,586611,546311,1132922
14532,23,State - MADHYA PRADESH,Total,8,Preprimary,789944,728810,1518754
14533,23,State - MADHYA PRADESH,Total,9,Preprimary,644646,599184,1243830
14534,23,State - MADHYA PRADESH,Total,10,Preprimary,653264,602491,1255755
14535,23,State - MADHYA PRADESH,Total,11,Preprimary,320577,279336,599913
14536,23,State - MADHYA PRADESH,Total,12,Preprimary,190600,169695,360295
14537,23,State - MADHYA PRADESH,Total,13,Preprimary,97706,79900,177606
14538,23,State - MADHYA PRADESH,Total,14,Preprimary,59267,55378,114645
14539,23,State - MADHYA PRADESH,Total,15,Preprimary,54292,46519,100811
14540,23,State - MADHYA PRADESH,Total,16,Preprimary,55261,46335,101596
14541,23,State - MADHYA PRADESH,Total,17,Preprimary,34806,29471,64277
14542,23,State - MADHYA PRADESH,Total,18,Preprimary,57456,42052,99508
14543,23,State - MADHYA PRADESH,Total,19,Preprimary,31463,28058,59521
14544,23,State - MADHYA PRADESH,Total,20-24,Preprimary,191275,162473,353748
14545,23,State - MADHYA PRADESH,Total,25-29,Preprimary,179012,158341,337353
14546,23,State - MADHYA PRADESH,Total,30-34,Preprimary,178892,156219,335111
14547,23,State - MADHYA PRADESH,Total,35-39,Preprimary,186598,142908,329506
14548,23,State - MADHYA PRADESH,Total,40-44,Preprimary,181841,119657,301498
14549,23,State - MADHYA PRADESH,Total,45-49,Preprimary,171772,94545,266317
14550,23,State - MADHYA PRADESH,Total,50-54,Preprimary,139125,68040,207165
14551,23,State - MADHYA PRADESH,Total,55-59,Preprimary,100221,51468,151689
14552,23,State - MADHYA PRADESH,Total,60-64,Preprimary,103792,46777,150569
14553,23,State - MADHYA PRADESH,Total,65-69,Preprimary,83503,32834,116337
14554,23,State - MADHYA PRADESH,Total,70-74,Preprimary,69165,22634,91799
14555,23,State - MADHYA PRADESH,Total,75-79,Preprimary,35364,11884,47248
14556,23,State - MADHYA PRADESH,Total,80+,Preprimary,41850,13953,55803
14557,23,State - MADHYA PRADESH,Total,Age not stated,Preprimary,4646,3992,8638
14558,23,State - MADHYA PRADESH,Rural,All ages,Preprimary,4119981,3359669,7479650
14559,23,State - MADHYA PRADESH,Rural,0-6,Preprimary,0,0,0
14560,23,State - MADHYA PRADESH,Rural,7,Preprimary,433401,407392,840793
14561,23,State - MADHYA PRADESH,Rural,8,Preprimary,603508,563739,1167247
14562,23,State - MADHYA PRADESH,Rural,9,Preprimary,488724,462769,951493
14563,23,State - MADHYA PRADESH,Rural,10,Preprimary,504136,475605,979741
14564,23,State - MADHYA PRADESH,Rural,11,Preprimary,250100,223877,473977
14565,23,State - MADHYA PRADESH,Rural,12,Preprimary,152454,140190,292644
14566,23,State - MADHYA PRADESH,Rural,13,Preprimary,77752,65731,143483
14567,23,State - MADHYA PRADESH,Rural,14,Preprimary,47381,46325,93706
14568,23,State - MADHYA PRADESH,Rural,15,Preprimary,43857,39463,83320
14569,23,State - MADHYA PRADESH,Rural,16,Preprimary,44410,38780,83190
14570,23,State - MADHYA PRADESH,Rural,17,Preprimary,27218,24650,51868
14571,23,State - MADHYA PRADESH,Rural,18,Preprimary,45542,35561,81103
14572,23,State - MADHYA PRADESH,Rural,19,Preprimary,24342,23425,47767
14573,23,State - MADHYA PRADESH,Rural,20-24,Preprimary,154450,135637,290087
14574,23,State - MADHYA PRADESH,Rural,25-29,Preprimary,149001,129289,278290
14575,23,State - MADHYA PRADESH,Rural,30-34,Preprimary,150225,125690,275915
14576,23,State - MADHYA PRADESH,Rural,35-39,Preprimary,156750,110506,267256
14577,23,State - MADHYA PRADESH,Rural,40-44,Preprimary,152134,89870,242004
14578,23,State - MADHYA PRADESH,Rural,45-49,Preprimary,142973,67611,210584
14579,23,State - MADHYA PRADESH,Rural,50-54,Preprimary,115346,46923,162269
14580,23,State - MADHYA PRADESH,Rural,55-59,Preprimary,83522,34043,117565
14581,23,State - MADHYA PRADESH,Rural,60-64,Preprimary,85666,28726,114392
14582,23,State - MADHYA PRADESH,Rural,65-69,Preprimary,68806,18349,87155
14583,23,State - MADHYA PRADESH,Rural,70-74,Preprimary,55430,11317,66747
14584,23,State - MADHYA PRADESH,Rural,75-79,Preprimary,27585,5246,32831
14585,23,State - MADHYA PRADESH,Rural,80+,Preprimary,32200,6412,38612
14586,23,State - MADHYA PRADESH,Rural,Age not stated,Preprimary,3068,2543,5611
14587,23,State - MADHYA PRADESH,Urban,All ages,Preprimary,1122968,979596,2102564
14588,23,State - MADHYA PRADESH,Urban,0-6,Preprimary,0,0,0
14589,23,State - MADHYA PRADESH,Urban,7,Preprimary,153210,138919,292129
14590,23,State - MADHYA PRADESH,Urban,8,Preprimary,186436,165071,351507
14591,23,State - MADHYA PRADESH,Urban,9,Preprimary,155922,136415,292337
14592,23,State - MADHYA PRADESH,Urban,10,Preprimary,149128,126886,276014
14593,23,State - MADHYA PRADESH,Urban,11,Preprimary,70477,55459,125936
14594,23,State - MADHYA PRADESH,Urban,12,Preprimary,38146,29505,67651
14595,23,State - MADHYA PRADESH,Urban,13,Preprimary,19954,14169,34123
14596,23,State - MADHYA PRADESH,Urban,14,Preprimary,11886,9053,20939
14597,23,State - MADHYA PRADESH,Urban,15,Preprimary,10435,7056,17491
14598,23,State - MADHYA PRADESH,Urban,16,Preprimary,10851,7555,18406
14599,23,State - MADHYA PRADESH,Urban,17,Preprimary,7588,4821,12409
14600,23,State - MADHYA PRADESH,Urban,18,Preprimary,11914,6491,18405
14601,23,State - MADHYA PRADESH,Urban,19,Preprimary,7121,4633,11754
14602,23,State - MADHYA PRADESH,Urban,20-24,Preprimary,36825,26836,63661
14603,23,State - MADHYA PRADESH,Urban,25-29,Preprimary,30011,29052,59063
14604,23,State - MADHYA PRADESH,Urban,30-34,Preprimary,28667,30529,59196
14605,23,State - MADHYA PRADESH,Urban,35-39,Preprimary,29848,32402,62250
14606,23,State - MADHYA PRADESH,Urban,40-44,Preprimary,29707,29787,59494
14607,23,State - MADHYA PRADESH,Urban,45-49,Preprimary,28799,26934,55733
14608,23,State - MADHYA PRADESH,Urban,50-54,Preprimary,23779,21117,44896
14609,23,State - MADHYA PRADESH,Urban,55-59,Preprimary,16699,17425,34124
14610,23,State - MADHYA PRADESH,Urban,60-64,Preprimary,18126,18051,36177
14611,23,State - MADHYA PRADESH,Urban,65-69,Preprimary,14697,14485,29182
14612,23,State - MADHYA PRADESH,Urban,70-74,Preprimary,13735,11317,25052
14613,23,State - MADHYA PRADESH,Urban,75-79,Preprimary,7779,6638,14417
14614,23,State - MADHYA PRADESH,Urban,80+,Preprimary,9650,7541,17191
14615,23,State - MADHYA PRADESH,Urban,Age not stated,Preprimary,1578,1449,3027
14616,24,State - GUJARAT,Total,All ages,Preprimary,4486708,3976121,8462829
14617,24,State - GUJARAT,Total,0-6,Preprimary,0,0,0
14618,24,State - GUJARAT,Total,7,Preprimary,500000,428835,928835
14619,24,State - GUJARAT,Total,8,Preprimary,559703,479174,1038877
14620,24,State - GUJARAT,Total,9,Preprimary,499621,419988,919609
14621,24,State - GUJARAT,Total,10,Preprimary,373972,312650,686622
14622,24,State - GUJARAT,Total,11,Preprimary,145932,123754,269686
14623,24,State - GUJARAT,Total,12,Preprimary,70334,65397,135731
14624,24,State - GUJARAT,Total,13,Preprimary,39078,41285,80363
14625,24,State - GUJARAT,Total,14,Preprimary,31148,36171,67319
14626,24,State - GUJARAT,Total,15,Preprimary,34703,39157,73860
14627,24,State - GUJARAT,Total,16,Preprimary,31383,36016,67399
14628,24,State - GUJARAT,Total,17,Preprimary,29464,32705,62169
14629,24,State - GUJARAT,Total,18,Preprimary,40828,43164,83992
14630,24,State - GUJARAT,Total,19,Preprimary,29619,34927,64546
14631,24,State - GUJARAT,Total,20-24,Preprimary,193744,214017,407761
14632,24,State - GUJARAT,Total,25-29,Preprimary,209159,224418,433577
14633,24,State - GUJARAT,Total,30-34,Preprimary,218115,231173,449288
14634,24,State - GUJARAT,Total,35-39,Preprimary,238323,219171,457494
14635,24,State - GUJARAT,Total,40-44,Preprimary,244022,207133,451155
14636,24,State - GUJARAT,Total,45-49,Preprimary,229369,180479,409848
14637,24,State - GUJARAT,Total,50-54,Preprimary,202609,152058,354667
14638,24,State - GUJARAT,Total,55-59,Preprimary,150746,121736,272482
14639,24,State - GUJARAT,Total,60-64,Preprimary,137752,106378,244130
14640,24,State - GUJARAT,Total,65-69,Preprimary,98281,77915,176196
14641,24,State - GUJARAT,Total,70-74,Preprimary,79743,60861,140604
14642,24,State - GUJARAT,Total,75-79,Preprimary,40484,34504,74988
14643,24,State - GUJARAT,Total,80+,Preprimary,42958,38700,81658
14644,24,State - GUJARAT,Total,Age not stated,Preprimary,15618,14355,29973
14645,24,State - GUJARAT,Rural,All ages,Preprimary,2959945,2578827,5538772
14646,24,State - GUJARAT,Rural,0-6,Preprimary,0,0,0
14647,24,State - GUJARAT,Rural,7,Preprimary,296372,263025,559397
14648,24,State - GUJARAT,Rural,8,Preprimary,344284,304519,648803
14649,24,State - GUJARAT,Rural,9,Preprimary,309015,269304,578319
14650,24,State - GUJARAT,Rural,10,Preprimary,228834,199708,428542
14651,24,State - GUJARAT,Rural,11,Preprimary,92438,81911,174349
14652,24,State - GUJARAT,Rural,12,Preprimary,46270,45733,92003
14653,24,State - GUJARAT,Rural,13,Preprimary,26409,29596,56005
14654,24,State - GUJARAT,Rural,14,Preprimary,21482,26554,48036
14655,24,State - GUJARAT,Rural,15,Preprimary,24288,29327,53615
14656,24,State - GUJARAT,Rural,16,Preprimary,21768,26947,48715
14657,24,State - GUJARAT,Rural,17,Preprimary,19803,24148,43951
14658,24,State - GUJARAT,Rural,18,Preprimary,27009,32198,59207
14659,24,State - GUJARAT,Rural,19,Preprimary,19062,25420,44482
14660,24,State - GUJARAT,Rural,20-24,Preprimary,132122,155654,287776
14661,24,State - GUJARAT,Rural,25-29,Preprimary,147892,160717,308609
14662,24,State - GUJARAT,Rural,30-34,Preprimary,156816,163853,320669
14663,24,State - GUJARAT,Rural,35-39,Preprimary,172290,149776,322066
14664,24,State - GUJARAT,Rural,40-44,Preprimary,174367,136322,310689
14665,24,State - GUJARAT,Rural,45-49,Preprimary,162215,111870,274085
14666,24,State - GUJARAT,Rural,50-54,Preprimary,142492,92504,234996
14667,24,State - GUJARAT,Rural,55-59,Preprimary,107702,72970,180672
14668,24,State - GUJARAT,Rural,60-64,Preprimary,99034,61146,160180
14669,24,State - GUJARAT,Rural,65-69,Preprimary,69614,42663,112277
14670,24,State - GUJARAT,Rural,70-74,Preprimary,55574,31368,86942
14671,24,State - GUJARAT,Rural,75-79,Preprimary,26321,15896,42217
14672,24,State - GUJARAT,Rural,80+,Preprimary,27740,17668,45408
14673,24,State - GUJARAT,Rural,Age not stated,Preprimary,8732,8030,16762
14674,24,State - GUJARAT,Urban,All ages,Preprimary,1526763,1397294,2924057
14675,24,State - GUJARAT,Urban,0-6,Preprimary,0,0,0
14676,24,State - GUJARAT,Urban,7,Preprimary,203628,165810,369438
14677,24,State - GUJARAT,Urban,8,Preprimary,215419,174655,390074
14678,24,State - GUJARAT,Urban,9,Preprimary,190606,150684,341290
14679,24,State - GUJARAT,Urban,10,Preprimary,145138,112942,258080
14680,24,State - GUJARAT,Urban,11,Preprimary,53494,41843,95337
14681,24,State - GUJARAT,Urban,12,Preprimary,24064,19664,43728
14682,24,State - GUJARAT,Urban,13,Preprimary,12669,11689,24358
14683,24,State - GUJARAT,Urban,14,Preprimary,9666,9617,19283
14684,24,State - GUJARAT,Urban,15,Preprimary,10415,9830,20245
14685,24,State - GUJARAT,Urban,16,Preprimary,9615,9069,18684
14686,24,State - GUJARAT,Urban,17,Preprimary,9661,8557,18218
14687,24,State - GUJARAT,Urban,18,Preprimary,13819,10966,24785
14688,24,State - GUJARAT,Urban,19,Preprimary,10557,9507,20064
14689,24,State - GUJARAT,Urban,20-24,Preprimary,61622,58363,119985
14690,24,State - GUJARAT,Urban,25-29,Preprimary,61267,63701,124968
14691,24,State - GUJARAT,Urban,30-34,Preprimary,61299,67320,128619
14692,24,State - GUJARAT,Urban,35-39,Preprimary,66033,69395,135428
14693,24,State - GUJARAT,Urban,40-44,Preprimary,69655,70811,140466
14694,24,State - GUJARAT,Urban,45-49,Preprimary,67154,68609,135763
14695,24,State - GUJARAT,Urban,50-54,Preprimary,60117,59554,119671
14696,24,State - GUJARAT,Urban,55-59,Preprimary,43044,48766,91810
14697,24,State - GUJARAT,Urban,60-64,Preprimary,38718,45232,83950
14698,24,State - GUJARAT,Urban,65-69,Preprimary,28667,35252,63919
14699,24,State - GUJARAT,Urban,70-74,Preprimary,24169,29493,53662
14700,24,State - GUJARAT,Urban,75-79,Preprimary,14163,18608,32771
14701,24,State - GUJARAT,Urban,80+,Preprimary,15218,21032,36250
14702,24,State - GUJARAT,Urban,Age not stated,Preprimary,6886,6325,13211
14703,25,State - DAMAN & DIU,Total,All ages,Preprimary,15332,11291,26623
14704,25,State - DAMAN & DIU,Total,0-6,Preprimary,0,0,0
14705,25,State - DAMAN & DIU,Total,7,Preprimary,1579,1435,3014
14706,25,State - DAMAN & DIU,Total,8,Preprimary,1771,1562,3333
14707,25,State - DAMAN & DIU,Total,9,Preprimary,1521,1278,2799
14708,25,State - DAMAN & DIU,Total,10,Preprimary,1136,979,2115
14709,25,State - DAMAN & DIU,Total,11,Preprimary,451,289,740
14710,25,State - DAMAN & DIU,Total,12,Preprimary,223,131,354
14711,25,State - DAMAN & DIU,Total,13,Preprimary,92,75,167
14712,25,State - DAMAN & DIU,Total,14,Preprimary,78,47,125
14713,25,State - DAMAN & DIU,Total,15,Preprimary,88,35,123
14714,25,State - DAMAN & DIU,Total,16,Preprimary,137,45,182
14715,25,State - DAMAN & DIU,Total,17,Preprimary,187,32,219
14716,25,State - DAMAN & DIU,Total,18,Preprimary,388,80,468
14717,25,State - DAMAN & DIU,Total,19,Preprimary,282,62,344
14718,25,State - DAMAN & DIU,Total,20-24,Preprimary,1501,507,2008
14719,25,State - DAMAN & DIU,Total,25-29,Preprimary,1125,635,1760
14720,25,State - DAMAN & DIU,Total,30-34,Preprimary,841,560,1401
14721,25,State - DAMAN & DIU,Total,35-39,Preprimary,808,606,1414
14722,25,State - DAMAN & DIU,Total,40-44,Preprimary,710,587,1297
14723,25,State - DAMAN & DIU,Total,45-49,Preprimary,572,478,1050
14724,25,State - DAMAN & DIU,Total,50-54,Preprimary,456,432,888
14725,25,State - DAMAN & DIU,Total,55-59,Preprimary,384,433,817
14726,25,State - DAMAN & DIU,Total,60-64,Preprimary,336,348,684
14727,25,State - DAMAN & DIU,Total,65-69,Preprimary,259,263,522
14728,25,State - DAMAN & DIU,Total,70-74,Preprimary,182,205,387
14729,25,State - DAMAN & DIU,Total,75-79,Preprimary,128,102,230
14730,25,State - DAMAN & DIU,Total,80+,Preprimary,82,77,159
14731,25,State - DAMAN & DIU,Total,Age not stated,Preprimary,15,8,23
14732,25,State - DAMAN & DIU,Rural,All ages,Preprimary,4407,3559,7966
14733,25,State - DAMAN & DIU,Rural,0-6,Preprimary,0,0,0
14734,25,State - DAMAN & DIU,Rural,7,Preprimary,478,468,946
14735,25,State - DAMAN & DIU,Rural,8,Preprimary,584,540,1124
14736,25,State - DAMAN & DIU,Rural,9,Preprimary,502,451,953
14737,25,State - DAMAN & DIU,Rural,10,Preprimary,311,316,627
14738,25,State - DAMAN & DIU,Rural,11,Preprimary,119,84,203
14739,25,State - DAMAN & DIU,Rural,12,Preprimary,51,21,72
14740,25,State - DAMAN & DIU,Rural,13,Preprimary,17,16,33
14741,25,State - DAMAN & DIU,Rural,14,Preprimary,15,5,20
14742,25,State - DAMAN & DIU,Rural,15,Preprimary,15,7,22
14743,25,State - DAMAN & DIU,Rural,16,Preprimary,23,9,32
14744,25,State - DAMAN & DIU,Rural,17,Preprimary,21,11,32
14745,25,State - DAMAN & DIU,Rural,18,Preprimary,44,27,71
14746,25,State - DAMAN & DIU,Rural,19,Preprimary,33,17,50
14747,25,State - DAMAN & DIU,Rural,20-24,Preprimary,197,141,338
14748,25,State - DAMAN & DIU,Rural,25-29,Preprimary,213,195,408
14749,25,State - DAMAN & DIU,Rural,30-34,Preprimary,214,194,408
14750,25,State - DAMAN & DIU,Rural,35-39,Preprimary,280,249,529
14751,25,State - DAMAN & DIU,Rural,40-44,Preprimary,298,250,548
14752,25,State - DAMAN & DIU,Rural,45-49,Preprimary,273,161,434
14753,25,State - DAMAN & DIU,Rural,50-54,Preprimary,218,139,357
14754,25,State - DAMAN & DIU,Rural,55-59,Preprimary,159,85,244
14755,25,State - DAMAN & DIU,Rural,60-64,Preprimary,134,68,202
14756,25,State - DAMAN & DIU,Rural,65-69,Preprimary,103,48,151
14757,25,State - DAMAN & DIU,Rural,70-74,Preprimary,53,31,84
14758,25,State - DAMAN & DIU,Rural,75-79,Preprimary,27,11,38
14759,25,State - DAMAN & DIU,Rural,80+,Preprimary,23,13,36
14760,25,State - DAMAN & DIU,Rural,Age not stated,Preprimary,2,2,4
14761,25,State - DAMAN & DIU,Urban,All ages,Preprimary,10925,7732,18657
14762,25,State - DAMAN & DIU,Urban,0-6,Preprimary,0,0,0
14763,25,State - DAMAN & DIU,Urban,7,Preprimary,1101,967,2068
14764,25,State - DAMAN & DIU,Urban,8,Preprimary,1187,1022,2209
14765,25,State - DAMAN & DIU,Urban,9,Preprimary,1019,827,1846
14766,25,State - DAMAN & DIU,Urban,10,Preprimary,825,663,1488
14767,25,State - DAMAN & DIU,Urban,11,Preprimary,332,205,537
14768,25,State - DAMAN & DIU,Urban,12,Preprimary,172,110,282
14769,25,State - DAMAN & DIU,Urban,13,Preprimary,75,59,134
14770,25,State - DAMAN & DIU,Urban,14,Preprimary,63,42,105
14771,25,State - DAMAN & DIU,Urban,15,Preprimary,73,28,101
14772,25,State - DAMAN & DIU,Urban,16,Preprimary,114,36,150
14773,25,State - DAMAN & DIU,Urban,17,Preprimary,166,21,187
14774,25,State - DAMAN & DIU,Urban,18,Preprimary,344,53,397
14775,25,State - DAMAN & DIU,Urban,19,Preprimary,249,45,294
14776,25,State - DAMAN & DIU,Urban,20-24,Preprimary,1304,366,1670
14777,25,State - DAMAN & DIU,Urban,25-29,Preprimary,912,440,1352
14778,25,State - DAMAN & DIU,Urban,30-34,Preprimary,627,366,993
14779,25,State - DAMAN & DIU,Urban,35-39,Preprimary,528,357,885
14780,25,State - DAMAN & DIU,Urban,40-44,Preprimary,412,337,749
14781,25,State - DAMAN & DIU,Urban,45-49,Preprimary,299,317,616
14782,25,State - DAMAN & DIU,Urban,50-54,Preprimary,238,293,531
14783,25,State - DAMAN & DIU,Urban,55-59,Preprimary,225,348,573
14784,25,State - DAMAN & DIU,Urban,60-64,Preprimary,202,280,482
14785,25,State - DAMAN & DIU,Urban,65-69,Preprimary,156,215,371
14786,25,State - DAMAN & DIU,Urban,70-74,Preprimary,129,174,303
14787,25,State - DAMAN & DIU,Urban,75-79,Preprimary,101,91,192
14788,25,State - DAMAN & DIU,Urban,80+,Preprimary,59,64,123
14789,25,State - DAMAN & DIU,Urban,Age not stated,Preprimary,13,6,19
14790,26,State - DADRA & NAGAR HAVELI,Total,All ages,Preprimary,24482,19227,43709
14791,26,State - DADRA & NAGAR HAVELI,Total,0-6,Preprimary,0,0,0
14792,26,State - DADRA & NAGAR HAVELI,Total,7,Preprimary,3262,2875,6137
14793,26,State - DADRA & NAGAR HAVELI,Total,8,Preprimary,3619,3253,6872
14794,26,State - DADRA & NAGAR HAVELI,Total,9,Preprimary,3083,2744,5827
14795,26,State - DADRA & NAGAR HAVELI,Total,10,Preprimary,2349,2059,4408
14796,26,State - DADRA & NAGAR HAVELI,Total,11,Preprimary,1093,935,2028
14797,26,State - DADRA & NAGAR HAVELI,Total,12,Preprimary,430,499,929
14798,26,State - DADRA & NAGAR HAVELI,Total,13,Preprimary,259,284,543
14799,26,State - DADRA & NAGAR HAVELI,Total,14,Preprimary,158,254,412
14800,26,State - DADRA & NAGAR HAVELI,Total,15,Preprimary,154,243,397
14801,26,State - DADRA & NAGAR HAVELI,Total,16,Preprimary,182,272,454
14802,26,State - DADRA & NAGAR HAVELI,Total,17,Preprimary,198,208,406
14803,26,State - DADRA & NAGAR HAVELI,Total,18,Preprimary,309,245,554
14804,26,State - DADRA & NAGAR HAVELI,Total,19,Preprimary,288,214,502
14805,26,State - DADRA & NAGAR HAVELI,Total,20-24,Preprimary,1631,1180,2811
14806,26,State - DADRA & NAGAR HAVELI,Total,25-29,Preprimary,1509,990,2499
14807,26,State - DADRA & NAGAR HAVELI,Total,30-34,Preprimary,1178,759,1937
14808,26,State - DADRA & NAGAR HAVELI,Total,35-39,Preprimary,1169,640,1809
14809,26,State - DADRA & NAGAR HAVELI,Total,40-44,Preprimary,994,447,1441
14810,26,State - DADRA & NAGAR HAVELI,Total,45-49,Preprimary,877,375,1252
14811,26,State - DADRA & NAGAR HAVELI,Total,50-54,Preprimary,612,228,840
14812,26,State - DADRA & NAGAR HAVELI,Total,55-59,Preprimary,378,156,534
14813,26,State - DADRA & NAGAR HAVELI,Total,60-64,Preprimary,342,134,476
14814,26,State - DADRA & NAGAR HAVELI,Total,65-69,Preprimary,178,85,263
14815,26,State - DADRA & NAGAR HAVELI,Total,70-74,Preprimary,115,52,167
14816,26,State - DADRA & NAGAR HAVELI,Total,75-79,Preprimary,37,39,76
14817,26,State - DADRA & NAGAR HAVELI,Total,80+,Preprimary,51,43,94
14818,26,State - DADRA & NAGAR HAVELI,Total,Age not stated,Preprimary,27,14,41
14819,26,State - DADRA & NAGAR HAVELI,Rural,All ages,Preprimary,15424,11950,27374
14820,26,State - DADRA & NAGAR HAVELI,Rural,0-6,Preprimary,0,0,0
14821,26,State - DADRA & NAGAR HAVELI,Rural,7,Preprimary,1851,1696,3547
14822,26,State - DADRA & NAGAR HAVELI,Rural,8,Preprimary,2206,2029,4235
14823,26,State - DADRA & NAGAR HAVELI,Rural,9,Preprimary,1797,1764,3561
14824,26,State - DADRA & NAGAR HAVELI,Rural,10,Preprimary,1477,1312,2789
14825,26,State - DADRA & NAGAR HAVELI,Rural,11,Preprimary,706,679,1385
14826,26,State - DADRA & NAGAR HAVELI,Rural,12,Preprimary,307,398,705
14827,26,State - DADRA & NAGAR HAVELI,Rural,13,Preprimary,193,237,430
14828,26,State - DADRA & NAGAR HAVELI,Rural,14,Preprimary,127,218,345
14829,26,State - DADRA & NAGAR HAVELI,Rural,15,Preprimary,118,217,335
14830,26,State - DADRA & NAGAR HAVELI,Rural,16,Preprimary,135,234,369
14831,26,State - DADRA & NAGAR HAVELI,Rural,17,Preprimary,156,182,338
14832,26,State - DADRA & NAGAR HAVELI,Rural,18,Preprimary,170,204,374
14833,26,State - DADRA & NAGAR HAVELI,Rural,19,Preprimary,167,176,343
14834,26,State - DADRA & NAGAR HAVELI,Rural,20-24,Preprimary,1078,841,1919
14835,26,State - DADRA & NAGAR HAVELI,Rural,25-29,Preprimary,1040,562,1602
14836,26,State - DADRA & NAGAR HAVELI,Rural,30-34,Preprimary,837,377,1214
14837,26,State - DADRA & NAGAR HAVELI,Rural,35-39,Preprimary,808,284,1092
14838,26,State - DADRA & NAGAR HAVELI,Rural,40-44,Preprimary,663,195,858
14839,26,State - DADRA & NAGAR HAVELI,Rural,45-49,Preprimary,582,151,733
14840,26,State - DADRA & NAGAR HAVELI,Rural,50-54,Preprimary,399,73,472
14841,26,State - DADRA & NAGAR HAVELI,Rural,55-59,Preprimary,240,53,293
14842,26,State - DADRA & NAGAR HAVELI,Rural,60-64,Preprimary,188,28,216
14843,26,State - DADRA & NAGAR HAVELI,Rural,65-69,Preprimary,94,21,115
14844,26,State - DADRA & NAGAR HAVELI,Rural,70-74,Preprimary,46,1,47
14845,26,State - DADRA & NAGAR HAVELI,Rural,75-79,Preprimary,8,5,13
14846,26,State - DADRA & NAGAR HAVELI,Rural,80+,Preprimary,9,6,15
14847,26,State - DADRA & NAGAR HAVELI,Rural,Age not stated,Preprimary,22,7,29
14848,26,State - DADRA & NAGAR HAVELI,Urban,All ages,Preprimary,9058,7277,16335
14849,26,State - DADRA & NAGAR HAVELI,Urban,0-6,Preprimary,0,0,0
14850,26,State - DADRA & NAGAR HAVELI,Urban,7,Preprimary,1411,1179,2590
14851,26,State - DADRA & NAGAR HAVELI,Urban,8,Preprimary,1413,1224,2637
14852,26,State - DADRA & NAGAR HAVELI,Urban,9,Preprimary,1286,980,2266
14853,26,State - DADRA & NAGAR HAVELI,Urban,10,Preprimary,872,747,1619
14854,26,State - DADRA & NAGAR HAVELI,Urban,11,Preprimary,387,256,643
14855,26,State - DADRA & NAGAR HAVELI,Urban,12,Preprimary,123,101,224
14856,26,State - DADRA & NAGAR HAVELI,Urban,13,Preprimary,66,47,113
14857,26,State - DADRA & NAGAR HAVELI,Urban,14,Preprimary,31,36,67
14858,26,State - DADRA & NAGAR HAVELI,Urban,15,Preprimary,36,26,62
14859,26,State - DADRA & NAGAR HAVELI,Urban,16,Preprimary,47,38,85
14860,26,State - DADRA & NAGAR HAVELI,Urban,17,Preprimary,42,26,68
14861,26,State - DADRA & NAGAR HAVELI,Urban,18,Preprimary,139,41,180
14862,26,State - DADRA & NAGAR HAVELI,Urban,19,Preprimary,121,38,159
14863,26,State - DADRA & NAGAR HAVELI,Urban,20-24,Preprimary,553,339,892
14864,26,State - DADRA & NAGAR HAVELI,Urban,25-29,Preprimary,469,428,897
14865,26,State - DADRA & NAGAR HAVELI,Urban,30-34,Preprimary,341,382,723
14866,26,State - DADRA & NAGAR HAVELI,Urban,35-39,Preprimary,361,356,717
14867,26,State - DADRA & NAGAR HAVELI,Urban,40-44,Preprimary,331,252,583
14868,26,State - DADRA & NAGAR HAVELI,Urban,45-49,Preprimary,295,224,519
14869,26,State - DADRA & NAGAR HAVELI,Urban,50-54,Preprimary,213,155,368
14870,26,State - DADRA & NAGAR HAVELI,Urban,55-59,Preprimary,138,103,241
14871,26,State - DADRA & NAGAR HAVELI,Urban,60-64,Preprimary,154,106,260
14872,26,State - DADRA & NAGAR HAVELI,Urban,65-69,Preprimary,84,64,148
14873,26,State - DADRA & NAGAR HAVELI,Urban,70-74,Preprimary,69,51,120
14874,26,State - DADRA & NAGAR HAVELI,Urban,75-79,Preprimary,29,34,63
14875,26,State - DADRA & NAGAR HAVELI,Urban,80+,Preprimary,42,37,79
14876,26,State - DADRA & NAGAR HAVELI,Urban,Age not stated,Preprimary,5,7,12
14877,27,State - MAHARASHTRA,Total,All ages,Preprimary,8069806,7266014,15335820
14878,27,State - MAHARASHTRA,Total,0-6,Preprimary,0,0,0
14879,27,State - MAHARASHTRA,Total,7,Preprimary,768535,697488,1466023
14880,27,State - MAHARASHTRA,Total,8,Preprimary,916840,819316,1736156
14881,27,State - MAHARASHTRA,Total,9,Preprimary,906863,800669,1707532
14882,27,State - MAHARASHTRA,Total,10,Preprimary,845852,731151,1577003
14883,27,State - MAHARASHTRA,Total,11,Preprimary,361300,303902,665202
14884,27,State - MAHARASHTRA,Total,12,Preprimary,135360,111197,246557
14885,27,State - MAHARASHTRA,Total,13,Preprimary,62856,53467,116323
14886,27,State - MAHARASHTRA,Total,14,Preprimary,46557,41074,87631
14887,27,State - MAHARASHTRA,Total,15,Preprimary,48058,39883,87941
14888,27,State - MAHARASHTRA,Total,16,Preprimary,46207,38358,84565
14889,27,State - MAHARASHTRA,Total,17,Preprimary,41729,32278,74007
14890,27,State - MAHARASHTRA,Total,18,Preprimary,58569,46553,105122
14891,27,State - MAHARASHTRA,Total,19,Preprimary,42572,39780,82352
14892,27,State - MAHARASHTRA,Total,20-24,Preprimary,263800,266094,529894
14893,27,State - MAHARASHTRA,Total,25-29,Preprimary,286874,317953,604827
14894,27,State - MAHARASHTRA,Total,30-34,Preprimary,312670,376901,689571
14895,27,State - MAHARASHTRA,Total,35-39,Preprimary,372439,441970,814409
14896,27,State - MAHARASHTRA,Total,40-44,Preprimary,437511,438602,876113
14897,27,State - MAHARASHTRA,Total,45-49,Preprimary,440057,396600,836657
14898,27,State - MAHARASHTRA,Total,50-54,Preprimary,376472,319481,695953
14899,27,State - MAHARASHTRA,Total,55-59,Preprimary,281144,251876,533020
14900,27,State - MAHARASHTRA,Total,60-64,Preprimary,278147,243832,521979
14901,27,State - MAHARASHTRA,Total,65-69,Preprimary,284818,201885,486703
14902,27,State - MAHARASHTRA,Total,70-74,Preprimary,215923,115983,331906
14903,27,State - MAHARASHTRA,Total,75-79,Preprimary,109967,59246,169213
14904,27,State - MAHARASHTRA,Total,80+,Preprimary,103918,57903,161821
14905,27,State - MAHARASHTRA,Total,Age not stated,Preprimary,24768,22572,47340
14906,27,State - MAHARASHTRA,Rural,All ages,Preprimary,5299069,4612785,9911854
14907,27,State - MAHARASHTRA,Rural,0-6,Preprimary,0,0,0
14908,27,State - MAHARASHTRA,Rural,7,Preprimary,420199,382168,802367
14909,27,State - MAHARASHTRA,Rural,8,Preprimary,528189,473854,1002043
14910,27,State - MAHARASHTRA,Rural,9,Preprimary,541992,482425,1024417
14911,27,State - MAHARASHTRA,Rural,10,Preprimary,527904,464313,992217
14912,27,State - MAHARASHTRA,Rural,11,Preprimary,241682,209358,451040
14913,27,State - MAHARASHTRA,Rural,12,Preprimary,86360,75573,161933
14914,27,State - MAHARASHTRA,Rural,13,Preprimary,39493,36491,75984
14915,27,State - MAHARASHTRA,Rural,14,Preprimary,30446,29357,59803
14916,27,State - MAHARASHTRA,Rural,15,Preprimary,32513,29449,61962
14917,27,State - MAHARASHTRA,Rural,16,Preprimary,31378,28328,59706
14918,27,State - MAHARASHTRA,Rural,17,Preprimary,27200,23045,50245
14919,27,State - MAHARASHTRA,Rural,18,Preprimary,37338,33723,71061
14920,27,State - MAHARASHTRA,Rural,19,Preprimary,25931,28578,54509
14921,27,State - MAHARASHTRA,Rural,20-24,Preprimary,166255,190816,357071
14922,27,State - MAHARASHTRA,Rural,25-29,Preprimary,188562,222376,410938
14923,27,State - MAHARASHTRA,Rural,30-34,Preprimary,214996,267136,482132
14924,27,State - MAHARASHTRA,Rural,35-39,Preprimary,263918,307561,571479
14925,27,State - MAHARASHTRA,Rural,40-44,Preprimary,318559,300106,618665
14926,27,State - MAHARASHTRA,Rural,45-49,Preprimary,323195,261151,584346
14927,27,State - MAHARASHTRA,Rural,50-54,Preprimary,277450,206582,484032
14928,27,State - MAHARASHTRA,Rural,55-59,Preprimary,209313,159497,368810
14929,27,State - MAHARASHTRA,Rural,60-64,Preprimary,207181,150975,358156
14930,27,State - MAHARASHTRA,Rural,65-69,Preprimary,222018,122353,344371
14931,27,State - MAHARASHTRA,Rural,70-74,Preprimary,166119,62818,228937
14932,27,State - MAHARASHTRA,Rural,75-79,Preprimary,81424,26922,108346
14933,27,State - MAHARASHTRA,Rural,80+,Preprimary,73903,24101,98004
14934,27,State - MAHARASHTRA,Rural,Age not stated,Preprimary,15551,13729,29280
14935,27,State - MAHARASHTRA,Urban,All ages,Preprimary,2770737,2653229,5423966
14936,27,State - MAHARASHTRA,Urban,0-6,Preprimary,0,0,0
14937,27,State - MAHARASHTRA,Urban,7,Preprimary,348336,315320,663656
14938,27,State - MAHARASHTRA,Urban,8,Preprimary,388651,345462,734113
14939,27,State - MAHARASHTRA,Urban,9,Preprimary,364871,318244,683115
14940,27,State - MAHARASHTRA,Urban,10,Preprimary,317948,266838,584786
14941,27,State - MAHARASHTRA,Urban,11,Preprimary,119618,94544,214162
14942,27,State - MAHARASHTRA,Urban,12,Preprimary,49000,35624,84624
14943,27,State - MAHARASHTRA,Urban,13,Preprimary,23363,16976,40339
14944,27,State - MAHARASHTRA,Urban,14,Preprimary,16111,11717,27828
14945,27,State - MAHARASHTRA,Urban,15,Preprimary,15545,10434,25979
14946,27,State - MAHARASHTRA,Urban,16,Preprimary,14829,10030,24859
14947,27,State - MAHARASHTRA,Urban,17,Preprimary,14529,9233,23762
14948,27,State - MAHARASHTRA,Urban,18,Preprimary,21231,12830,34061
14949,27,State - MAHARASHTRA,Urban,19,Preprimary,16641,11202,27843
14950,27,State - MAHARASHTRA,Urban,20-24,Preprimary,97545,75278,172823
14951,27,State - MAHARASHTRA,Urban,25-29,Preprimary,98312,95577,193889
14952,27,State - MAHARASHTRA,Urban,30-34,Preprimary,97674,109765,207439
14953,27,State - MAHARASHTRA,Urban,35-39,Preprimary,108521,134409,242930
14954,27,State - MAHARASHTRA,Urban,40-44,Preprimary,118952,138496,257448
14955,27,State - MAHARASHTRA,Urban,45-49,Preprimary,116862,135449,252311
14956,27,State - MAHARASHTRA,Urban,50-54,Preprimary,99022,112899,211921
14957,27,State - MAHARASHTRA,Urban,55-59,Preprimary,71831,92379,164210
14958,27,State - MAHARASHTRA,Urban,60-64,Preprimary,70966,92857,163823
14959,27,State - MAHARASHTRA,Urban,65-69,Preprimary,62800,79532,142332
14960,27,State - MAHARASHTRA,Urban,70-74,Preprimary,49804,53165,102969
14961,27,State - MAHARASHTRA,Urban,75-79,Preprimary,28543,32324,60867
14962,27,State - MAHARASHTRA,Urban,80+,Preprimary,30015,33802,63817
14963,27,State - MAHARASHTRA,Urban,Age not stated,Preprimary,9217,8843,18060
14964,28,State - ANDHRA PRADESH,Total,All ages,Preprimary,3884076,3553443,7437519
14965,28,State - ANDHRA PRADESH,Total,0-6,Preprimary,0,0,0
14966,28,State - ANDHRA PRADESH,Total,7,Preprimary,538506,508812,1047318
14967,28,State - ANDHRA PRADESH,Total,8,Preprimary,655893,623856,1279749
14968,28,State - ANDHRA PRADESH,Total,9,Preprimary,572151,530824,1102975
14969,28,State - ANDHRA PRADESH,Total,10,Preprimary,441422,369728,811150
14970,28,State - ANDHRA PRADESH,Total,11,Preprimary,176421,132641,309062
14971,28,State - ANDHRA PRADESH,Total,12,Preprimary,78811,55195,134006
14972,28,State - ANDHRA PRADESH,Total,13,Preprimary,31940,24824,56764
14973,28,State - ANDHRA PRADESH,Total,14,Preprimary,20388,18377,38765
14974,28,State - ANDHRA PRADESH,Total,15,Preprimary,20423,18468,38891
14975,28,State - ANDHRA PRADESH,Total,16,Preprimary,18667,16885,35552
14976,28,State - ANDHRA PRADESH,Total,17,Preprimary,16528,14294,30822
14977,28,State - ANDHRA PRADESH,Total,18,Preprimary,24058,24712,48770
14978,28,State - ANDHRA PRADESH,Total,19,Preprimary,17961,19812,37773
14979,28,State - ANDHRA PRADESH,Total,20-24,Preprimary,112829,135458,248287
14980,28,State - ANDHRA PRADESH,Total,25-29,Preprimary,133768,174745,308513
14981,28,State - ANDHRA PRADESH,Total,30-34,Preprimary,135107,159189,294296
14982,28,State - ANDHRA PRADESH,Total,35-39,Preprimary,148421,160956,309377
14983,28,State - ANDHRA PRADESH,Total,40-44,Preprimary,141482,121572,263054
14984,28,State - ANDHRA PRADESH,Total,45-49,Preprimary,132200,106230,238430
14985,28,State - ANDHRA PRADESH,Total,50-54,Preprimary,104755,78249,183004
14986,28,State - ANDHRA PRADESH,Total,55-59,Preprimary,76055,66643,142698
14987,28,State - ANDHRA PRADESH,Total,60-64,Preprimary,89117,66368,155485
14988,28,State - ANDHRA PRADESH,Total,65-69,Preprimary,69745,42869,112614
14989,28,State - ANDHRA PRADESH,Total,70-74,Preprimary,48518,24743,73261
14990,28,State - ANDHRA PRADESH,Total,75-79,Preprimary,22588,12458,35046
14991,28,State - ANDHRA PRADESH,Total,80+,Preprimary,23049,14453,37502
14992,28,State - ANDHRA PRADESH,Total,Age not stated,Preprimary,33273,31082,64355
14993,28,State - ANDHRA PRADESH,Rural,All ages,Preprimary,2791703,2492735,5284438
14994,28,State - ANDHRA PRADESH,Rural,0-6,Preprimary,0,0,0
14995,28,State - ANDHRA PRADESH,Rural,7,Preprimary,355988,337260,693248
14996,28,State - ANDHRA PRADESH,Rural,8,Preprimary,449476,428348,877824
14997,28,State - ANDHRA PRADESH,Rural,9,Preprimary,393976,367820,761796
14998,28,State - ANDHRA PRADESH,Rural,10,Preprimary,304434,255469,559903
14999,28,State - ANDHRA PRADESH,Rural,11,Preprimary,120397,90503,210900
15000,28,State - ANDHRA PRADESH,Rural,12,Preprimary,55081,39381,94462
15001,28,State - ANDHRA PRADESH,Rural,13,Preprimary,21832,17766,39598
15002,28,State - ANDHRA PRADESH,Rural,14,Preprimary,14283,13624,27907
15003,28,State - ANDHRA PRADESH,Rural,15,Preprimary,14759,14189,28948
15004,28,State - ANDHRA PRADESH,Rural,16,Preprimary,13665,12971,26636
15005,28,State - ANDHRA PRADESH,Rural,17,Preprimary,11575,10495,22070
15006,28,State - ANDHRA PRADESH,Rural,18,Preprimary,18110,19508,37618
15007,28,State - ANDHRA PRADESH,Rural,19,Preprimary,13237,15107,28344
15008,28,State - ANDHRA PRADESH,Rural,20-24,Preprimary,86829,105641,192470
15009,28,State - ANDHRA PRADESH,Rural,25-29,Preprimary,106192,136763,242955
15010,28,State - ANDHRA PRADESH,Rural,30-34,Preprimary,109121,124231,233352
15011,28,State - ANDHRA PRADESH,Rural,35-39,Preprimary,119742,122081,241823
15012,28,State - ANDHRA PRADESH,Rural,40-44,Preprimary,113966,88467,202433
15013,28,State - ANDHRA PRADESH,Rural,45-49,Preprimary,105098,74367,179465
15014,28,State - ANDHRA PRADESH,Rural,50-54,Preprimary,82491,53013,135504
15015,28,State - ANDHRA PRADESH,Rural,55-59,Preprimary,59663,45323,104986
15016,28,State - ANDHRA PRADESH,Rural,60-64,Preprimary,71480,44929,116409
15017,28,State - ANDHRA PRADESH,Rural,65-69,Preprimary,56900,27897,84797
15018,28,State - ANDHRA PRADESH,Rural,70-74,Preprimary,39337,15155,54492
15019,28,State - ANDHRA PRADESH,Rural,75-79,Preprimary,17850,7108,24958
15020,28,State - ANDHRA PRADESH,Rural,80+,Preprimary,17644,8225,25869
15021,28,State - ANDHRA PRADESH,Rural,Age not stated,Preprimary,18577,17094,35671
15022,28,State - ANDHRA PRADESH,Urban,All ages,Preprimary,1092373,1060708,2153081
15023,28,State - ANDHRA PRADESH,Urban,0-6,Preprimary,0,0,0
15024,28,State - ANDHRA PRADESH,Urban,7,Preprimary,182518,171552,354070
15025,28,State - ANDHRA PRADESH,Urban,8,Preprimary,206417,195508,401925
15026,28,State - ANDHRA PRADESH,Urban,9,Preprimary,178175,163004,341179
15027,28,State - ANDHRA PRADESH,Urban,10,Preprimary,136988,114259,251247
15028,28,State - ANDHRA PRADESH,Urban,11,Preprimary,56024,42138,98162
15029,28,State - ANDHRA PRADESH,Urban,12,Preprimary,23730,15814,39544
15030,28,State - ANDHRA PRADESH,Urban,13,Preprimary,10108,7058,17166
15031,28,State - ANDHRA PRADESH,Urban,14,Preprimary,6105,4753,10858
15032,28,State - ANDHRA PRADESH,Urban,15,Preprimary,5664,4279,9943
15033,28,State - ANDHRA PRADESH,Urban,16,Preprimary,5002,3914,8916
15034,28,State - ANDHRA PRADESH,Urban,17,Preprimary,4953,3799,8752
15035,28,State - ANDHRA PRADESH,Urban,18,Preprimary,5948,5204,11152
15036,28,State - ANDHRA PRADESH,Urban,19,Preprimary,4724,4705,9429
15037,28,State - ANDHRA PRADESH,Urban,20-24,Preprimary,26000,29817,55817
15038,28,State - ANDHRA PRADESH,Urban,25-29,Preprimary,27576,37982,65558
15039,28,State - ANDHRA PRADESH,Urban,30-34,Preprimary,25986,34958,60944
15040,28,State - ANDHRA PRADESH,Urban,35-39,Preprimary,28679,38875,67554
15041,28,State - ANDHRA PRADESH,Urban,40-44,Preprimary,27516,33105,60621
15042,28,State - ANDHRA PRADESH,Urban,45-49,Preprimary,27102,31863,58965
15043,28,State - ANDHRA PRADESH,Urban,50-54,Preprimary,22264,25236,47500
15044,28,State - ANDHRA PRADESH,Urban,55-59,Preprimary,16392,21320,37712
15045,28,State - ANDHRA PRADESH,Urban,60-64,Preprimary,17637,21439,39076
15046,28,State - ANDHRA PRADESH,Urban,65-69,Preprimary,12845,14972,27817
15047,28,State - ANDHRA PRADESH,Urban,70-74,Preprimary,9181,9588,18769
15048,28,State - ANDHRA PRADESH,Urban,75-79,Preprimary,4738,5350,10088
15049,28,State - ANDHRA PRADESH,Urban,80+,Preprimary,5405,6228,11633
15050,28,State - ANDHRA PRADESH,Urban,Age not stated,Preprimary,14696,13988,28684
15051,29,State - KARNATAKA,Total,All ages,Preprimary,3655942,3268127,6924069
15052,29,State - KARNATAKA,Total,0-6,Preprimary,0,0,0
15053,29,State - KARNATAKA,Total,7,Preprimary,402909,379476,782385
15054,29,State - KARNATAKA,Total,8,Preprimary,493046,465229,958275
15055,29,State - KARNATAKA,Total,9,Preprimary,471108,442174,913282
15056,29,State - KARNATAKA,Total,10,Preprimary,414973,375786,790759
15057,29,State - KARNATAKA,Total,11,Preprimary,149749,128773,278522
15058,29,State - KARNATAKA,Total,12,Preprimary,46492,37062,83554
15059,29,State - KARNATAKA,Total,13,Preprimary,17441,15090,32531
15060,29,State - KARNATAKA,Total,14,Preprimary,15152,13749,28901
15061,29,State - KARNATAKA,Total,15,Preprimary,16278,13726,30004
15062,29,State - KARNATAKA,Total,16,Preprimary,18110,14866,32976
15063,29,State - KARNATAKA,Total,17,Preprimary,15817,12083,27900
15064,29,State - KARNATAKA,Total,18,Preprimary,27480,21743,49223
15065,29,State - KARNATAKA,Total,19,Preprimary,19469,17141,36610
15066,29,State - KARNATAKA,Total,20-24,Preprimary,133614,117722,251336
15067,29,State - KARNATAKA,Total,25-29,Preprimary,154934,160525,315459
15068,29,State - KARNATAKA,Total,30-34,Preprimary,148540,156117,304657
15069,29,State - KARNATAKA,Total,35-39,Preprimary,179152,186055,365207
15070,29,State - KARNATAKA,Total,40-44,Preprimary,176270,150750,327020
15071,29,State - KARNATAKA,Total,45-49,Preprimary,179283,144679,323962
15072,29,State - KARNATAKA,Total,50-54,Preprimary,135672,106396,242068
15073,29,State - KARNATAKA,Total,55-59,Preprimary,108049,88263,196312
15074,29,State - KARNATAKA,Total,60-64,Preprimary,110080,78551,188631
15075,29,State - KARNATAKA,Total,65-69,Preprimary,93161,61690,154851
15076,29,State - KARNATAKA,Total,70-74,Preprimary,61621,35971,97592
15077,29,State - KARNATAKA,Total,75-79,Preprimary,32314,20448,52762
15078,29,State - KARNATAKA,Total,80+,Preprimary,33228,22199,55427
15079,29,State - KARNATAKA,Total,Age not stated,Preprimary,2000,1863,3863
15080,29,State - KARNATAKA,Rural,All ages,Preprimary,2535393,2184435,4719828
15081,29,State - KARNATAKA,Rural,0-6,Preprimary,0,0,0
15082,29,State - KARNATAKA,Rural,7,Preprimary,244059,228410,472469
15083,29,State - KARNATAKA,Rural,8,Preprimary,310325,292542,602867
15084,29,State - KARNATAKA,Rural,9,Preprimary,303162,285765,588927
15085,29,State - KARNATAKA,Rural,10,Preprimary,273795,251128,524923
15086,29,State - KARNATAKA,Rural,11,Preprimary,98533,87138,185671
15087,29,State - KARNATAKA,Rural,12,Preprimary,29934,25843,55777
15088,29,State - KARNATAKA,Rural,13,Preprimary,11276,11006,22282
15089,29,State - KARNATAKA,Rural,14,Preprimary,10651,10661,21312
15090,29,State - KARNATAKA,Rural,15,Preprimary,11871,10946,22817
15091,29,State - KARNATAKA,Rural,16,Preprimary,13375,11804,25179
15092,29,State - KARNATAKA,Rural,17,Preprimary,11089,8996,20085
15093,29,State - KARNATAKA,Rural,18,Preprimary,20384,17011,37395
15094,29,State - KARNATAKA,Rural,19,Preprimary,13726,12976,26702
15095,29,State - KARNATAKA,Rural,20-24,Preprimary,97767,89385,187152
15096,29,State - KARNATAKA,Rural,25-29,Preprimary,115707,120679,236386
15097,29,State - KARNATAKA,Rural,30-34,Preprimary,112219,116761,228980
15098,29,State - KARNATAKA,Rural,35-39,Preprimary,136560,135884,272444
15099,29,State - KARNATAKA,Rural,40-44,Preprimary,136262,108199,244461
15100,29,State - KARNATAKA,Rural,45-49,Preprimary,138704,99585,238289
15101,29,State - KARNATAKA,Rural,50-54,Preprimary,104817,71189,176006
15102,29,State - KARNATAKA,Rural,55-59,Preprimary,83245,57552,140797
15103,29,State - KARNATAKA,Rural,60-64,Preprimary,85429,49587,135016
15104,29,State - KARNATAKA,Rural,65-69,Preprimary,73492,37774,111266
15105,29,State - KARNATAKA,Rural,70-74,Preprimary,47954,20654,68608
15106,29,State - KARNATAKA,Rural,75-79,Preprimary,24481,10885,35366
15107,29,State - KARNATAKA,Rural,80+,Preprimary,25103,10757,35860
15108,29,State - KARNATAKA,Rural,Age not stated,Preprimary,1473,1318,2791
15109,29,State - KARNATAKA,Urban,All ages,Preprimary,1120549,1083692,2204241
15110,29,State - KARNATAKA,Urban,0-6,Preprimary,0,0,0
15111,29,State - KARNATAKA,Urban,7,Preprimary,158850,151066,309916
15112,29,State - KARNATAKA,Urban,8,Preprimary,182721,172687,355408
15113,29,State - KARNATAKA,Urban,9,Preprimary,167946,156409,324355
15114,29,State - KARNATAKA,Urban,10,Preprimary,141178,124658,265836
15115,29,State - KARNATAKA,Urban,11,Preprimary,51216,41635,92851
15116,29,State - KARNATAKA,Urban,12,Preprimary,16558,11219,27777
15117,29,State - KARNATAKA,Urban,13,Preprimary,6165,4084,10249
15118,29,State - KARNATAKA,Urban,14,Preprimary,4501,3088,7589
15119,29,State - KARNATAKA,Urban,15,Preprimary,4407,2780,7187
15120,29,State - KARNATAKA,Urban,16,Preprimary,4735,3062,7797
15121,29,State - KARNATAKA,Urban,17,Preprimary,4728,3087,7815
15122,29,State - KARNATAKA,Urban,18,Preprimary,7096,4732,11828
15123,29,State - KARNATAKA,Urban,19,Preprimary,5743,4165,9908
15124,29,State - KARNATAKA,Urban,20-24,Preprimary,35847,28337,64184
15125,29,State - KARNATAKA,Urban,25-29,Preprimary,39227,39846,79073
15126,29,State - KARNATAKA,Urban,30-34,Preprimary,36321,39356,75677
15127,29,State - KARNATAKA,Urban,35-39,Preprimary,42592,50171,92763
15128,29,State - KARNATAKA,Urban,40-44,Preprimary,40008,42551,82559
15129,29,State - KARNATAKA,Urban,45-49,Preprimary,40579,45094,85673
15130,29,State - KARNATAKA,Urban,50-54,Preprimary,30855,35207,66062
15131,29,State - KARNATAKA,Urban,55-59,Preprimary,24804,30711,55515
15132,29,State - KARNATAKA,Urban,60-64,Preprimary,24651,28964,53615
15133,29,State - KARNATAKA,Urban,65-69,Preprimary,19669,23916,43585
15134,29,State - KARNATAKA,Urban,70-74,Preprimary,13667,15317,28984
15135,29,State - KARNATAKA,Urban,75-79,Preprimary,7833,9563,17396
15136,29,State - KARNATAKA,Urban,80+,Preprimary,8125,11442,19567
15137,29,State - KARNATAKA,Urban,Age not stated,Preprimary,527,545,1072
15138,30,State - GOA,Total,All ages,Preprimary,80497,80806,161303
15139,30,State - GOA,Total,0-6,Preprimary,0,0,0
15140,30,State - GOA,Total,7,Preprimary,8729,8167,16896
15141,30,State - GOA,Total,8,Preprimary,9657,8936,18593
15142,30,State - GOA,Total,9,Preprimary,9491,9138,18629
15143,30,State - GOA,Total,10,Preprimary,8293,7613,15906
15144,30,State - GOA,Total,11,Preprimary,3423,2851,6274
15145,30,State - GOA,Total,12,Preprimary,1166,833,1999
15146,30,State - GOA,Total,13,Preprimary,522,391,913
15147,30,State - GOA,Total,14,Preprimary,335,227,562
15148,30,State - GOA,Total,15,Preprimary,265,195,460
15149,30,State - GOA,Total,16,Preprimary,262,201,463
15150,30,State - GOA,Total,17,Preprimary,258,232,490
15151,30,State - GOA,Total,18,Preprimary,358,338,696
15152,30,State - GOA,Total,19,Preprimary,375,343,718
15153,30,State - GOA,Total,20-24,Preprimary,2005,1846,3851
15154,30,State - GOA,Total,25-29,Preprimary,2163,2361,4524
15155,30,State - GOA,Total,30-34,Preprimary,2273,2864,5137
15156,30,State - GOA,Total,35-39,Preprimary,2887,3973,6860
15157,30,State - GOA,Total,40-44,Preprimary,3270,4317,7587
15158,30,State - GOA,Total,45-49,Preprimary,3982,4818,8800
15159,30,State - GOA,Total,50-54,Preprimary,3762,4407,8169
15160,30,State - GOA,Total,55-59,Preprimary,3453,4182,7635
15161,30,State - GOA,Total,60-64,Preprimary,4453,4186,8639
15162,30,State - GOA,Total,65-69,Preprimary,3564,3138,6702
15163,30,State - GOA,Total,70-74,Preprimary,2685,2328,5013
15164,30,State - GOA,Total,75-79,Preprimary,1607,1470,3077
15165,30,State - GOA,Total,80+,Preprimary,1186,1361,2547
15166,30,State - GOA,Total,Age not stated,Preprimary,73,90,163
15167,30,State - GOA,Rural,All ages,Preprimary,34450,33994,68444
15168,30,State - GOA,Rural,0-6,Preprimary,0,0,0
15169,30,State - GOA,Rural,7,Preprimary,3199,3051,6250
15170,30,State - GOA,Rural,8,Preprimary,3529,3369,6898
15171,30,State - GOA,Rural,9,Preprimary,3528,3492,7020
15172,30,State - GOA,Rural,10,Preprimary,3146,3037,6183
15173,30,State - GOA,Rural,11,Preprimary,1309,1144,2453
15174,30,State - GOA,Rural,12,Preprimary,468,323,791
15175,30,State - GOA,Rural,13,Preprimary,207,163,370
15176,30,State - GOA,Rural,14,Preprimary,140,92,232
15177,30,State - GOA,Rural,15,Preprimary,110,80,190
15178,30,State - GOA,Rural,16,Preprimary,95,75,170
15179,30,State - GOA,Rural,17,Preprimary,94,80,174
15180,30,State - GOA,Rural,18,Preprimary,123,139,262
15181,30,State - GOA,Rural,19,Preprimary,137,122,259
15182,30,State - GOA,Rural,20-24,Preprimary,723,779,1502
15183,30,State - GOA,Rural,25-29,Preprimary,845,1088,1933
15184,30,State - GOA,Rural,30-34,Preprimary,1006,1444,2450
15185,30,State - GOA,Rural,35-39,Preprimary,1405,2112,3517
15186,30,State - GOA,Rural,40-44,Preprimary,1696,2267,3963
15187,30,State - GOA,Rural,45-49,Preprimary,2212,2403,4615
15188,30,State - GOA,Rural,50-54,Preprimary,2093,2175,4268
15189,30,State - GOA,Rural,55-59,Preprimary,1886,1838,3724
15190,30,State - GOA,Rural,60-64,Preprimary,2221,1678,3899
15191,30,State - GOA,Rural,65-69,Preprimary,1766,1248,3014
15192,30,State - GOA,Rural,70-74,Preprimary,1212,815,2027
15193,30,State - GOA,Rural,75-79,Preprimary,718,483,1201
15194,30,State - GOA,Rural,80+,Preprimary,541,444,985
15195,30,State - GOA,Rural,Age not stated,Preprimary,41,53,94
15196,30,State - GOA,Urban,All ages,Preprimary,46047,46812,92859
15197,30,State - GOA,Urban,0-6,Preprimary,0,0,0
15198,30,State - GOA,Urban,7,Preprimary,5530,5116,10646
15199,30,State - GOA,Urban,8,Preprimary,6128,5567,11695
15200,30,State - GOA,Urban,9,Preprimary,5963,5646,11609
15201,30,State - GOA,Urban,10,Preprimary,5147,4576,9723
15202,30,State - GOA,Urban,11,Preprimary,2114,1707,3821
15203,30,State - GOA,Urban,12,Preprimary,698,510,1208
15204,30,State - GOA,Urban,13,Preprimary,315,228,543
15205,30,State - GOA,Urban,14,Preprimary,195,135,330
15206,30,State - GOA,Urban,15,Preprimary,155,115,270
15207,30,State - GOA,Urban,16,Preprimary,167,126,293
15208,30,State - GOA,Urban,17,Preprimary,164,152,316
15209,30,State - GOA,Urban,18,Preprimary,235,199,434
15210,30,State - GOA,Urban,19,Preprimary,238,221,459
15211,30,State - GOA,Urban,20-24,Preprimary,1282,1067,2349
15212,30,State - GOA,Urban,25-29,Preprimary,1318,1273,2591
15213,30,State - GOA,Urban,30-34,Preprimary,1267,1420,2687
15214,30,State - GOA,Urban,35-39,Preprimary,1482,1861,3343
15215,30,State - GOA,Urban,40-44,Preprimary,1574,2050,3624
15216,30,State - GOA,Urban,45-49,Preprimary,1770,2415,4185
15217,30,State - GOA,Urban,50-54,Preprimary,1669,2232,3901
15218,30,State - GOA,Urban,55-59,Preprimary,1567,2344,3911
15219,30,State - GOA,Urban,60-64,Preprimary,2232,2508,4740
15220,30,State - GOA,Urban,65-69,Preprimary,1798,1890,3688
15221,30,State - GOA,Urban,70-74,Preprimary,1473,1513,2986
15222,30,State - GOA,Urban,75-79,Preprimary,889,987,1876
15223,30,State - GOA,Urban,80+,Preprimary,645,917,1562
15224,30,State - GOA,Urban,Age not stated,Preprimary,32,37,69
15225,31,State - LAKSHADWEEP,Total,All ages,Preprimary,4523,4887,9410
15226,31,State - LAKSHADWEEP,Total,0-6,Preprimary,0,0,0
15227,31,State - LAKSHADWEEP,Total,7,Preprimary,391,376,767
15228,31,State - LAKSHADWEEP,Total,8,Preprimary,409,413,822
15229,31,State - LAKSHADWEEP,Total,9,Preprimary,531,516,1047
15230,31,State - LAKSHADWEEP,Total,10,Preprimary,457,439,896
15231,31,State - LAKSHADWEEP,Total,11,Preprimary,174,148,322
15232,31,State - LAKSHADWEEP,Total,12,Preprimary,43,30,73
15233,31,State - LAKSHADWEEP,Total,13,Preprimary,16,11,27
15234,31,State - LAKSHADWEEP,Total,14,Preprimary,9,12,21
15235,31,State - LAKSHADWEEP,Total,15,Preprimary,11,3,14
15236,31,State - LAKSHADWEEP,Total,16,Preprimary,4,15,19
15237,31,State - LAKSHADWEEP,Total,17,Preprimary,7,13,20
15238,31,State - LAKSHADWEEP,Total,18,Preprimary,12,10,22
15239,31,State - LAKSHADWEEP,Total,19,Preprimary,6,13,19
15240,31,State - LAKSHADWEEP,Total,20-24,Preprimary,102,69,171
15241,31,State - LAKSHADWEEP,Total,25-29,Preprimary,137,115,252
15242,31,State - LAKSHADWEEP,Total,30-34,Preprimary,153,229,382
15243,31,State - LAKSHADWEEP,Total,35-39,Preprimary,253,374,627
15244,31,State - LAKSHADWEEP,Total,40-44,Preprimary,223,383,606
15245,31,State - LAKSHADWEEP,Total,45-49,Preprimary,248,439,687
15246,31,State - LAKSHADWEEP,Total,50-54,Preprimary,255,414,669
15247,31,State - LAKSHADWEEP,Total,55-59,Preprimary,332,427,759
15248,31,State - LAKSHADWEEP,Total,60-64,Preprimary,255,260,515
15249,31,State - LAKSHADWEEP,Total,65-69,Preprimary,208,107,315
15250,31,State - LAKSHADWEEP,Total,70-74,Preprimary,139,36,175
15251,31,State - LAKSHADWEEP,Total,75-79,Preprimary,77,22,99
15252,31,State - LAKSHADWEEP,Total,80+,Preprimary,59,9,68
15253,31,State - LAKSHADWEEP,Total,Age not stated,Preprimary,12,4,16
15254,31,State - LAKSHADWEEP,Rural,All ages,Preprimary,1095,1021,2116
15255,31,State - LAKSHADWEEP,Rural,0-6,Preprimary,0,0,0
15256,31,State - LAKSHADWEEP,Rural,7,Preprimary,74,75,149
15257,31,State - LAKSHADWEEP,Rural,8,Preprimary,92,100,192
15258,31,State - LAKSHADWEEP,Rural,9,Preprimary,135,111,246
15259,31,State - LAKSHADWEEP,Rural,10,Preprimary,123,100,223
15260,31,State - LAKSHADWEEP,Rural,11,Preprimary,43,45,88
15261,31,State - LAKSHADWEEP,Rural,12,Preprimary,8,5,13
15262,31,State - LAKSHADWEEP,Rural,13,Preprimary,7,3,10
15263,31,State - LAKSHADWEEP,Rural,14,Preprimary,5,6,11
15264,31,State - LAKSHADWEEP,Rural,15,Preprimary,8,1,9
15265,31,State - LAKSHADWEEP,Rural,16,Preprimary,2,7,9
15266,31,State - LAKSHADWEEP,Rural,17,Preprimary,2,4,6
15267,31,State - LAKSHADWEEP,Rural,18,Preprimary,6,5,11
15268,31,State - LAKSHADWEEP,Rural,19,Preprimary,2,4,6
15269,31,State - LAKSHADWEEP,Rural,20-24,Preprimary,29,20,49
15270,31,State - LAKSHADWEEP,Rural,25-29,Preprimary,43,17,60
15271,31,State - LAKSHADWEEP,Rural,30-34,Preprimary,38,42,80
15272,31,State - LAKSHADWEEP,Rural,35-39,Preprimary,59,64,123
15273,31,State - LAKSHADWEEP,Rural,40-44,Preprimary,52,70,122
15274,31,State - LAKSHADWEEP,Rural,45-49,Preprimary,62,92,154
15275,31,State - LAKSHADWEEP,Rural,50-54,Preprimary,70,85,155
15276,31,State - LAKSHADWEEP,Rural,55-59,Preprimary,73,78,151
15277,31,State - LAKSHADWEEP,Rural,60-64,Preprimary,55,48,103
15278,31,State - LAKSHADWEEP,Rural,65-69,Preprimary,45,20,65
15279,31,State - LAKSHADWEEP,Rural,70-74,Preprimary,28,9,37
15280,31,State - LAKSHADWEEP,Rural,75-79,Preprimary,15,5,20
15281,31,State - LAKSHADWEEP,Rural,80+,Preprimary,19,2,21
15282,31,State - LAKSHADWEEP,Rural,Age not stated,Preprimary,0,3,3
15283,31,State - LAKSHADWEEP,Urban,All ages,Preprimary,3428,3866,7294
15284,31,State - LAKSHADWEEP,Urban,0-6,Preprimary,0,0,0
15285,31,State - LAKSHADWEEP,Urban,7,Preprimary,317,301,618
15286,31,State - LAKSHADWEEP,Urban,8,Preprimary,317,313,630
15287,31,State - LAKSHADWEEP,Urban,9,Preprimary,396,405,801
15288,31,State - LAKSHADWEEP,Urban,10,Preprimary,334,339,673
15289,31,State - LAKSHADWEEP,Urban,11,Preprimary,131,103,234
15290,31,State - LAKSHADWEEP,Urban,12,Preprimary,35,25,60
15291,31,State - LAKSHADWEEP,Urban,13,Preprimary,9,8,17
15292,31,State - LAKSHADWEEP,Urban,14,Preprimary,4,6,10
15293,31,State - LAKSHADWEEP,Urban,15,Preprimary,3,2,5
15294,31,State - LAKSHADWEEP,Urban,16,Preprimary,2,8,10
15295,31,State - LAKSHADWEEP,Urban,17,Preprimary,5,9,14
15296,31,State - LAKSHADWEEP,Urban,18,Preprimary,6,5,11
15297,31,State - LAKSHADWEEP,Urban,19,Preprimary,4,9,13
15298,31,State - LAKSHADWEEP,Urban,20-24,Preprimary,73,49,122
15299,31,State - LAKSHADWEEP,Urban,25-29,Preprimary,94,98,192
15300,31,State - LAKSHADWEEP,Urban,30-34,Preprimary,115,187,302
15301,31,State - LAKSHADWEEP,Urban,35-39,Preprimary,194,310,504
15302,31,State - LAKSHADWEEP,Urban,40-44,Preprimary,171,313,484
15303,31,State - LAKSHADWEEP,Urban,45-49,Preprimary,186,347,533
15304,31,State - LAKSHADWEEP,Urban,50-54,Preprimary,185,329,514
15305,31,State - LAKSHADWEEP,Urban,55-59,Preprimary,259,349,608
15306,31,State - LAKSHADWEEP,Urban,60-64,Preprimary,200,212,412
15307,31,State - LAKSHADWEEP,Urban,65-69,Preprimary,163,87,250
15308,31,State - LAKSHADWEEP,Urban,70-74,Preprimary,111,27,138
15309,31,State - LAKSHADWEEP,Urban,75-79,Preprimary,62,17,79
15310,31,State - LAKSHADWEEP,Urban,80+,Preprimary,40,7,47
15311,31,State - LAKSHADWEEP,Urban,Age not stated,Preprimary,12,1,13
15312,32,State - KERALA,Total,All ages,Preprimary,2076920,2324577,4401497
15313,32,State - KERALA,Total,0-6,Preprimary,0,0,0
15314,32,State - KERALA,Total,7,Preprimary,219895,211849,431744
15315,32,State - KERALA,Total,8,Preprimary,245767,237456,483223
15316,32,State - KERALA,Total,9,Preprimary,242124,232374,474498
15317,32,State - KERALA,Total,10,Preprimary,198209,182012,380221
15318,32,State - KERALA,Total,11,Preprimary,63362,49806,113168
15319,32,State - KERALA,Total,12,Preprimary,11005,6937,17942
15320,32,State - KERALA,Total,13,Preprimary,3169,2204,5373
15321,32,State - KERALA,Total,14,Preprimary,1886,1500,3386
15322,32,State - KERALA,Total,15,Preprimary,5561,6457,12018
15323,32,State - KERALA,Total,16,Preprimary,20589,25046,45635
15324,32,State - KERALA,Total,17,Preprimary,29062,30625,59687
15325,32,State - KERALA,Total,18,Preprimary,16361,13036,29397
15326,32,State - KERALA,Total,19,Preprimary,7714,5840,13554
15327,32,State - KERALA,Total,20-24,Preprimary,20825,19638,40463
15328,32,State - KERALA,Total,25-29,Preprimary,21275,20060,41335
15329,32,State - KERALA,Total,30-34,Preprimary,26144,29469,55613
15330,32,State - KERALA,Total,35-39,Preprimary,49553,65646,115199
15331,32,State - KERALA,Total,40-44,Preprimary,77335,107493,184828
15332,32,State - KERALA,Total,45-49,Preprimary,120492,167515,288007
15333,32,State - KERALA,Total,50-54,Preprimary,132813,168027,300840
15334,32,State - KERALA,Total,55-59,Preprimary,138657,166677,305334
15335,32,State - KERALA,Total,60-64,Preprimary,124307,150817,275124
15336,32,State - KERALA,Total,65-69,Preprimary,94481,126323,220804
15337,32,State - KERALA,Total,70-74,Preprimary,77093,104188,181281
15338,32,State - KERALA,Total,75-79,Preprimary,58665,85555,144220
15339,32,State - KERALA,Total,80+,Preprimary,69115,106171,175286
15340,32,State - KERALA,Total,Age not stated,Preprimary,1461,1856,3317
15341,32,State - KERALA,Rural,All ages,Preprimary,1155194,1269175,2424369
15342,32,State - KERALA,Rural,0-6,Preprimary,0,0,0
15343,32,State - KERALA,Rural,7,Preprimary,114754,111432,226186
15344,32,State - KERALA,Rural,8,Preprimary,129218,125067,254285
15345,32,State - KERALA,Rural,9,Preprimary,127904,122750,250654
15346,32,State - KERALA,Rural,10,Preprimary,105558,97232,202790
15347,32,State - KERALA,Rural,11,Preprimary,34609,27612,62221
15348,32,State - KERALA,Rural,12,Preprimary,6257,4041,10298
15349,32,State - KERALA,Rural,13,Preprimary,1905,1338,3243
15350,32,State - KERALA,Rural,14,Preprimary,1128,885,2013
15351,32,State - KERALA,Rural,15,Preprimary,3021,3486,6507
15352,32,State - KERALA,Rural,16,Preprimary,10780,13161,23941
15353,32,State - KERALA,Rural,17,Preprimary,15101,16077,31178
15354,32,State - KERALA,Rural,18,Preprimary,8768,7116,15884
15355,32,State - KERALA,Rural,19,Preprimary,4228,3397,7625
15356,32,State - KERALA,Rural,20-24,Preprimary,12132,12064,24196
15357,32,State - KERALA,Rural,25-29,Preprimary,13275,12929,26204
15358,32,State - KERALA,Rural,30-34,Preprimary,16182,18885,35067
15359,32,State - KERALA,Rural,35-39,Preprimary,30790,40881,71671
15360,32,State - KERALA,Rural,40-44,Preprimary,46257,62573,108830
15361,32,State - KERALA,Rural,45-49,Preprimary,71749,94583,166332
15362,32,State - KERALA,Rural,50-54,Preprimary,77103,91680,168783
15363,32,State - KERALA,Rural,55-59,Preprimary,79861,90205,170066
15364,32,State - KERALA,Rural,60-64,Preprimary,70376,79829,150205
15365,32,State - KERALA,Rural,65-69,Preprimary,53712,67496,121208
15366,32,State - KERALA,Rural,70-74,Preprimary,43087,55211,98298
15367,32,State - KERALA,Rural,75-79,Preprimary,33870,47262,81132
15368,32,State - KERALA,Rural,80+,Preprimary,42819,61016,103835
15369,32,State - KERALA,Rural,Age not stated,Preprimary,750,967,1717
15370,32,State - KERALA,Urban,All ages,Preprimary,921726,1055402,1977128
15371,32,State - KERALA,Urban,0-6,Preprimary,0,0,0
15372,32,State - KERALA,Urban,7,Preprimary,105141,100417,205558
15373,32,State - KERALA,Urban,8,Preprimary,116549,112389,228938
15374,32,State - KERALA,Urban,9,Preprimary,114220,109624,223844
15375,32,State - KERALA,Urban,10,Preprimary,92651,84780,177431
15376,32,State - KERALA,Urban,11,Preprimary,28753,22194,50947
15377,32,State - KERALA,Urban,12,Preprimary,4748,2896,7644
15378,32,State - KERALA,Urban,13,Preprimary,1264,866,2130
15379,32,State - KERALA,Urban,14,Preprimary,758,615,1373
15380,32,State - KERALA,Urban,15,Preprimary,2540,2971,5511
15381,32,State - KERALA,Urban,16,Preprimary,9809,11885,21694
15382,32,State - KERALA,Urban,17,Preprimary,13961,14548,28509
15383,32,State - KERALA,Urban,18,Preprimary,7593,5920,13513
15384,32,State - KERALA,Urban,19,Preprimary,3486,2443,5929
15385,32,State - KERALA,Urban,20-24,Preprimary,8693,7574,16267
15386,32,State - KERALA,Urban,25-29,Preprimary,8000,7131,15131
15387,32,State - KERALA,Urban,30-34,Preprimary,9962,10584,20546
15388,32,State - KERALA,Urban,35-39,Preprimary,18763,24765,43528
15389,32,State - KERALA,Urban,40-44,Preprimary,31078,44920,75998
15390,32,State - KERALA,Urban,45-49,Preprimary,48743,72932,121675
15391,32,State - KERALA,Urban,50-54,Preprimary,55710,76347,132057
15392,32,State - KERALA,Urban,55-59,Preprimary,58796,76472,135268
15393,32,State - KERALA,Urban,60-64,Preprimary,53931,70988,124919
15394,32,State - KERALA,Urban,65-69,Preprimary,40769,58827,99596
15395,32,State - KERALA,Urban,70-74,Preprimary,34006,48977,82983
15396,32,State - KERALA,Urban,75-79,Preprimary,24795,38293,63088
15397,32,State - KERALA,Urban,80+,Preprimary,26296,45155,71451
15398,32,State - KERALA,Urban,Age not stated,Preprimary,711,889,1600
15399,33,State - TAMIL NADU,Total,All ages,Preprimary,2861589,2767790,5629379
15400,33,State - TAMIL NADU,Total,0-6,Preprimary,0,0,0
15401,33,State - TAMIL NADU,Total,7,Preprimary,469681,445925,915606
15402,33,State - TAMIL NADU,Total,8,Preprimary,527429,505259,1032688
15403,33,State - TAMIL NADU,Total,9,Preprimary,439008,408419,847427
15404,33,State - TAMIL NADU,Total,10,Preprimary,228788,198229,427017
15405,33,State - TAMIL NADU,Total,11,Preprimary,49483,38560,88043
15406,33,State - TAMIL NADU,Total,12,Preprimary,12475,9355,21830
15407,33,State - TAMIL NADU,Total,13,Preprimary,5899,4443,10342
15408,33,State - TAMIL NADU,Total,14,Preprimary,4500,3555,8055
15409,33,State - TAMIL NADU,Total,15,Preprimary,5465,4353,9818
15410,33,State - TAMIL NADU,Total,16,Preprimary,5371,4464,9835
15411,33,State - TAMIL NADU,Total,17,Preprimary,6523,5298,11821
15412,33,State - TAMIL NADU,Total,18,Preprimary,8177,7026,15203
15413,33,State - TAMIL NADU,Total,19,Preprimary,7932,7199,15131
15414,33,State - TAMIL NADU,Total,20-24,Preprimary,51342,53216,104558
15415,33,State - TAMIL NADU,Total,25-29,Preprimary,79491,100581,180072
15416,33,State - TAMIL NADU,Total,30-34,Preprimary,86511,119124,205635
15417,33,State - TAMIL NADU,Total,35-39,Preprimary,114188,163782,277970
15418,33,State - TAMIL NADU,Total,40-44,Preprimary,128098,150617,278715
15419,33,State - TAMIL NADU,Total,45-49,Preprimary,137968,145720,283688
15420,33,State - TAMIL NADU,Total,50-54,Preprimary,108523,106989,215512
15421,33,State - TAMIL NADU,Total,55-59,Preprimary,93823,89656,183479
15422,33,State - TAMIL NADU,Total,60-64,Preprimary,95809,73221,169030
15423,33,State - TAMIL NADU,Total,65-69,Preprimary,72059,49934,121993
15424,33,State - TAMIL NADU,Total,70-74,Preprimary,56228,33093,89321
15425,33,State - TAMIL NADU,Total,75-79,Preprimary,32123,18679,50802
15426,33,State - TAMIL NADU,Total,80+,Preprimary,32582,18917,51499
15427,33,State - TAMIL NADU,Total,Age not stated,Preprimary,2113,2176,4289
15428,33,State - TAMIL NADU,Rural,All ages,Preprimary,1587693,1476918,3064611
15429,33,State - TAMIL NADU,Rural,0-6,Preprimary,0,0,0
15430,33,State - TAMIL NADU,Rural,7,Preprimary,249670,236456,486126
15431,33,State - TAMIL NADU,Rural,8,Preprimary,285629,272323,557952
15432,33,State - TAMIL NADU,Rural,9,Preprimary,235832,217830,453662
15433,33,State - TAMIL NADU,Rural,10,Preprimary,117732,101631,219363
15434,33,State - TAMIL NADU,Rural,11,Preprimary,25137,19451,44588
15435,33,State - TAMIL NADU,Rural,12,Preprimary,6442,4982,11424
15436,33,State - TAMIL NADU,Rural,13,Preprimary,3068,2476,5544
15437,33,State - TAMIL NADU,Rural,14,Preprimary,2420,2000,4420
15438,33,State - TAMIL NADU,Rural,15,Preprimary,3171,2561,5732
15439,33,State - TAMIL NADU,Rural,16,Preprimary,2976,2571,5547
15440,33,State - TAMIL NADU,Rural,17,Preprimary,3657,3043,6700
15441,33,State - TAMIL NADU,Rural,18,Preprimary,4689,4228,8917
15442,33,State - TAMIL NADU,Rural,19,Preprimary,4626,4393,9019
15443,33,State - TAMIL NADU,Rural,20-24,Preprimary,29782,32508,62290
15444,33,State - TAMIL NADU,Rural,25-29,Preprimary,45861,61464,107325
15445,33,State - TAMIL NADU,Rural,30-34,Preprimary,49960,70586,120546
15446,33,State - TAMIL NADU,Rural,35-39,Preprimary,66345,95176,161521
15447,33,State - TAMIL NADU,Rural,40-44,Preprimary,75407,83385,158792
15448,33,State - TAMIL NADU,Rural,45-49,Preprimary,81655,78515,160170
15449,33,State - TAMIL NADU,Rural,50-54,Preprimary,64130,55574,119704
15450,33,State - TAMIL NADU,Rural,55-59,Preprimary,55769,44198,99967
15451,33,State - TAMIL NADU,Rural,60-64,Preprimary,57951,33382,91333
15452,33,State - TAMIL NADU,Rural,65-69,Preprimary,43914,21396,65310
15453,33,State - TAMIL NADU,Rural,70-74,Preprimary,33654,13063,46717
15454,33,State - TAMIL NADU,Rural,75-79,Preprimary,18456,6452,24908
15455,33,State - TAMIL NADU,Rural,80+,Preprimary,18367,5899,24266
15456,33,State - TAMIL NADU,Rural,Age not stated,Preprimary,1393,1375,2768
15457,33,State - TAMIL NADU,Urban,All ages,Preprimary,1273896,1290872,2564768
15458,33,State - TAMIL NADU,Urban,0-6,Preprimary,0,0,0
15459,33,State - TAMIL NADU,Urban,7,Preprimary,220011,209469,429480
15460,33,State - TAMIL NADU,Urban,8,Preprimary,241800,232936,474736
15461,33,State - TAMIL NADU,Urban,9,Preprimary,203176,190589,393765
15462,33,State - TAMIL NADU,Urban,10,Preprimary,111056,96598,207654
15463,33,State - TAMIL NADU,Urban,11,Preprimary,24346,19109,43455
15464,33,State - TAMIL NADU,Urban,12,Preprimary,6033,4373,10406
15465,33,State - TAMIL NADU,Urban,13,Preprimary,2831,1967,4798
15466,33,State - TAMIL NADU,Urban,14,Preprimary,2080,1555,3635
15467,33,State - TAMIL NADU,Urban,15,Preprimary,2294,1792,4086
15468,33,State - TAMIL NADU,Urban,16,Preprimary,2395,1893,4288
15469,33,State - TAMIL NADU,Urban,17,Preprimary,2866,2255,5121
15470,33,State - TAMIL NADU,Urban,18,Preprimary,3488,2798,6286
15471,33,State - TAMIL NADU,Urban,19,Preprimary,3306,2806,6112
15472,33,State - TAMIL NADU,Urban,20-24,Preprimary,21560,20708,42268
15473,33,State - TAMIL NADU,Urban,25-29,Preprimary,33630,39117,72747
15474,33,State - TAMIL NADU,Urban,30-34,Preprimary,36551,48538,85089
15475,33,State - TAMIL NADU,Urban,35-39,Preprimary,47843,68606,116449
15476,33,State - TAMIL NADU,Urban,40-44,Preprimary,52691,67232,119923
15477,33,State - TAMIL NADU,Urban,45-49,Preprimary,56313,67205,123518
15478,33,State - TAMIL NADU,Urban,50-54,Preprimary,44393,51415,95808
15479,33,State - TAMIL NADU,Urban,55-59,Preprimary,38054,45458,83512
15480,33,State - TAMIL NADU,Urban,60-64,Preprimary,37858,39839,77697
15481,33,State - TAMIL NADU,Urban,65-69,Preprimary,28145,28538,56683
15482,33,State - TAMIL NADU,Urban,70-74,Preprimary,22574,20030,42604
15483,33,State - TAMIL NADU,Urban,75-79,Preprimary,13667,12227,25894
15484,33,State - TAMIL NADU,Urban,80+,Preprimary,14215,13018,27233
15485,33,State - TAMIL NADU,Urban,Age not stated,Preprimary,720,801,1521
15486,34,State - PUDUCHERRY,Total,All ages,Preprimary,45162,48024,93186
15487,34,State - PUDUCHERRY,Total,0-6,Preprimary,0,0,0
15488,34,State - PUDUCHERRY,Total,7,Preprimary,7882,7573,15455
15489,34,State - PUDUCHERRY,Total,8,Preprimary,8992,8603,17595
15490,34,State - PUDUCHERRY,Total,9,Preprimary,8146,7787,15933
15491,34,State - PUDUCHERRY,Total,10,Preprimary,4651,4332,8983
15492,34,State - PUDUCHERRY,Total,11,Preprimary,911,788,1699
15493,34,State - PUDUCHERRY,Total,12,Preprimary,174,170,344
15494,34,State - PUDUCHERRY,Total,13,Preprimary,81,58,139
15495,34,State - PUDUCHERRY,Total,14,Preprimary,60,53,113
15496,34,State - PUDUCHERRY,Total,15,Preprimary,51,47,98
15497,34,State - PUDUCHERRY,Total,16,Preprimary,53,49,102
15498,34,State - PUDUCHERRY,Total,17,Preprimary,53,54,107
15499,34,State - PUDUCHERRY,Total,18,Preprimary,71,79,150
15500,34,State - PUDUCHERRY,Total,19,Preprimary,76,72,148
15501,34,State - PUDUCHERRY,Total,20-24,Preprimary,551,566,1117
15502,34,State - PUDUCHERRY,Total,25-29,Preprimary,958,1210,2168
15503,34,State - PUDUCHERRY,Total,30-34,Preprimary,1160,1621,2781
15504,34,State - PUDUCHERRY,Total,35-39,Preprimary,1497,2323,3820
15505,34,State - PUDUCHERRY,Total,40-44,Preprimary,1568,2274,3842
15506,34,State - PUDUCHERRY,Total,45-49,Preprimary,1730,2287,4017
15507,34,State - PUDUCHERRY,Total,50-54,Preprimary,1326,1818,3144
15508,34,State - PUDUCHERRY,Total,55-59,Preprimary,1180,1723,2903
15509,34,State - PUDUCHERRY,Total,60-64,Preprimary,1232,1554,2786
15510,34,State - PUDUCHERRY,Total,65-69,Preprimary,847,1114,1961
15511,34,State - PUDUCHERRY,Total,70-74,Preprimary,865,802,1667
15512,34,State - PUDUCHERRY,Total,75-79,Preprimary,518,518,1036
15513,34,State - PUDUCHERRY,Total,80+,Preprimary,483,501,984
15514,34,State - PUDUCHERRY,Total,Age not stated,Preprimary,46,48,94
15515,34,State - PUDUCHERRY,Rural,All ages,Preprimary,14818,15075,29893
15516,34,State - PUDUCHERRY,Rural,0-6,Preprimary,0,0,0
15517,34,State - PUDUCHERRY,Rural,7,Preprimary,2412,2444,4856
15518,34,State - PUDUCHERRY,Rural,8,Preprimary,2938,2766,5704
15519,34,State - PUDUCHERRY,Rural,9,Preprimary,2593,2516,5109
15520,34,State - PUDUCHERRY,Rural,10,Preprimary,1379,1323,2702
15521,34,State - PUDUCHERRY,Rural,11,Preprimary,281,236,517
15522,34,State - PUDUCHERRY,Rural,12,Preprimary,52,59,111
15523,34,State - PUDUCHERRY,Rural,13,Preprimary,16,20,36
15524,34,State - PUDUCHERRY,Rural,14,Preprimary,12,14,26
15525,34,State - PUDUCHERRY,Rural,15,Preprimary,18,12,30
15526,34,State - PUDUCHERRY,Rural,16,Preprimary,16,19,35
15527,34,State - PUDUCHERRY,Rural,17,Preprimary,16,12,28
15528,34,State - PUDUCHERRY,Rural,18,Preprimary,22,23,45
15529,34,State - PUDUCHERRY,Rural,19,Preprimary,29,19,48
15530,34,State - PUDUCHERRY,Rural,20-24,Preprimary,167,161,328
15531,34,State - PUDUCHERRY,Rural,25-29,Preprimary,292,400,692
15532,34,State - PUDUCHERRY,Rural,30-34,Preprimary,355,585,940
15533,34,State - PUDUCHERRY,Rural,35-39,Preprimary,529,884,1413
15534,34,State - PUDUCHERRY,Rural,40-44,Preprimary,547,802,1349
15535,34,State - PUDUCHERRY,Rural,45-49,Preprimary,673,762,1435
15536,34,State - PUDUCHERRY,Rural,50-54,Preprimary,501,555,1056
15537,34,State - PUDUCHERRY,Rural,55-59,Preprimary,466,482,948
15538,34,State - PUDUCHERRY,Rural,60-64,Preprimary,452,381,833
15539,34,State - PUDUCHERRY,Rural,65-69,Preprimary,335,256,591
15540,34,State - PUDUCHERRY,Rural,70-74,Preprimary,340,144,484
15541,34,State - PUDUCHERRY,Rural,75-79,Preprimary,176,88,264
15542,34,State - PUDUCHERRY,Rural,80+,Preprimary,171,87,258
15543,34,State - PUDUCHERRY,Rural,Age not stated,Preprimary,30,25,55
15544,34,State - PUDUCHERRY,Urban,All ages,Preprimary,30344,32949,63293
15545,34,State - PUDUCHERRY,Urban,0-6,Preprimary,0,0,0
15546,34,State - PUDUCHERRY,Urban,7,Preprimary,5470,5129,10599
15547,34,State - PUDUCHERRY,Urban,8,Preprimary,6054,5837,11891
15548,34,State - PUDUCHERRY,Urban,9,Preprimary,5553,5271,10824
15549,34,State - PUDUCHERRY,Urban,10,Preprimary,3272,3009,6281
15550,34,State - PUDUCHERRY,Urban,11,Preprimary,630,552,1182
15551,34,State - PUDUCHERRY,Urban,12,Preprimary,122,111,233
15552,34,State - PUDUCHERRY,Urban,13,Preprimary,65,38,103
15553,34,State - PUDUCHERRY,Urban,14,Preprimary,48,39,87
15554,34,State - PUDUCHERRY,Urban,15,Preprimary,33,35,68
15555,34,State - PUDUCHERRY,Urban,16,Preprimary,37,30,67
15556,34,State - PUDUCHERRY,Urban,17,Preprimary,37,42,79
15557,34,State - PUDUCHERRY,Urban,18,Preprimary,49,56,105
15558,34,State - PUDUCHERRY,Urban,19,Preprimary,47,53,100
15559,34,State - PUDUCHERRY,Urban,20-24,Preprimary,384,405,789
15560,34,State - PUDUCHERRY,Urban,25-29,Preprimary,666,810,1476
15561,34,State - PUDUCHERRY,Urban,30-34,Preprimary,805,1036,1841
15562,34,State - PUDUCHERRY,Urban,35-39,Preprimary,968,1439,2407
15563,34,State - PUDUCHERRY,Urban,40-44,Preprimary,1021,1472,2493
15564,34,State - PUDUCHERRY,Urban,45-49,Preprimary,1057,1525,2582
15565,34,State - PUDUCHERRY,Urban,50-54,Preprimary,825,1263,2088
15566,34,State - PUDUCHERRY,Urban,55-59,Preprimary,714,1241,1955
15567,34,State - PUDUCHERRY,Urban,60-64,Preprimary,780,1173,1953
15568,34,State - PUDUCHERRY,Urban,65-69,Preprimary,512,858,1370
15569,34,State - PUDUCHERRY,Urban,70-74,Preprimary,525,658,1183
15570,34,State - PUDUCHERRY,Urban,75-79,Preprimary,342,430,772
15571,34,State - PUDUCHERRY,Urban,80+,Preprimary,312,414,726
15572,34,State - PUDUCHERRY,Urban,Age not stated,Preprimary,16,23,39
15573,35,State - ANDAMAN & NICOBAR ISLANDS,Total,All ages,Preprimary,22513,19616,42129
15574,35,State - ANDAMAN & NICOBAR ISLANDS,Total,0-6,Preprimary,0,0,0
15575,35,State - ANDAMAN & NICOBAR ISLANDS,Total,7,Preprimary,2606,2483,5089
15576,35,State - ANDAMAN & NICOBAR ISLANDS,Total,8,Preprimary,2888,2704,5592
15577,35,State - ANDAMAN & NICOBAR ISLANDS,Total,9,Preprimary,2645,2630,5275
15578,35,State - ANDAMAN & NICOBAR ISLANDS,Total,10,Preprimary,2153,2055,4208
15579,35,State - ANDAMAN & NICOBAR ISLANDS,Total,11,Preprimary,842,772,1614
15580,35,State - ANDAMAN & NICOBAR ISLANDS,Total,12,Preprimary,282,244,526
15581,35,State - ANDAMAN & NICOBAR ISLANDS,Total,13,Preprimary,132,93,225
15582,35,State - ANDAMAN & NICOBAR ISLANDS,Total,14,Preprimary,79,63,142
15583,35,State - ANDAMAN & NICOBAR ISLANDS,Total,15,Preprimary,72,54,126
15584,35,State - ANDAMAN & NICOBAR ISLANDS,Total,16,Preprimary,90,67,157
15585,35,State - ANDAMAN & NICOBAR ISLANDS,Total,17,Preprimary,70,51,121
15586,35,State - ANDAMAN & NICOBAR ISLANDS,Total,18,Preprimary,118,75,193
15587,35,State - ANDAMAN & NICOBAR ISLANDS,Total,19,Preprimary,124,59,183
15588,35,State - ANDAMAN & NICOBAR ISLANDS,Total,20-24,Preprimary,888,622,1510
15589,35,State - ANDAMAN & NICOBAR ISLANDS,Total,25-29,Preprimary,1091,877,1968
15590,35,State - ANDAMAN & NICOBAR ISLANDS,Total,30-34,Preprimary,974,956,1930
15591,35,State - ANDAMAN & NICOBAR ISLANDS,Total,35-39,Preprimary,1039,1145,2184
15592,35,State - ANDAMAN & NICOBAR ISLANDS,Total,40-44,Preprimary,1084,1038,2122
15593,35,State - ANDAMAN & NICOBAR ISLANDS,Total,45-49,Preprimary,1297,1098,2395
15594,35,State - ANDAMAN & NICOBAR ISLANDS,Total,50-54,Preprimary,941,751,1692
15595,35,State - ANDAMAN & NICOBAR ISLANDS,Total,55-59,Preprimary,885,690,1575
15596,35,State - ANDAMAN & NICOBAR ISLANDS,Total,60-64,Preprimary,793,462,1255
15597,35,State - ANDAMAN & NICOBAR ISLANDS,Total,65-69,Preprimary,548,291,839
15598,35,State - ANDAMAN & NICOBAR ISLANDS,Total,70-74,Preprimary,397,158,555
15599,35,State - ANDAMAN & NICOBAR ISLANDS,Total,75-79,Preprimary,248,85,333
15600,35,State - ANDAMAN & NICOBAR ISLANDS,Total,80+,Preprimary,206,75,281
15601,35,State - ANDAMAN & NICOBAR ISLANDS,Total,Age not stated,Preprimary,21,18,39
15602,35,State - ANDAMAN & NICOBAR ISLANDS,Rural,All ages,Preprimary,15759,13501,29260
15603,35,State - ANDAMAN & NICOBAR ISLANDS,Rural,0-6,Preprimary,0,0,0
15604,35,State - ANDAMAN & NICOBAR ISLANDS,Rural,7,Preprimary,1621,1471,3092
15605,35,State - ANDAMAN & NICOBAR ISLANDS,Rural,8,Preprimary,1802,1662,3464
15606,35,State - ANDAMAN & NICOBAR ISLANDS,Rural,9,Preprimary,1661,1646,3307
15607,35,State - ANDAMAN & NICOBAR ISLANDS,Rural,10,Preprimary,1388,1291,2679
15608,35,State - ANDAMAN & NICOBAR ISLANDS,Rural,11,Preprimary,528,521,1049
15609,35,State - ANDAMAN & NICOBAR ISLANDS,Rural,12,Preprimary,192,165,357
15610,35,State - ANDAMAN & NICOBAR ISLANDS,Rural,13,Preprimary,86,67,153
15611,35,State - ANDAMAN & NICOBAR ISLANDS,Rural,14,Preprimary,58,47,105
15612,35,State - ANDAMAN & NICOBAR ISLANDS,Rural,15,Preprimary,56,38,94
15613,35,State - ANDAMAN & NICOBAR ISLANDS,Rural,16,Preprimary,67,45,112
15614,35,State - ANDAMAN & NICOBAR ISLANDS,Rural,17,Preprimary,46,40,86
15615,35,State - ANDAMAN & NICOBAR ISLANDS,Rural,18,Preprimary,74,53,127
15616,35,State - ANDAMAN & NICOBAR ISLANDS,Rural,19,Preprimary,72,41,113
15617,35,State - ANDAMAN & NICOBAR ISLANDS,Rural,20-24,Preprimary,605,486,1091
15618,35,State - ANDAMAN & NICOBAR ISLANDS,Rural,25-29,Preprimary,829,686,1515
15619,35,State - ANDAMAN & NICOBAR ISLANDS,Rural,30-34,Preprimary,769,752,1521
15620,35,State - ANDAMAN & NICOBAR ISLANDS,Rural,35-39,Preprimary,797,880,1677
15621,35,State - ANDAMAN & NICOBAR ISLANDS,Rural,40-44,Preprimary,873,797,1670
15622,35,State - ANDAMAN & NICOBAR ISLANDS,Rural,45-49,Preprimary,981,848,1829
15623,35,State - ANDAMAN & NICOBAR ISLANDS,Rural,50-54,Preprimary,757,574,1331
15624,35,State - ANDAMAN & NICOBAR ISLANDS,Rural,55-59,Preprimary,705,537,1242
15625,35,State - ANDAMAN & NICOBAR ISLANDS,Rural,60-64,Preprimary,616,375,991
15626,35,State - ANDAMAN & NICOBAR ISLANDS,Rural,65-69,Preprimary,453,243,696
15627,35,State - ANDAMAN & NICOBAR ISLANDS,Rural,70-74,Preprimary,320,117,437
15628,35,State - ANDAMAN & NICOBAR ISLANDS,Rural,75-79,Preprimary,206,53,259
15629,35,State - ANDAMAN & NICOBAR ISLANDS,Rural,80+,Preprimary,188,55,243
15630,35,State - ANDAMAN & NICOBAR ISLANDS,Rural,Age not stated,Preprimary,9,11,20
15631,35,State - ANDAMAN & NICOBAR ISLANDS,Urban,All ages,Preprimary,6754,6115,12869
15632,35,State - ANDAMAN & NICOBAR ISLANDS,Urban,0-6,Preprimary,0,0,0
15633,35,State - ANDAMAN & NICOBAR ISLANDS,Urban,7,Preprimary,985,1012,1997
15634,35,State - ANDAMAN & NICOBAR ISLANDS,Urban,8,Preprimary,1086,1042,2128
15635,35,State - ANDAMAN & NICOBAR ISLANDS,Urban,9,Preprimary,984,984,1968
15636,35,State - ANDAMAN & NICOBAR ISLANDS,Urban,10,Preprimary,765,764,1529
15637,35,State - ANDAMAN & NICOBAR ISLANDS,Urban,11,Preprimary,314,251,565
15638,35,State - ANDAMAN & NICOBAR ISLANDS,Urban,12,Preprimary,90,79,169
15639,35,State - ANDAMAN & NICOBAR ISLANDS,Urban,13,Preprimary,46,26,72
15640,35,State - ANDAMAN & NICOBAR ISLANDS,Urban,14,Preprimary,21,16,37
15641,35,State - ANDAMAN & NICOBAR ISLANDS,Urban,15,Preprimary,16,16,32
15642,35,State - ANDAMAN & NICOBAR ISLANDS,Urban,16,Preprimary,23,22,45
15643,35,State - ANDAMAN & NICOBAR ISLANDS,Urban,17,Preprimary,24,11,35
15644,35,State - ANDAMAN & NICOBAR ISLANDS,Urban,18,Preprimary,44,22,66
15645,35,State - ANDAMAN & NICOBAR ISLANDS,Urban,19,Preprimary,52,18,70
15646,35,State - ANDAMAN & NICOBAR ISLANDS,Urban,20-24,Preprimary,283,136,419
15647,35,State - ANDAMAN & NICOBAR ISLANDS,Urban,25-29,Preprimary,262,191,453
15648,35,State - ANDAMAN & NICOBAR ISLANDS,Urban,30-34,Preprimary,205,204,409
15649,35,State - ANDAMAN & NICOBAR ISLANDS,Urban,35-39,Preprimary,242,265,507
15650,35,State - ANDAMAN & NICOBAR ISLANDS,Urban,40-44,Preprimary,211,241,452
15651,35,State - ANDAMAN & NICOBAR ISLANDS,Urban,45-49,Preprimary,316,250,566
15652,35,State - ANDAMAN & NICOBAR ISLANDS,Urban,50-54,Preprimary,184,177,361
15653,35,State - ANDAMAN & NICOBAR ISLANDS,Urban,55-59,Preprimary,180,153,333
15654,35,State - ANDAMAN & NICOBAR ISLANDS,Urban,60-64,Preprimary,177,87,264
15655,35,State - ANDAMAN & NICOBAR ISLANDS,Urban,65-69,Preprimary,95,48,143
15656,35,State - ANDAMAN & NICOBAR ISLANDS,Urban,70-74,Preprimary,77,41,118
15657,35,State - ANDAMAN & NICOBAR ISLANDS,Urban,75-79,Preprimary,42,32,74
15658,35,State - ANDAMAN & NICOBAR ISLANDS,Urban,80+,Preprimary,18,20,38
15659,35,State - ANDAMAN & NICOBAR ISLANDS,Urban,Age not stated,Preprimary,12,7,19
15660,0,INDIA,Total,All ages,Primary,99311072,84859761,184170833
15661,0,INDIA,Total,0-6,Primary,0,0,0
15662,0,INDIA,Total,7,Primary,0,0,0
15663,0,INDIA,Total,8,Primary,0,0,0
15664,0,INDIA,Total,9,Primary,1231973,1167538,2399511
15665,0,INDIA,Total,10,Primary,4627154,4234004,8861158
15666,0,INDIA,Total,11,Primary,7585285,6959557,14544842
15667,0,INDIA,Total,12,Primary,9301648,8270038,17571686
15668,0,INDIA,Total,13,Primary,6853656,6158001,13011657
15669,0,INDIA,Total,14,Primary,4387739,3835121,8222860
15670,0,INDIA,Total,15,Primary,2927513,2463122,5390635
15671,0,INDIA,Total,16,Primary,2134030,1831077,3965107
15672,0,INDIA,Total,17,Primary,1579151,1326619,2905770
15673,0,INDIA,Total,18,Primary,2287038,1865835,4152873
15674,0,INDIA,Total,19,Primary,1507317,1381339,2888656
15675,0,INDIA,Total,20-24,Primary,8704663,7869340,16574003
15676,0,INDIA,Total,25-29,Primary,7884838,7325521,15210359
15677,0,INDIA,Total,30-34,Primary,6703962,6247410,12951372
15678,0,INDIA,Total,35-39,Primary,6434966,5853133,12288099
15679,0,INDIA,Total,40-44,Primary,5521883,4581299,10103182
15680,0,INDIA,Total,45-49,Primary,4933720,3861682,8795402
15681,0,INDIA,Total,50-54,Primary,3971123,2837147,6808270
15682,0,INDIA,Total,55-59,Primary,2972493,2194677,5167170
15683,0,INDIA,Total,60-64,Primary,2803327,1784292,4587619
15684,0,INDIA,Total,65-69,Primary,1922936,1110655,3033591
15685,0,INDIA,Total,70-74,Primary,1368272,680516,2048788
15686,0,INDIA,Total,75-79,Primary,655496,364773,1020269
15687,0,INDIA,Total,80+,Primary,740460,426091,1166551
15688,0,INDIA,Total,Age not stated,Primary,270429,230974,501403
15689,0,INDIA,Rural,All ages,Primary,71805082,58460068,130265150
15690,0,INDIA,Rural,0-6,Primary,0,0,0
15691,0,INDIA,Rural,7,Primary,0,0,0
15692,0,INDIA,Rural,8,Primary,0,0,0
15693,0,INDIA,Rural,9,Primary,838598,785287,1623885
15694,0,INDIA,Rural,10,Primary,3203214,2899701,6102915
15695,0,INDIA,Rural,11,Primary,5211564,4764299,9975863
15696,0,INDIA,Rural,12,Primary,6750227,5997170,12747397
15697,0,INDIA,Rural,13,Primary,5018163,4552814,9570977
15698,0,INDIA,Rural,14,Primary,3366476,2988865,6355341
15699,0,INDIA,Rural,15,Primary,2299605,1957642,4257247
15700,0,INDIA,Rural,16,Primary,1671179,1450117,3121296
15701,0,INDIA,Rural,17,Primary,1197714,1021338,2219052
15702,0,INDIA,Rural,18,Primary,1751961,1451963,3203924
15703,0,INDIA,Rural,19,Primary,1111362,1047593,2158955
15704,0,INDIA,Rural,20-24,Primary,6445141,5837678,12282819
15705,0,INDIA,Rural,25-29,Primary,5771904,5211286,10983190
15706,0,INDIA,Rural,30-34,Primary,4864035,4316897,9180932
15707,0,INDIA,Rural,35-39,Primary,4611959,3836860,8448819
15708,0,INDIA,Rural,40-44,Primary,3894331,2862955,6757286
15709,0,INDIA,Rural,45-49,Primary,3431725,2290805,5722530
15710,0,INDIA,Rural,50-54,Primary,2767774,1630226,4398000
15711,0,INDIA,Rural,55-59,Primary,2072099,1232125,3304224
15712,0,INDIA,Rural,60-64,Primary,2009936,959319,2969255
15713,0,INDIA,Rural,65-69,Primary,1397186,561148,1958334
15714,0,INDIA,Rural,70-74,Primary,977884,311162,1289046
15715,0,INDIA,Rural,75-79,Primary,449579,149493,599072
15716,0,INDIA,Rural,80+,Primary,505337,193559,698896
15717,0,INDIA,Rural,Age not stated,Primary,186129,149766,335895
15718,0,INDIA,Urban,All ages,Primary,27505990,26399693,53905683
15719,0,INDIA,Urban,0-6,Primary,0,0,0
15720,0,INDIA,Urban,7,Primary,0,0,0
15721,0,INDIA,Urban,8,Primary,0,0,0
15722,0,INDIA,Urban,9,Primary,393375,382251,775626
15723,0,INDIA,Urban,10,Primary,1423940,1334303,2758243
15724,0,INDIA,Urban,11,Primary,2373721,2195258,4568979
15725,0,INDIA,Urban,12,Primary,2551421,2272868,4824289
15726,0,INDIA,Urban,13,Primary,1835493,1605187,3440680
15727,0,INDIA,Urban,14,Primary,1021263,846256,1867519
15728,0,INDIA,Urban,15,Primary,627908,505480,1133388
15729,0,INDIA,Urban,16,Primary,462851,380960,843811
15730,0,INDIA,Urban,17,Primary,381437,305281,686718
15731,0,INDIA,Urban,18,Primary,535077,413872,948949
15732,0,INDIA,Urban,19,Primary,395955,333746,729701
15733,0,INDIA,Urban,20-24,Primary,2259522,2031662,4291184
15734,0,INDIA,Urban,25-29,Primary,2112934,2114235,4227169
15735,0,INDIA,Urban,30-34,Primary,1839927,1930513,3770440
15736,0,INDIA,Urban,35-39,Primary,1823007,2016273,3839280
15737,0,INDIA,Urban,40-44,Primary,1627552,1718344,3345896
15738,0,INDIA,Urban,45-49,Primary,1501995,1570877,3072872
15739,0,INDIA,Urban,50-54,Primary,1203349,1206921,2410270
15740,0,INDIA,Urban,55-59,Primary,900394,962552,1862946
15741,0,INDIA,Urban,60-64,Primary,793391,824973,1618364
15742,0,INDIA,Urban,65-69,Primary,525750,549507,1075257
15743,0,INDIA,Urban,70-74,Primary,390388,369354,759742
15744,0,INDIA,Urban,75-79,Primary,205917,215280,421197
15745,0,INDIA,Urban,80+,Primary,235123,232532,467655
15746,0,INDIA,Urban,Age not stated,Primary,84300,81208,165508
15747,1,State - JAMMU & KASHMIR,Total,All ages,Primary,719512,566397,1285909
15748,1,State - JAMMU & KASHMIR,Total,0-6,Primary,0,0,0
15749,1,State - JAMMU & KASHMIR,Total,7,Primary,0,0,0
15750,1,State - JAMMU & KASHMIR,Total,8,Primary,0,0,0
15751,1,State - JAMMU & KASHMIR,Total,9,Primary,13603,11865,25468
15752,1,State - JAMMU & KASHMIR,Total,10,Primary,47399,40708,88107
15753,1,State - JAMMU & KASHMIR,Total,11,Primary,88841,76326,165167
15754,1,State - JAMMU & KASHMIR,Total,12,Primary,103528,88499,192027
15755,1,State - JAMMU & KASHMIR,Total,13,Primary,79387,67559,146946
15756,1,State - JAMMU & KASHMIR,Total,14,Primary,45704,38114,83818
15757,1,State - JAMMU & KASHMIR,Total,15,Primary,23142,20022,43164
15758,1,State - JAMMU & KASHMIR,Total,16,Primary,13555,12108,25663
15759,1,State - JAMMU & KASHMIR,Total,17,Primary,9070,7603,16673
15760,1,State - JAMMU & KASHMIR,Total,18,Primary,10823,9331,20154
15761,1,State - JAMMU & KASHMIR,Total,19,Primary,7354,6034,13388
15762,1,State - JAMMU & KASHMIR,Total,20-24,Primary,43425,36434,79859
15763,1,State - JAMMU & KASHMIR,Total,25-29,Primary,37803,29754,67557
15764,1,State - JAMMU & KASHMIR,Total,30-34,Primary,36297,27793,64090
15765,1,State - JAMMU & KASHMIR,Total,35-39,Primary,33521,25388,58909
15766,1,State - JAMMU & KASHMIR,Total,40-44,Primary,28149,19272,47421
15767,1,State - JAMMU & KASHMIR,Total,45-49,Primary,25326,16093,41419
15768,1,State - JAMMU & KASHMIR,Total,50-54,Primary,20402,10992,31394
15769,1,State - JAMMU & KASHMIR,Total,55-59,Primary,13423,7491,20914
15770,1,State - JAMMU & KASHMIR,Total,60-64,Primary,13654,5920,19574
15771,1,State - JAMMU & KASHMIR,Total,65-69,Primary,8437,3481,11918
15772,1,State - JAMMU & KASHMIR,Total,70-74,Primary,7372,2327,9699
15773,1,State - JAMMU & KASHMIR,Total,75-79,Primary,3722,1279,5001
15774,1,State - JAMMU & KASHMIR,Total,80+,Primary,5092,1599,6691
15775,1,State - JAMMU & KASHMIR,Total,Age not stated,Primary,483,405,888
15776,1,State - JAMMU & KASHMIR,Rural,All ages,Primary,564510,434962,999472
15777,1,State - JAMMU & KASHMIR,Rural,0-6,Primary,0,0,0
15778,1,State - JAMMU & KASHMIR,Rural,7,Primary,0,0,0
15779,1,State - JAMMU & KASHMIR,Rural,8,Primary,0,0,0
15780,1,State - JAMMU & KASHMIR,Rural,9,Primary,9891,8787,18678
15781,1,State - JAMMU & KASHMIR,Rural,10,Primary,36274,30984,67258
15782,1,State - JAMMU & KASHMIR,Rural,11,Primary,68113,58309,126422
15783,1,State - JAMMU & KASHMIR,Rural,12,Primary,80611,68238,148849
15784,1,State - JAMMU & KASHMIR,Rural,13,Primary,61838,52409,114247
15785,1,State - JAMMU & KASHMIR,Rural,14,Primary,36235,30231,66466
15786,1,State - JAMMU & KASHMIR,Rural,15,Primary,18728,16431,35159
15787,1,State - JAMMU & KASHMIR,Rural,16,Primary,11050,10065,21115
15788,1,State - JAMMU & KASHMIR,Rural,17,Primary,7359,6350,13709
15789,1,State - JAMMU & KASHMIR,Rural,18,Primary,8763,7698,16461
15790,1,State - JAMMU & KASHMIR,Rural,19,Primary,5785,5034,10819
15791,1,State - JAMMU & KASHMIR,Rural,20-24,Primary,35200,29820,65020
15792,1,State - JAMMU & KASHMIR,Rural,25-29,Primary,30846,24028,54874
15793,1,State - JAMMU & KASHMIR,Rural,30-34,Primary,29737,22039,51776
15794,1,State - JAMMU & KASHMIR,Rural,35-39,Primary,26742,19208,45950
15795,1,State - JAMMU & KASHMIR,Rural,40-44,Primary,21715,14173,35888
15796,1,State - JAMMU & KASHMIR,Rural,45-49,Primary,19296,11482,30778
15797,1,State - JAMMU & KASHMIR,Rural,50-54,Primary,15982,7609,23591
15798,1,State - JAMMU & KASHMIR,Rural,55-59,Primary,10602,4710,15312
15799,1,State - JAMMU & KASHMIR,Rural,60-64,Primary,10687,3439,14126
15800,1,State - JAMMU & KASHMIR,Rural,65-69,Primary,6614,1533,8147
15801,1,State - JAMMU & KASHMIR,Rural,70-74,Primary,5604,935,6539
15802,1,State - JAMMU & KASHMIR,Rural,75-79,Primary,2664,426,3090
15803,1,State - JAMMU & KASHMIR,Rural,80+,Primary,3780,695,4475
15804,1,State - JAMMU & KASHMIR,Rural,Age not stated,Primary,394,329,723
15805,1,State - JAMMU & KASHMIR,Urban,All ages,Primary,155002,131435,286437
15806,1,State - JAMMU & KASHMIR,Urban,0-6,Primary,0,0,0
15807,1,State - JAMMU & KASHMIR,Urban,7,Primary,0,0,0
15808,1,State - JAMMU & KASHMIR,Urban,8,Primary,0,0,0
15809,1,State - JAMMU & KASHMIR,Urban,9,Primary,3712,3078,6790
15810,1,State - JAMMU & KASHMIR,Urban,10,Primary,11125,9724,20849
15811,1,State - JAMMU & KASHMIR,Urban,11,Primary,20728,18017,38745
15812,1,State - JAMMU & KASHMIR,Urban,12,Primary,22917,20261,43178
15813,1,State - JAMMU & KASHMIR,Urban,13,Primary,17549,15150,32699
15814,1,State - JAMMU & KASHMIR,Urban,14,Primary,9469,7883,17352
15815,1,State - JAMMU & KASHMIR,Urban,15,Primary,4414,3591,8005
15816,1,State - JAMMU & KASHMIR,Urban,16,Primary,2505,2043,4548
15817,1,State - JAMMU & KASHMIR,Urban,17,Primary,1711,1253,2964
15818,1,State - JAMMU & KASHMIR,Urban,18,Primary,2060,1633,3693
15819,1,State - JAMMU & KASHMIR,Urban,19,Primary,1569,1000,2569
15820,1,State - JAMMU & KASHMIR,Urban,20-24,Primary,8225,6614,14839
15821,1,State - JAMMU & KASHMIR,Urban,25-29,Primary,6957,5726,12683
15822,1,State - JAMMU & KASHMIR,Urban,30-34,Primary,6560,5754,12314
15823,1,State - JAMMU & KASHMIR,Urban,35-39,Primary,6779,6180,12959
15824,1,State - JAMMU & KASHMIR,Urban,40-44,Primary,6434,5099,11533
15825,1,State - JAMMU & KASHMIR,Urban,45-49,Primary,6030,4611,10641
15826,1,State - JAMMU & KASHMIR,Urban,50-54,Primary,4420,3383,7803
15827,1,State - JAMMU & KASHMIR,Urban,55-59,Primary,2821,2781,5602
15828,1,State - JAMMU & KASHMIR,Urban,60-64,Primary,2967,2481,5448
15829,1,State - JAMMU & KASHMIR,Urban,65-69,Primary,1823,1948,3771
15830,1,State - JAMMU & KASHMIR,Urban,70-74,Primary,1768,1392,3160
15831,1,State - JAMMU & KASHMIR,Urban,75-79,Primary,1058,853,1911
15832,1,State - JAMMU & KASHMIR,Urban,80+,Primary,1312,904,2216
15833,1,State - JAMMU & KASHMIR,Urban,Age not stated,Primary,89,76,165
15834,2,State - HIMACHAL PRADESH,Total,All ages,Primary,576764,586231,1162995
15835,2,State - HIMACHAL PRADESH,Total,0-6,Primary,0,0,0
15836,2,State - HIMACHAL PRADESH,Total,7,Primary,0,0,0
15837,2,State - HIMACHAL PRADESH,Total,8,Primary,0,0,0
15838,2,State - HIMACHAL PRADESH,Total,9,Primary,6825,6299,13124
15839,2,State - HIMACHAL PRADESH,Total,10,Primary,30474,27424,57898
15840,2,State - HIMACHAL PRADESH,Total,11,Primary,52629,46750,99379
15841,2,State - HIMACHAL PRADESH,Total,12,Primary,55211,48389,103600
15842,2,State - HIMACHAL PRADESH,Total,13,Primary,40257,35067,75324
15843,2,State - HIMACHAL PRADESH,Total,14,Primary,20751,17888,38639
15844,2,State - HIMACHAL PRADESH,Total,15,Primary,10999,9102,20101
15845,2,State - HIMACHAL PRADESH,Total,16,Primary,7338,6238,13576
15846,2,State - HIMACHAL PRADESH,Total,17,Primary,5957,5081,11038
15847,2,State - HIMACHAL PRADESH,Total,18,Primary,6995,5713,12708
15848,2,State - HIMACHAL PRADESH,Total,19,Primary,6140,5360,11500
15849,2,State - HIMACHAL PRADESH,Total,20-24,Primary,34178,32773,66951
15850,2,State - HIMACHAL PRADESH,Total,25-29,Primary,33633,36523,70156
15851,2,State - HIMACHAL PRADESH,Total,30-34,Primary,35230,43423,78653
15852,2,State - HIMACHAL PRADESH,Total,35-39,Primary,41859,53837,95696
15853,2,State - HIMACHAL PRADESH,Total,40-44,Primary,39960,53505,93465
15854,2,State - HIMACHAL PRADESH,Total,45-49,Primary,39065,51052,90117
15855,2,State - HIMACHAL PRADESH,Total,50-54,Primary,31482,40238,71720
15856,2,State - HIMACHAL PRADESH,Total,55-59,Primary,25065,28436,53501
15857,2,State - HIMACHAL PRADESH,Total,60-64,Primary,20016,16213,36229
15858,2,State - HIMACHAL PRADESH,Total,65-69,Primary,12909,7649,20558
15859,2,State - HIMACHAL PRADESH,Total,70-74,Primary,8973,4305,13278
15860,2,State - HIMACHAL PRADESH,Total,75-79,Primary,4773,2188,6961
15861,2,State - HIMACHAL PRADESH,Total,80+,Primary,5394,2144,7538
15862,2,State - HIMACHAL PRADESH,Total,Age not stated,Primary,651,634,1285
15863,2,State - HIMACHAL PRADESH,Rural,All ages,Primary,532805,548312,1081117
15864,2,State - HIMACHAL PRADESH,Rural,0-6,Primary,0,0,0
15865,2,State - HIMACHAL PRADESH,Rural,7,Primary,0,0,0
15866,2,State - HIMACHAL PRADESH,Rural,8,Primary,0,0,0
15867,2,State - HIMACHAL PRADESH,Rural,9,Primary,6306,5832,12138
15868,2,State - HIMACHAL PRADESH,Rural,10,Primary,28206,25556,53762
15869,2,State - HIMACHAL PRADESH,Rural,11,Primary,47743,42837,90580
15870,2,State - HIMACHAL PRADESH,Rural,12,Primary,49996,44242,94238
15871,2,State - HIMACHAL PRADESH,Rural,13,Primary,36276,32065,68341
15872,2,State - HIMACHAL PRADESH,Rural,14,Primary,18850,16555,35405
15873,2,State - HIMACHAL PRADESH,Rural,15,Primary,10162,8537,18699
15874,2,State - HIMACHAL PRADESH,Rural,16,Primary,6742,5926,12668
15875,2,State - HIMACHAL PRADESH,Rural,17,Primary,5458,4833,10291
15876,2,State - HIMACHAL PRADESH,Rural,18,Primary,6254,5470,11724
15877,2,State - HIMACHAL PRADESH,Rural,19,Primary,5497,5115,10612
15878,2,State - HIMACHAL PRADESH,Rural,20-24,Primary,30982,31166,62148
15879,2,State - HIMACHAL PRADESH,Rural,25-29,Primary,30808,34696,65504
15880,2,State - HIMACHAL PRADESH,Rural,30-34,Primary,32670,41319,73989
15881,2,State - HIMACHAL PRADESH,Rural,35-39,Primary,39252,51021,90273
15882,2,State - HIMACHAL PRADESH,Rural,40-44,Primary,37512,50711,88223
15883,2,State - HIMACHAL PRADESH,Rural,45-49,Primary,36709,48302,85011
15884,2,State - HIMACHAL PRADESH,Rural,50-54,Primary,29659,38098,67757
15885,2,State - HIMACHAL PRADESH,Rural,55-59,Primary,23692,26789,50481
15886,2,State - HIMACHAL PRADESH,Rural,60-64,Primary,19082,15000,34082
15887,2,State - HIMACHAL PRADESH,Rural,65-69,Primary,12309,6764,19073
15888,2,State - HIMACHAL PRADESH,Rural,70-74,Primary,8530,3596,12126
15889,2,State - HIMACHAL PRADESH,Rural,75-79,Primary,4475,1668,6143
15890,2,State - HIMACHAL PRADESH,Rural,80+,Primary,5014,1612,6626
15891,2,State - HIMACHAL PRADESH,Rural,Age not stated,Primary,621,602,1223
15892,2,State - HIMACHAL PRADESH,Urban,All ages,Primary,43959,37919,81878
15893,2,State - HIMACHAL PRADESH,Urban,0-6,Primary,0,0,0
15894,2,State - HIMACHAL PRADESH,Urban,7,Primary,0,0,0
15895,2,State - HIMACHAL PRADESH,Urban,8,Primary,0,0,0
15896,2,State - HIMACHAL PRADESH,Urban,9,Primary,519,467,986
15897,2,State - HIMACHAL PRADESH,Urban,10,Primary,2268,1868,4136
15898,2,State - HIMACHAL PRADESH,Urban,11,Primary,4886,3913,8799
15899,2,State - HIMACHAL PRADESH,Urban,12,Primary,5215,4147,9362
15900,2,State - HIMACHAL PRADESH,Urban,13,Primary,3981,3002,6983
15901,2,State - HIMACHAL PRADESH,Urban,14,Primary,1901,1333,3234
15902,2,State - HIMACHAL PRADESH,Urban,15,Primary,837,565,1402
15903,2,State - HIMACHAL PRADESH,Urban,16,Primary,596,312,908
15904,2,State - HIMACHAL PRADESH,Urban,17,Primary,499,248,747
15905,2,State - HIMACHAL PRADESH,Urban,18,Primary,741,243,984
15906,2,State - HIMACHAL PRADESH,Urban,19,Primary,643,245,888
15907,2,State - HIMACHAL PRADESH,Urban,20-24,Primary,3196,1607,4803
15908,2,State - HIMACHAL PRADESH,Urban,25-29,Primary,2825,1827,4652
15909,2,State - HIMACHAL PRADESH,Urban,30-34,Primary,2560,2104,4664
15910,2,State - HIMACHAL PRADESH,Urban,35-39,Primary,2607,2816,5423
15911,2,State - HIMACHAL PRADESH,Urban,40-44,Primary,2448,2794,5242
15912,2,State - HIMACHAL PRADESH,Urban,45-49,Primary,2356,2750,5106
15913,2,State - HIMACHAL PRADESH,Urban,50-54,Primary,1823,2140,3963
15914,2,State - HIMACHAL PRADESH,Urban,55-59,Primary,1373,1647,3020
15915,2,State - HIMACHAL PRADESH,Urban,60-64,Primary,934,1213,2147
15916,2,State - HIMACHAL PRADESH,Urban,65-69,Primary,600,885,1485
15917,2,State - HIMACHAL PRADESH,Urban,70-74,Primary,443,709,1152
15918,2,State - HIMACHAL PRADESH,Urban,75-79,Primary,298,520,818
15919,2,State - HIMACHAL PRADESH,Urban,80+,Primary,380,532,912
15920,2,State - HIMACHAL PRADESH,Urban,Age not stated,Primary,30,32,62
15921,3,State - PUNJAB,Total,All ages,Primary,2273540,2014660,4288200
15922,3,State - PUNJAB,Total,0-6,Primary,0,0,0
15923,3,State - PUNJAB,Total,7,Primary,0,0,0
15924,3,State - PUNJAB,Total,8,Primary,0,0,0
15925,3,State - PUNJAB,Total,9,Primary,17417,16071,33488
15926,3,State - PUNJAB,Total,10,Primary,68822,60717,129539
15927,3,State - PUNJAB,Total,11,Primary,148269,124645,272914
15928,3,State - PUNJAB,Total,12,Primary,196653,157092,353745
15929,3,State - PUNJAB,Total,13,Primary,182906,137868,320774
15930,3,State - PUNJAB,Total,14,Primary,125777,87288,213065
15931,3,State - PUNJAB,Total,15,Primary,79996,54479,134475
15932,3,State - PUNJAB,Total,16,Primary,57417,41440,98857
15933,3,State - PUNJAB,Total,17,Primary,46536,32828,79364
15934,3,State - PUNJAB,Total,18,Primary,55950,37990,93940
15935,3,State - PUNJAB,Total,19,Primary,42450,28998,71448
15936,3,State - PUNJAB,Total,20-24,Primary,208955,153867,362822
15937,3,State - PUNJAB,Total,25-29,Primary,165901,142334,308235
15938,3,State - PUNJAB,Total,30-34,Primary,137149,138590,275739
15939,3,State - PUNJAB,Total,35-39,Primary,135781,152254,288035
15940,3,State - PUNJAB,Total,40-44,Primary,137290,155640,292930
15941,3,State - PUNJAB,Total,45-49,Primary,124750,142065,266815
15942,3,State - PUNJAB,Total,50-54,Primary,95828,107723,203551
15943,3,State - PUNJAB,Total,55-59,Primary,66939,81115,148054
15944,3,State - PUNJAB,Total,60-64,Primary,64303,73816,138119
15945,3,State - PUNJAB,Total,65-69,Primary,47391,39337,86728
15946,3,State - PUNJAB,Total,70-74,Primary,29603,22143,51746
15947,3,State - PUNJAB,Total,75-79,Primary,14263,10966,25229
15948,3,State - PUNJAB,Total,80+,Primary,20444,12896,33340
15949,3,State - PUNJAB,Total,Age not stated,Primary,2750,2498,5248
15950,3,State - PUNJAB,Rural,All ages,Primary,1555595,1397770,2953365
15951,3,State - PUNJAB,Rural,0-6,Primary,0,0,0
15952,3,State - PUNJAB,Rural,7,Primary,0,0,0
15953,3,State - PUNJAB,Rural,8,Primary,0,0,0
15954,3,State - PUNJAB,Rural,9,Primary,10487,9975,20462
15955,3,State - PUNJAB,Rural,10,Primary,40826,37346,78172
15956,3,State - PUNJAB,Rural,11,Primary,91975,78802,170777
15957,3,State - PUNJAB,Rural,12,Primary,127966,103041,231007
15958,3,State - PUNJAB,Rural,13,Primary,123437,93771,217208
15959,3,State - PUNJAB,Rural,14,Primary,89289,61701,150990
15960,3,State - PUNJAB,Rural,15,Primary,57668,39834,97502
15961,3,State - PUNJAB,Rural,16,Primary,41774,30924,72698
15962,3,State - PUNJAB,Rural,17,Primary,33630,24741,58371
15963,3,State - PUNJAB,Rural,18,Primary,39615,28624,68239
15964,3,State - PUNJAB,Rural,19,Primary,30008,21664,51672
15965,3,State - PUNJAB,Rural,20-24,Primary,147180,113610,260790
15966,3,State - PUNJAB,Rural,25-29,Primary,114972,103690,218662
15967,3,State - PUNJAB,Rural,30-34,Primary,95689,102531,198220
15968,3,State - PUNJAB,Rural,35-39,Primary,94910,111354,206264
15969,3,State - PUNJAB,Rural,40-44,Primary,96939,114009,210948
15970,3,State - PUNJAB,Rural,45-49,Primary,86126,101055,187181
15971,3,State - PUNJAB,Rural,50-54,Primary,65552,74442,139994
15972,3,State - PUNJAB,Rural,55-59,Primary,45544,53664,99208
15973,3,State - PUNJAB,Rural,60-64,Primary,44657,47323,91980
15974,3,State - PUNJAB,Rural,65-69,Primary,33887,22685,56572
15975,3,State - PUNJAB,Rural,70-74,Primary,19691,10654,30345
15976,3,State - PUNJAB,Rural,75-79,Primary,8774,4543,13317
15977,3,State - PUNJAB,Rural,80+,Primary,12889,5842,18731
15978,3,State - PUNJAB,Rural,Age not stated,Primary,2110,1945,4055
15979,3,State - PUNJAB,Urban,All ages,Primary,717945,616890,1334835
15980,3,State - PUNJAB,Urban,0-6,Primary,0,0,0
15981,3,State - PUNJAB,Urban,7,Primary,0,0,0
15982,3,State - PUNJAB,Urban,8,Primary,0,0,0
15983,3,State - PUNJAB,Urban,9,Primary,6930,6096,13026
15984,3,State - PUNJAB,Urban,10,Primary,27996,23371,51367
15985,3,State - PUNJAB,Urban,11,Primary,56294,45843,102137
15986,3,State - PUNJAB,Urban,12,Primary,68687,54051,122738
15987,3,State - PUNJAB,Urban,13,Primary,59469,44097,103566
15988,3,State - PUNJAB,Urban,14,Primary,36488,25587,62075
15989,3,State - PUNJAB,Urban,15,Primary,22328,14645,36973
15990,3,State - PUNJAB,Urban,16,Primary,15643,10516,26159
15991,3,State - PUNJAB,Urban,17,Primary,12906,8087,20993
15992,3,State - PUNJAB,Urban,18,Primary,16335,9366,25701
15993,3,State - PUNJAB,Urban,19,Primary,12442,7334,19776
15994,3,State - PUNJAB,Urban,20-24,Primary,61775,40257,102032
15995,3,State - PUNJAB,Urban,25-29,Primary,50929,38644,89573
15996,3,State - PUNJAB,Urban,30-34,Primary,41460,36059,77519
15997,3,State - PUNJAB,Urban,35-39,Primary,40871,40900,81771
15998,3,State - PUNJAB,Urban,40-44,Primary,40351,41631,81982
15999,3,State - PUNJAB,Urban,45-49,Primary,38624,41010,79634
16000,3,State - PUNJAB,Urban,50-54,Primary,30276,33281,63557
16001,3,State - PUNJAB,Urban,55-59,Primary,21395,27451,48846
16002,3,State - PUNJAB,Urban,60-64,Primary,19646,26493,46139
16003,3,State - PUNJAB,Urban,65-69,Primary,13504,16652,30156
16004,3,State - PUNJAB,Urban,70-74,Primary,9912,11489,21401
16005,3,State - PUNJAB,Urban,75-79,Primary,5489,6423,11912
16006,3,State - PUNJAB,Urban,80+,Primary,7555,7054,14609
16007,3,State - PUNJAB,Urban,Age not stated,Primary,640,553,1193
16008,4,State - CHANDIGARH,Total,All ages,Primary,73645,56598,130243
16009,4,State - CHANDIGARH,Total,0-6,Primary,0,0,0
16010,4,State - CHANDIGARH,Total,7,Primary,0,0,0
16011,4,State - CHANDIGARH,Total,8,Primary,0,0,0
16012,4,State - CHANDIGARH,Total,9,Primary,511,414,925
16013,4,State - CHANDIGARH,Total,10,Primary,2382,1933,4315
16014,4,State - CHANDIGARH,Total,11,Primary,5615,4504,10119
16015,4,State - CHANDIGARH,Total,12,Primary,7268,5732,13000
16016,4,State - CHANDIGARH,Total,13,Primary,6425,5004,11429
16017,4,State - CHANDIGARH,Total,14,Primary,4175,3062,7237
16018,4,State - CHANDIGARH,Total,15,Primary,2542,1788,4330
16019,4,State - CHANDIGARH,Total,16,Primary,1713,1168,2881
16020,4,State - CHANDIGARH,Total,17,Primary,1374,799,2173
16021,4,State - CHANDIGARH,Total,18,Primary,1968,881,2849
16022,4,State - CHANDIGARH,Total,19,Primary,1514,753,2267
16023,4,State - CHANDIGARH,Total,20-24,Primary,7384,4406,11790
16024,4,State - CHANDIGARH,Total,25-29,Primary,6444,4519,10963
16025,4,State - CHANDIGARH,Total,30-34,Primary,5103,3898,9001
16026,4,State - CHANDIGARH,Total,35-39,Primary,4831,3724,8555
16027,4,State - CHANDIGARH,Total,40-44,Primary,3836,3461,7297
16028,4,State - CHANDIGARH,Total,45-49,Primary,3476,2985,6461
16029,4,State - CHANDIGARH,Total,50-54,Primary,2433,2233,4666
16030,4,State - CHANDIGARH,Total,55-59,Primary,1617,1610,3227
16031,4,State - CHANDIGARH,Total,60-64,Primary,1244,1309,2553
16032,4,State - CHANDIGARH,Total,65-69,Primary,702,830,1532
16033,4,State - CHANDIGARH,Total,70-74,Primary,491,598,1089
16034,4,State - CHANDIGARH,Total,75-79,Primary,253,439,692
16035,4,State - CHANDIGARH,Total,80+,Primary,332,538,870
16036,4,State - CHANDIGARH,Total,Age not stated,Primary,12,10,22
16037,4,State - CHANDIGARH,Rural,All ages,Primary,2484,1607,4091
16038,4,State - CHANDIGARH,Rural,0-6,Primary,0,0,0
16039,4,State - CHANDIGARH,Rural,7,Primary,0,0,0
16040,4,State - CHANDIGARH,Rural,8,Primary,0,0,0
16041,4,State - CHANDIGARH,Rural,9,Primary,8,13,21
16042,4,State - CHANDIGARH,Rural,10,Primary,51,37,88
16043,4,State - CHANDIGARH,Rural,11,Primary,140,106,246
16044,4,State - CHANDIGARH,Rural,12,Primary,193,126,319
16045,4,State - CHANDIGARH,Rural,13,Primary,160,128,288
16046,4,State - CHANDIGARH,Rural,14,Primary,117,86,203
16047,4,State - CHANDIGARH,Rural,15,Primary,92,42,134
16048,4,State - CHANDIGARH,Rural,16,Primary,79,29,108
16049,4,State - CHANDIGARH,Rural,17,Primary,49,21,70
16050,4,State - CHANDIGARH,Rural,18,Primary,86,31,117
16051,4,State - CHANDIGARH,Rural,19,Primary,81,27,108
16052,4,State - CHANDIGARH,Rural,20-24,Primary,308,146,454
16053,4,State - CHANDIGARH,Rural,25-29,Primary,254,177,431
16054,4,State - CHANDIGARH,Rural,30-34,Primary,226,144,370
16055,4,State - CHANDIGARH,Rural,35-39,Primary,195,121,316
16056,4,State - CHANDIGARH,Rural,40-44,Primary,146,114,260
16057,4,State - CHANDIGARH,Rural,45-49,Primary,112,90,202
16058,4,State - CHANDIGARH,Rural,50-54,Primary,59,62,121
16059,4,State - CHANDIGARH,Rural,55-59,Primary,43,47,90
16060,4,State - CHANDIGARH,Rural,60-64,Primary,39,32,71
16061,4,State - CHANDIGARH,Rural,65-69,Primary,18,14,32
16062,4,State - CHANDIGARH,Rural,70-74,Primary,9,9,18
16063,4,State - CHANDIGARH,Rural,75-79,Primary,9,2,11
16064,4,State - CHANDIGARH,Rural,80+,Primary,10,3,13
16065,4,State - CHANDIGARH,Rural,Age not stated,Primary,0,0,0
16066,4,State - CHANDIGARH,Urban,All ages,Primary,71161,54991,126152
16067,4,State - CHANDIGARH,Urban,0-6,Primary,0,0,0
16068,4,State - CHANDIGARH,Urban,7,Primary,0,0,0
16069,4,State - CHANDIGARH,Urban,8,Primary,0,0,0
16070,4,State - CHANDIGARH,Urban,9,Primary,503,401,904
16071,4,State - CHANDIGARH,Urban,10,Primary,2331,1896,4227
16072,4,State - CHANDIGARH,Urban,11,Primary,5475,4398,9873
16073,4,State - CHANDIGARH,Urban,12,Primary,7075,5606,12681
16074,4,State - CHANDIGARH,Urban,13,Primary,6265,4876,11141
16075,4,State - CHANDIGARH,Urban,14,Primary,4058,2976,7034
16076,4,State - CHANDIGARH,Urban,15,Primary,2450,1746,4196
16077,4,State - CHANDIGARH,Urban,16,Primary,1634,1139,2773
16078,4,State - CHANDIGARH,Urban,17,Primary,1325,778,2103
16079,4,State - CHANDIGARH,Urban,18,Primary,1882,850,2732
16080,4,State - CHANDIGARH,Urban,19,Primary,1433,726,2159
16081,4,State - CHANDIGARH,Urban,20-24,Primary,7076,4260,11336
16082,4,State - CHANDIGARH,Urban,25-29,Primary,6190,4342,10532
16083,4,State - CHANDIGARH,Urban,30-34,Primary,4877,3754,8631
16084,4,State - CHANDIGARH,Urban,35-39,Primary,4636,3603,8239
16085,4,State - CHANDIGARH,Urban,40-44,Primary,3690,3347,7037
16086,4,State - CHANDIGARH,Urban,45-49,Primary,3364,2895,6259
16087,4,State - CHANDIGARH,Urban,50-54,Primary,2374,2171,4545
16088,4,State - CHANDIGARH,Urban,55-59,Primary,1574,1563,3137
16089,4,State - CHANDIGARH,Urban,60-64,Primary,1205,1277,2482
16090,4,State - CHANDIGARH,Urban,65-69,Primary,684,816,1500
16091,4,State - CHANDIGARH,Urban,70-74,Primary,482,589,1071
16092,4,State - CHANDIGARH,Urban,75-79,Primary,244,437,681
16093,4,State - CHANDIGARH,Urban,80+,Primary,322,535,857
16094,4,State - CHANDIGARH,Urban,Age not stated,Primary,12,10,22
16095,5,State - UTTARAKHAND,Total,All ages,Primary,803056,747518,1550574
16096,5,State - UTTARAKHAND,Total,0-6,Primary,0,0,0
16097,5,State - UTTARAKHAND,Total,7,Primary,0,0,0
16098,5,State - UTTARAKHAND,Total,8,Primary,0,0,0
16099,5,State - UTTARAKHAND,Total,9,Primary,10311,9384,19695
16100,5,State - UTTARAKHAND,Total,10,Primary,38965,34732,73697
16101,5,State - UTTARAKHAND,Total,11,Primary,66364,60446,126810
16102,5,State - UTTARAKHAND,Total,12,Primary,82598,74956,157554
16103,5,State - UTTARAKHAND,Total,13,Primary,62816,59110,121926
16104,5,State - UTTARAKHAND,Total,14,Primary,42955,39584,82539
16105,5,State - UTTARAKHAND,Total,15,Primary,26357,25045,51402
16106,5,State - UTTARAKHAND,Total,16,Primary,17447,17142,34589
16107,5,State - UTTARAKHAND,Total,17,Primary,12073,11524,23597
16108,5,State - UTTARAKHAND,Total,18,Primary,16703,14552,31255
16109,5,State - UTTARAKHAND,Total,19,Primary,11306,10398,21704
16110,5,State - UTTARAKHAND,Total,20-24,Primary,56640,57260,113900
16111,5,State - UTTARAKHAND,Total,25-29,Primary,44949,52367,97316
16112,5,State - UTTARAKHAND,Total,30-34,Primary,39668,50565,90233
16113,5,State - UTTARAKHAND,Total,35-39,Primary,42499,53251,95750
16114,5,State - UTTARAKHAND,Total,40-44,Primary,39295,46025,85320
16115,5,State - UTTARAKHAND,Total,45-49,Primary,38207,39362,77569
16116,5,State - UTTARAKHAND,Total,50-54,Primary,33581,30241,63822
16117,5,State - UTTARAKHAND,Total,55-59,Primary,26919,22238,49157
16118,5,State - UTTARAKHAND,Total,60-64,Primary,34048,16551,50599
16119,5,State - UTTARAKHAND,Total,65-69,Primary,23247,9841,33088
16120,5,State - UTTARAKHAND,Total,70-74,Primary,17370,5714,23084
16121,5,State - UTTARAKHAND,Total,75-79,Primary,8612,2897,11509
16122,5,State - UTTARAKHAND,Total,80+,Primary,9094,3448,12542
16123,5,State - UTTARAKHAND,Total,Age not stated,Primary,1032,885,1917
16124,5,State - UTTARAKHAND,Rural,All ages,Primary,595425,562972,1158397
16125,5,State - UTTARAKHAND,Rural,0-6,Primary,0,0,0
16126,5,State - UTTARAKHAND,Rural,7,Primary,0,0,0
16127,5,State - UTTARAKHAND,Rural,8,Primary,0,0,0
16128,5,State - UTTARAKHAND,Rural,9,Primary,7324,6729,14053
16129,5,State - UTTARAKHAND,Rural,10,Primary,28427,25611,54038
16130,5,State - UTTARAKHAND,Rural,11,Primary,48192,44805,92997
16131,5,State - UTTARAKHAND,Rural,12,Primary,61045,56854,117899
16132,5,State - UTTARAKHAND,Rural,13,Primary,46441,45213,91654
16133,5,State - UTTARAKHAND,Rural,14,Primary,31983,30785,62768
16134,5,State - UTTARAKHAND,Rural,15,Primary,19342,19386,38728
16135,5,State - UTTARAKHAND,Rural,16,Primary,12417,13148,25565
16136,5,State - UTTARAKHAND,Rural,17,Primary,8202,8679,16881
16137,5,State - UTTARAKHAND,Rural,18,Primary,11267,10964,22231
16138,5,State - UTTARAKHAND,Rural,19,Primary,7559,8044,15603
16139,5,State - UTTARAKHAND,Rural,20-24,Primary,37914,44579,82493
16140,5,State - UTTARAKHAND,Rural,25-29,Primary,30818,41169,71987
16141,5,State - UTTARAKHAND,Rural,30-34,Primary,28066,40131,68197
16142,5,State - UTTARAKHAND,Rural,35-39,Primary,30867,41718,72585
16143,5,State - UTTARAKHAND,Rural,40-44,Primary,29447,35285,64732
16144,5,State - UTTARAKHAND,Rural,45-49,Primary,29111,28873,57984
16145,5,State - UTTARAKHAND,Rural,50-54,Primary,26563,22067,48630
16146,5,State - UTTARAKHAND,Rural,55-59,Primary,21747,15824,37571
16147,5,State - UTTARAKHAND,Rural,60-64,Primary,28961,10863,39824
16148,5,State - UTTARAKHAND,Rural,65-69,Primary,19839,5780,25619
16149,5,State - UTTARAKHAND,Rural,70-74,Primary,14847,3021,17868
16150,5,State - UTTARAKHAND,Rural,75-79,Primary,7200,1280,8480
16151,5,State - UTTARAKHAND,Rural,80+,Primary,7126,1557,8683
16152,5,State - UTTARAKHAND,Rural,Age not stated,Primary,720,607,1327
16153,5,State - UTTARAKHAND,Urban,All ages,Primary,207631,184546,392177
16154,5,State - UTTARAKHAND,Urban,0-6,Primary,0,0,0
16155,5,State - UTTARAKHAND,Urban,7,Primary,0,0,0
16156,5,State - UTTARAKHAND,Urban,8,Primary,0,0,0
16157,5,State - UTTARAKHAND,Urban,9,Primary,2987,2655,5642
16158,5,State - UTTARAKHAND,Urban,10,Primary,10538,9121,19659
16159,5,State - UTTARAKHAND,Urban,11,Primary,18172,15641,33813
16160,5,State - UTTARAKHAND,Urban,12,Primary,21553,18102,39655
16161,5,State - UTTARAKHAND,Urban,13,Primary,16375,13897,30272
16162,5,State - UTTARAKHAND,Urban,14,Primary,10972,8799,19771
16163,5,State - UTTARAKHAND,Urban,15,Primary,7015,5659,12674
16164,5,State - UTTARAKHAND,Urban,16,Primary,5030,3994,9024
16165,5,State - UTTARAKHAND,Urban,17,Primary,3871,2845,6716
16166,5,State - UTTARAKHAND,Urban,18,Primary,5436,3588,9024
16167,5,State - UTTARAKHAND,Urban,19,Primary,3747,2354,6101
16168,5,State - UTTARAKHAND,Urban,20-24,Primary,18726,12681,31407
16169,5,State - UTTARAKHAND,Urban,25-29,Primary,14131,11198,25329
16170,5,State - UTTARAKHAND,Urban,30-34,Primary,11602,10434,22036
16171,5,State - UTTARAKHAND,Urban,35-39,Primary,11632,11533,23165
16172,5,State - UTTARAKHAND,Urban,40-44,Primary,9848,10740,20588
16173,5,State - UTTARAKHAND,Urban,45-49,Primary,9096,10489,19585
16174,5,State - UTTARAKHAND,Urban,50-54,Primary,7018,8174,15192
16175,5,State - UTTARAKHAND,Urban,55-59,Primary,5172,6414,11586
16176,5,State - UTTARAKHAND,Urban,60-64,Primary,5087,5688,10775
16177,5,State - UTTARAKHAND,Urban,65-69,Primary,3408,4061,7469
16178,5,State - UTTARAKHAND,Urban,70-74,Primary,2523,2693,5216
16179,5,State - UTTARAKHAND,Urban,75-79,Primary,1412,1617,3029
16180,5,State - UTTARAKHAND,Urban,80+,Primary,1968,1891,3859
16181,5,State - UTTARAKHAND,Urban,Age not stated,Primary,312,278,590
16182,6,State - HARYANA,Total,All ages,Primary,2075334,1696688,3772022
16183,6,State - HARYANA,Total,0-6,Primary,0,0,0
16184,6,State - HARYANA,Total,7,Primary,0,0,0
16185,6,State - HARYANA,Total,8,Primary,0,0,0
16186,6,State - HARYANA,Total,9,Primary,17730,15561,33291
16187,6,State - HARYANA,Total,10,Primary,77293,63429,140722
16188,6,State - HARYANA,Total,11,Primary,154710,124412,279122
16189,6,State - HARYANA,Total,12,Primary,203670,158472,362142
16190,6,State - HARYANA,Total,13,Primary,167857,131935,299792
16191,6,State - HARYANA,Total,14,Primary,107356,81593,188949
16192,6,State - HARYANA,Total,15,Primary,65069,48137,113206
16193,6,State - HARYANA,Total,16,Primary,43508,33724,77232
16194,6,State - HARYANA,Total,17,Primary,32491,25743,58234
16195,6,State - HARYANA,Total,18,Primary,45093,35184,80277
16196,6,State - HARYANA,Total,19,Primary,33137,27846,60983
16197,6,State - HARYANA,Total,20-24,Primary,193205,168294,361499
16198,6,State - HARYANA,Total,25-29,Primary,171670,163685,335355
16199,6,State - HARYANA,Total,30-34,Primary,153554,150987,304541
16200,6,State - HARYANA,Total,35-39,Primary,141592,130868,272460
16201,6,State - HARYANA,Total,40-44,Primary,121491,99585,221076
16202,6,State - HARYANA,Total,45-49,Primary,103759,72529,176288
16203,6,State - HARYANA,Total,50-54,Primary,68631,49093,117724
16204,6,State - HARYANA,Total,55-59,Primary,44018,36995,81013
16205,6,State - HARYANA,Total,60-64,Primary,53841,36392,90233
16206,6,State - HARYANA,Total,65-69,Primary,30426,17465,47891
16207,6,State - HARYANA,Total,70-74,Primary,19994,10720,30714
16208,6,State - HARYANA,Total,75-79,Primary,10040,5593,15633
16209,6,State - HARYANA,Total,80+,Primary,13119,6701,19820
16210,6,State - HARYANA,Total,Age not stated,Primary,2080,1745,3825
16211,6,State - HARYANA,Rural,All ages,Primary,1481060,1182665,2663725
16212,6,State - HARYANA,Rural,0-6,Primary,0,0,0
16213,6,State - HARYANA,Rural,7,Primary,0,0,0
16214,6,State - HARYANA,Rural,8,Primary,0,0,0
16215,6,State - HARYANA,Rural,9,Primary,11049,9880,20929
16216,6,State - HARYANA,Rural,10,Primary,48860,40425,89285
16217,6,State - HARYANA,Rural,11,Primary,101177,82154,183331
16218,6,State - HARYANA,Rural,12,Primary,138980,108568,247548
16219,6,State - HARYANA,Rural,13,Primary,117026,92772,209798
16220,6,State - HARYANA,Rural,14,Primary,77457,59430,136887
16221,6,State - HARYANA,Rural,15,Primary,47140,35329,82469
16222,6,State - HARYANA,Rural,16,Primary,31892,25215,57107
16223,6,State - HARYANA,Rural,17,Primary,23404,19591,42995
16224,6,State - HARYANA,Rural,18,Primary,33043,27069,60112
16225,6,State - HARYANA,Rural,19,Primary,24067,21373,45440
16226,6,State - HARYANA,Rural,20-24,Primary,143152,128553,271705
16227,6,State - HARYANA,Rural,25-29,Primary,128040,124320,252360
16228,6,State - HARYANA,Rural,30-34,Primary,116302,114766,231068
16229,6,State - HARYANA,Rural,35-39,Primary,105070,94906,199976
16230,6,State - HARYANA,Rural,40-44,Primary,89574,69133,158707
16231,6,State - HARYANA,Rural,45-49,Primary,75214,45658,120872
16232,6,State - HARYANA,Rural,50-54,Primary,48790,28856,77646
16233,6,State - HARYANA,Rural,55-59,Primary,30833,20269,51102
16234,6,State - HARYANA,Rural,60-64,Primary,38935,18540,57475
16235,6,State - HARYANA,Rural,65-69,Primary,21600,7154,28754
16236,6,State - HARYANA,Rural,70-74,Primary,13604,3540,17144
16237,6,State - HARYANA,Rural,75-79,Primary,6294,1573,7867
16238,6,State - HARYANA,Rural,80+,Primary,8051,2313,10364
16239,6,State - HARYANA,Rural,Age not stated,Primary,1506,1278,2784
16240,6,State - HARYANA,Urban,All ages,Primary,594274,514023,1108297
16241,6,State - HARYANA,Urban,0-6,Primary,0,0,0
16242,6,State - HARYANA,Urban,7,Primary,0,0,0
16243,6,State - HARYANA,Urban,8,Primary,0,0,0
16244,6,State - HARYANA,Urban,9,Primary,6681,5681,12362
16245,6,State - HARYANA,Urban,10,Primary,28433,23004,51437
16246,6,State - HARYANA,Urban,11,Primary,53533,42258,95791
16247,6,State - HARYANA,Urban,12,Primary,64690,49904,114594
16248,6,State - HARYANA,Urban,13,Primary,50831,39163,89994
16249,6,State - HARYANA,Urban,14,Primary,29899,22163,52062
16250,6,State - HARYANA,Urban,15,Primary,17929,12808,30737
16251,6,State - HARYANA,Urban,16,Primary,11616,8509,20125
16252,6,State - HARYANA,Urban,17,Primary,9087,6152,15239
16253,6,State - HARYANA,Urban,18,Primary,12050,8115,20165
16254,6,State - HARYANA,Urban,19,Primary,9070,6473,15543
16255,6,State - HARYANA,Urban,20-24,Primary,50053,39741,89794
16256,6,State - HARYANA,Urban,25-29,Primary,43630,39365,82995
16257,6,State - HARYANA,Urban,30-34,Primary,37252,36221,73473
16258,6,State - HARYANA,Urban,35-39,Primary,36522,35962,72484
16259,6,State - HARYANA,Urban,40-44,Primary,31917,30452,62369
16260,6,State - HARYANA,Urban,45-49,Primary,28545,26871,55416
16261,6,State - HARYANA,Urban,50-54,Primary,19841,20237,40078
16262,6,State - HARYANA,Urban,55-59,Primary,13185,16726,29911
16263,6,State - HARYANA,Urban,60-64,Primary,14906,17852,32758
16264,6,State - HARYANA,Urban,65-69,Primary,8826,10311,19137
16265,6,State - HARYANA,Urban,70-74,Primary,6390,7180,13570
16266,6,State - HARYANA,Urban,75-79,Primary,3746,4020,7766
16267,6,State - HARYANA,Urban,80+,Primary,5068,4388,9456
16268,6,State - HARYANA,Urban,Age not stated,Primary,574,467,1041
16269,7,State - NCT OF DELHI,Total,All ages,Primary,1197622,1033272,2230894
16270,7,State - NCT OF DELHI,Total,0-6,Primary,0,0,0
16271,7,State - NCT OF DELHI,Total,7,Primary,0,0,0
16272,7,State - NCT OF DELHI,Total,8,Primary,0,0,0
16273,7,State - NCT OF DELHI,Total,9,Primary,11465,10662,22127
16274,7,State - NCT OF DELHI,Total,10,Primary,51989,46077,98066
16275,7,State - NCT OF DELHI,Total,11,Primary,100818,87414,188232
16276,7,State - NCT OF DELHI,Total,12,Primary,129166,107776,236942
16277,7,State - NCT OF DELHI,Total,13,Primary,104399,86431,190830
16278,7,State - NCT OF DELHI,Total,14,Primary,64170,50037,114207
16279,7,State - NCT OF DELHI,Total,15,Primary,37582,27727,65309
16280,7,State - NCT OF DELHI,Total,16,Primary,25292,18880,44172
16281,7,State - NCT OF DELHI,Total,17,Primary,20311,14223,34534
16282,7,State - NCT OF DELHI,Total,18,Primary,29376,18766,48142
16283,7,State - NCT OF DELHI,Total,19,Primary,21230,13875,35105
16284,7,State - NCT OF DELHI,Total,20-24,Primary,116740,85444,202184
16285,7,State - NCT OF DELHI,Total,25-29,Primary,95067,81206,176273
16286,7,State - NCT OF DELHI,Total,30-34,Primary,76172,72277,148449
16287,7,State - NCT OF DELHI,Total,35-39,Primary,71869,70520,142389
16288,7,State - NCT OF DELHI,Total,40-44,Primary,61433,58027,119460
16289,7,State - NCT OF DELHI,Total,45-49,Primary,51902,47057,98959
16290,7,State - NCT OF DELHI,Total,50-54,Primary,36852,34414,71266
16291,7,State - NCT OF DELHI,Total,55-59,Primary,24772,26972,51744
16292,7,State - NCT OF DELHI,Total,60-64,Primary,28392,29136,57528
16293,7,State - NCT OF DELHI,Total,65-69,Primary,15037,16739,31776
16294,7,State - NCT OF DELHI,Total,70-74,Primary,10417,12517,22934
16295,7,State - NCT OF DELHI,Total,75-79,Primary,5537,7911,13448
16296,7,State - NCT OF DELHI,Total,80+,Primary,6663,8352,15015
16297,7,State - NCT OF DELHI,Total,Age not stated,Primary,971,832,1803
16298,7,State - NCT OF DELHI,Rural,All ages,Primary,31897,27514,59411
16299,7,State - NCT OF DELHI,Rural,0-6,Primary,0,0,0
16300,7,State - NCT OF DELHI,Rural,7,Primary,0,0,0
16301,7,State - NCT OF DELHI,Rural,8,Primary,0,0,0
16302,7,State - NCT OF DELHI,Rural,9,Primary,360,326,686
16303,7,State - NCT OF DELHI,Rural,10,Primary,1540,1321,2861
16304,7,State - NCT OF DELHI,Rural,11,Primary,2778,2294,5072
16305,7,State - NCT OF DELHI,Rural,12,Primary,3629,2834,6463
16306,7,State - NCT OF DELHI,Rural,13,Primary,2981,2167,5148
16307,7,State - NCT OF DELHI,Rural,14,Primary,1800,1291,3091
16308,7,State - NCT OF DELHI,Rural,15,Primary,1111,791,1902
16309,7,State - NCT OF DELHI,Rural,16,Primary,688,517,1205
16310,7,State - NCT OF DELHI,Rural,17,Primary,595,394,989
16311,7,State - NCT OF DELHI,Rural,18,Primary,840,542,1382
16312,7,State - NCT OF DELHI,Rural,19,Primary,539,419,958
16313,7,State - NCT OF DELHI,Rural,20-24,Primary,2999,2368,5367
16314,7,State - NCT OF DELHI,Rural,25-29,Primary,2358,2173,4531
16315,7,State - NCT OF DELHI,Rural,30-34,Primary,1872,2115,3987
16316,7,State - NCT OF DELHI,Rural,35-39,Primary,1733,2003,3736
16317,7,State - NCT OF DELHI,Rural,40-44,Primary,1542,1736,3278
16318,7,State - NCT OF DELHI,Rural,45-49,Primary,1238,1299,2537
16319,7,State - NCT OF DELHI,Rural,50-54,Primary,930,969,1899
16320,7,State - NCT OF DELHI,Rural,55-59,Primary,565,674,1239
16321,7,State - NCT OF DELHI,Rural,60-64,Primary,813,685,1498
16322,7,State - NCT OF DELHI,Rural,65-69,Primary,397,272,669
16323,7,State - NCT OF DELHI,Rural,70-74,Primary,273,174,447
16324,7,State - NCT OF DELHI,Rural,75-79,Primary,120,53,173
16325,7,State - NCT OF DELHI,Rural,80+,Primary,168,68,236
16326,7,State - NCT OF DELHI,Rural,Age not stated,Primary,28,29,57
16327,7,State - NCT OF DELHI,Urban,All ages,Primary,1165725,1005758,2171483
16328,7,State - NCT OF DELHI,Urban,0-6,Primary,0,0,0
16329,7,State - NCT OF DELHI,Urban,7,Primary,0,0,0
16330,7,State - NCT OF DELHI,Urban,8,Primary,0,0,0
16331,7,State - NCT OF DELHI,Urban,9,Primary,11105,10336,21441
16332,7,State - NCT OF DELHI,Urban,10,Primary,50449,44756,95205
16333,7,State - NCT OF DELHI,Urban,11,Primary,98040,85120,183160
16334,7,State - NCT OF DELHI,Urban,12,Primary,125537,104942,230479
16335,7,State - NCT OF DELHI,Urban,13,Primary,101418,84264,185682
16336,7,State - NCT OF DELHI,Urban,14,Primary,62370,48746,111116
16337,7,State - NCT OF DELHI,Urban,15,Primary,36471,26936,63407
16338,7,State - NCT OF DELHI,Urban,16,Primary,24604,18363,42967
16339,7,State - NCT OF DELHI,Urban,17,Primary,19716,13829,33545
16340,7,State - NCT OF DELHI,Urban,18,Primary,28536,18224,46760
16341,7,State - NCT OF DELHI,Urban,19,Primary,20691,13456,34147
16342,7,State - NCT OF DELHI,Urban,20-24,Primary,113741,83076,196817
16343,7,State - NCT OF DELHI,Urban,25-29,Primary,92709,79033,171742
16344,7,State - NCT OF DELHI,Urban,30-34,Primary,74300,70162,144462
16345,7,State - NCT OF DELHI,Urban,35-39,Primary,70136,68517,138653
16346,7,State - NCT OF DELHI,Urban,40-44,Primary,59891,56291,116182
16347,7,State - NCT OF DELHI,Urban,45-49,Primary,50664,45758,96422
16348,7,State - NCT OF DELHI,Urban,50-54,Primary,35922,33445,69367
16349,7,State - NCT OF DELHI,Urban,55-59,Primary,24207,26298,50505
16350,7,State - NCT OF DELHI,Urban,60-64,Primary,27579,28451,56030
16351,7,State - NCT OF DELHI,Urban,65-69,Primary,14640,16467,31107
16352,7,State - NCT OF DELHI,Urban,70-74,Primary,10144,12343,22487
16353,7,State - NCT OF DELHI,Urban,75-79,Primary,5417,7858,13275
16354,7,State - NCT OF DELHI,Urban,80+,Primary,6495,8284,14779
16355,7,State - NCT OF DELHI,Urban,Age not stated,Primary,943,803,1746
16356,8,State - RAJASTHAN,Total,All ages,Primary,6143552,4380872,10524424
16357,8,State - RAJASTHAN,Total,0-6,Primary,0,0,0
16358,8,State - RAJASTHAN,Total,7,Primary,0,0,0
16359,8,State - RAJASTHAN,Total,8,Primary,0,0,0
16360,8,State - RAJASTHAN,Total,9,Primary,93444,74319,167763
16361,8,State - RAJASTHAN,Total,10,Primary,313641,244231,557872
16362,8,State - RAJASTHAN,Total,11,Primary,461087,362945,824032
16363,8,State - RAJASTHAN,Total,12,Primary,572772,449759,1022531
16364,8,State - RAJASTHAN,Total,13,Primary,425976,353578,779554
16365,8,State - RAJASTHAN,Total,14,Primary,305167,261497,566664
16366,8,State - RAJASTHAN,Total,15,Primary,221721,196140,417861
16367,8,State - RAJASTHAN,Total,16,Primary,163736,157789,321525
16368,8,State - RAJASTHAN,Total,17,Primary,108915,108419,217334
16369,8,State - RAJASTHAN,Total,18,Primary,172799,157921,330720
16370,8,State - RAJASTHAN,Total,19,Primary,98450,97301,195751
16371,8,State - RAJASTHAN,Total,20-24,Primary,649005,513567,1162572
16372,8,State - RAJASTHAN,Total,25-29,Primary,538184,369183,907367
16373,8,State - RAJASTHAN,Total,30-34,Primary,435167,280330,715497
16374,8,State - RAJASTHAN,Total,35-39,Primary,376638,212810,589448
16375,8,State - RAJASTHAN,Total,40-44,Primary,298709,154002,452711
16376,8,State - RAJASTHAN,Total,45-49,Primary,244936,114900,359836
16377,8,State - RAJASTHAN,Total,50-54,Primary,203940,82778,286718
16378,8,State - RAJASTHAN,Total,55-59,Primary,139347,59568,198915
16379,8,State - RAJASTHAN,Total,60-64,Primary,121032,47355,168387
16380,8,State - RAJASTHAN,Total,65-69,Primary,75349,29912,105261
16381,8,State - RAJASTHAN,Total,70-74,Primary,53228,17886,71114
16382,8,State - RAJASTHAN,Total,75-79,Primary,24033,9015,33048
16383,8,State - RAJASTHAN,Total,80+,Primary,26727,10740,37467
16384,8,State - RAJASTHAN,Total,Age not stated,Primary,19549,14927,34476
16385,8,State - RAJASTHAN,Rural,All ages,Primary,4849831,3207006,8056837
16386,8,State - RAJASTHAN,Rural,0-6,Primary,0,0,0
16387,8,State - RAJASTHAN,Rural,7,Primary,0,0,0
16388,8,State - RAJASTHAN,Rural,8,Primary,0,0,0
16389,8,State - RAJASTHAN,Rural,9,Primary,70703,54026,124729
16390,8,State - RAJASTHAN,Rural,10,Primary,240114,181287,421401
16391,8,State - RAJASTHAN,Rural,11,Primary,353295,270810,624105
16392,8,State - RAJASTHAN,Rural,12,Primary,451672,349253,800925
16393,8,State - RAJASTHAN,Rural,13,Primary,336829,277303,614132
16394,8,State - RAJASTHAN,Rural,14,Primary,247578,212472,460050
16395,8,State - RAJASTHAN,Rural,15,Primary,180955,160786,341741
16396,8,State - RAJASTHAN,Rural,16,Primary,135105,130667,265772
16397,8,State - RAJASTHAN,Rural,17,Primary,87337,88065,175402
16398,8,State - RAJASTHAN,Rural,18,Primary,141271,129286,270557
16399,8,State - RAJASTHAN,Rural,19,Primary,78559,78210,156769
16400,8,State - RAJASTHAN,Rural,20-24,Primary,528387,399465,927852
16401,8,State - RAJASTHAN,Rural,25-29,Primary,437017,271831,708848
16402,8,State - RAJASTHAN,Rural,30-34,Primary,351135,196644,547779
16403,8,State - RAJASTHAN,Rural,35-39,Primary,297127,136265,433392
16404,8,State - RAJASTHAN,Rural,40-44,Primary,231941,90829,322770
16405,8,State - RAJASTHAN,Rural,45-49,Primary,186354,59682,246036
16406,8,State - RAJASTHAN,Rural,50-54,Primary,154049,39203,193252
16407,8,State - RAJASTHAN,Rural,55-59,Primary,105142,25993,131135
16408,8,State - RAJASTHAN,Rural,60-64,Primary,91488,19559,111047
16409,8,State - RAJASTHAN,Rural,65-69,Primary,56250,11321,67571
16410,8,State - RAJASTHAN,Rural,70-74,Primary,37941,5803,43744
16411,8,State - RAJASTHAN,Rural,75-79,Primary,16121,2467,18588
16412,8,State - RAJASTHAN,Rural,80+,Primary,17207,3983,21190
16413,8,State - RAJASTHAN,Rural,Age not stated,Primary,16254,11796,28050
16414,8,State - RAJASTHAN,Urban,All ages,Primary,1293721,1173866,2467587
16415,8,State - RAJASTHAN,Urban,0-6,Primary,0,0,0
16416,8,State - RAJASTHAN,Urban,7,Primary,0,0,0
16417,8,State - RAJASTHAN,Urban,8,Primary,0,0,0
16418,8,State - RAJASTHAN,Urban,9,Primary,22741,20293,43034
16419,8,State - RAJASTHAN,Urban,10,Primary,73527,62944,136471
16420,8,State - RAJASTHAN,Urban,11,Primary,107792,92135,199927
16421,8,State - RAJASTHAN,Urban,12,Primary,121100,100506,221606
16422,8,State - RAJASTHAN,Urban,13,Primary,89147,76275,165422
16423,8,State - RAJASTHAN,Urban,14,Primary,57589,49025,106614
16424,8,State - RAJASTHAN,Urban,15,Primary,40766,35354,76120
16425,8,State - RAJASTHAN,Urban,16,Primary,28631,27122,55753
16426,8,State - RAJASTHAN,Urban,17,Primary,21578,20354,41932
16427,8,State - RAJASTHAN,Urban,18,Primary,31528,28635,60163
16428,8,State - RAJASTHAN,Urban,19,Primary,19891,19091,38982
16429,8,State - RAJASTHAN,Urban,20-24,Primary,120618,114102,234720
16430,8,State - RAJASTHAN,Urban,25-29,Primary,101167,97352,198519
16431,8,State - RAJASTHAN,Urban,30-34,Primary,84032,83686,167718
16432,8,State - RAJASTHAN,Urban,35-39,Primary,79511,76545,156056
16433,8,State - RAJASTHAN,Urban,40-44,Primary,66768,63173,129941
16434,8,State - RAJASTHAN,Urban,45-49,Primary,58582,55218,113800
16435,8,State - RAJASTHAN,Urban,50-54,Primary,49891,43575,93466
16436,8,State - RAJASTHAN,Urban,55-59,Primary,34205,33575,67780
16437,8,State - RAJASTHAN,Urban,60-64,Primary,29544,27796,57340
16438,8,State - RAJASTHAN,Urban,65-69,Primary,19099,18591,37690
16439,8,State - RAJASTHAN,Urban,70-74,Primary,15287,12083,27370
16440,8,State - RAJASTHAN,Urban,75-79,Primary,7912,6548,14460
16441,8,State - RAJASTHAN,Urban,80+,Primary,9520,6757,16277
16442,8,State - RAJASTHAN,Urban,Age not stated,Primary,3295,3131,6426
16443,9,State - UTTAR PRADESH,Total,All ages,Primary,15505178,12293614,27798792
16444,9,State - UTTAR PRADESH,Total,0-6,Primary,0,0,0
16445,9,State - UTTAR PRADESH,Total,7,Primary,0,0,0
16446,9,State - UTTAR PRADESH,Total,8,Primary,0,0,0
16447,9,State - UTTAR PRADESH,Total,9,Primary,265408,239565,504973
16448,9,State - UTTAR PRADESH,Total,10,Primary,859041,749551,1608592
16449,9,State - UTTAR PRADESH,Total,11,Primary,1181833,1042238,2224071
16450,9,State - UTTAR PRADESH,Total,12,Primary,1594969,1388577,2983546
16451,9,State - UTTAR PRADESH,Total,13,Primary,1160369,1058530,2218899
16452,9,State - UTTAR PRADESH,Total,14,Primary,933156,838606,1771762
16453,9,State - UTTAR PRADESH,Total,15,Primary,695352,592388,1287740
16454,9,State - UTTAR PRADESH,Total,16,Primary,485684,433673,919357
16455,9,State - UTTAR PRADESH,Total,17,Primary,305726,263413,569139
16456,9,State - UTTAR PRADESH,Total,18,Primary,462187,349527,811714
16457,9,State - UTTAR PRADESH,Total,19,Primary,245440,195507,440947
16458,9,State - UTTAR PRADESH,Total,20-24,Primary,1299258,1010654,2309912
16459,9,State - UTTAR PRADESH,Total,25-29,Primary,1006494,823759,1830253
16460,9,State - UTTAR PRADESH,Total,30-34,Primary,861703,720309,1582012
16461,9,State - UTTAR PRADESH,Total,35-39,Primary,842357,635098,1477455
16462,9,State - UTTAR PRADESH,Total,40-44,Primary,699129,479204,1178333
16463,9,State - UTTAR PRADESH,Total,45-49,Primary,574129,385973,960102
16464,9,State - UTTAR PRADESH,Total,50-54,Primary,466731,284005,750736
16465,9,State - UTTAR PRADESH,Total,55-59,Primary,345239,235348,580587
16466,9,State - UTTAR PRADESH,Total,60-64,Primary,418875,203522,622397
16467,9,State - UTTAR PRADESH,Total,65-69,Primary,279289,122519,401808
16468,9,State - UTTAR PRADESH,Total,70-74,Primary,211663,75198,286861
16469,9,State - UTTAR PRADESH,Total,75-79,Primary,87770,35436,123206
16470,9,State - UTTAR PRADESH,Total,80+,Primary,127104,56109,183213
16471,9,State - UTTAR PRADESH,Total,Age not stated,Primary,96272,74905,171177
16472,9,State - UTTAR PRADESH,Rural,All ages,Primary,12594860,9796385,22391245
16473,9,State - UTTAR PRADESH,Rural,0-6,Primary,0,0,0
16474,9,State - UTTAR PRADESH,Rural,7,Primary,0,0,0
16475,9,State - UTTAR PRADESH,Rural,8,Primary,0,0,0
16476,9,State - UTTAR PRADESH,Rural,9,Primary,200560,181096,381656
16477,9,State - UTTAR PRADESH,Rural,10,Primary,677739,591065,1268804
16478,9,State - UTTAR PRADESH,Rural,11,Primary,938327,827866,1766193
16479,9,State - UTTAR PRADESH,Rural,12,Primary,1320582,1152833,2473415
16480,9,State - UTTAR PRADESH,Rural,13,Primary,965071,884695,1849766
16481,9,State - UTTAR PRADESH,Rural,14,Primary,780885,706818,1487703
16482,9,State - UTTAR PRADESH,Rural,15,Primary,584934,500467,1085401
16483,9,State - UTTAR PRADESH,Rural,16,Primary,401120,363497,764617
16484,9,State - UTTAR PRADESH,Rural,17,Primary,244950,216316,461266
16485,9,State - UTTAR PRADESH,Rural,18,Primary,374297,289742,664039
16486,9,State - UTTAR PRADESH,Rural,19,Primary,191852,158234,350086
16487,9,State - UTTAR PRADESH,Rural,20-24,Primary,1026626,819874,1846500
16488,9,State - UTTAR PRADESH,Rural,25-29,Primary,812010,662279,1474289
16489,9,State - UTTAR PRADESH,Rural,30-34,Primary,703327,573224,1276551
16490,9,State - UTTAR PRADESH,Rural,35-39,Primary,685022,487591,1172613
16491,9,State - UTTAR PRADESH,Rural,40-44,Primary,562154,356630,918784
16492,9,State - UTTAR PRADESH,Rural,45-49,Primary,456925,276477,733402
16493,9,State - UTTAR PRADESH,Rural,50-54,Primary,375261,200599,575860
16494,9,State - UTTAR PRADESH,Rural,55-59,Primary,278570,164989,443559
16495,9,State - UTTAR PRADESH,Rural,60-64,Primary,350028,140928,490956
16496,9,State - UTTAR PRADESH,Rural,65-69,Primary,235481,81129,316610
16497,9,State - UTTAR PRADESH,Rural,70-74,Primary,178719,47237,225956
16498,9,State - UTTAR PRADESH,Rural,75-79,Primary,72841,20709,93550
16499,9,State - UTTAR PRADESH,Rural,80+,Primary,103955,36170,140125
16500,9,State - UTTAR PRADESH,Rural,Age not stated,Primary,73624,55920,129544
16501,9,State - UTTAR PRADESH,Urban,All ages,Primary,2910318,2497229,5407547
16502,9,State - UTTAR PRADESH,Urban,0-6,Primary,0,0,0
16503,9,State - UTTAR PRADESH,Urban,7,Primary,0,0,0
16504,9,State - UTTAR PRADESH,Urban,8,Primary,0,0,0
16505,9,State - UTTAR PRADESH,Urban,9,Primary,64848,58469,123317
16506,9,State - UTTAR PRADESH,Urban,10,Primary,181302,158486,339788
16507,9,State - UTTAR PRADESH,Urban,11,Primary,243506,214372,457878
16508,9,State - UTTAR PRADESH,Urban,12,Primary,274387,235744,510131
16509,9,State - UTTAR PRADESH,Urban,13,Primary,195298,173835,369133
16510,9,State - UTTAR PRADESH,Urban,14,Primary,152271,131788,284059
16511,9,State - UTTAR PRADESH,Urban,15,Primary,110418,91921,202339
16512,9,State - UTTAR PRADESH,Urban,16,Primary,84564,70176,154740
16513,9,State - UTTAR PRADESH,Urban,17,Primary,60776,47097,107873
16514,9,State - UTTAR PRADESH,Urban,18,Primary,87890,59785,147675
16515,9,State - UTTAR PRADESH,Urban,19,Primary,53588,37273,90861
16516,9,State - UTTAR PRADESH,Urban,20-24,Primary,272632,190780,463412
16517,9,State - UTTAR PRADESH,Urban,25-29,Primary,194484,161480,355964
16518,9,State - UTTAR PRADESH,Urban,30-34,Primary,158376,147085,305461
16519,9,State - UTTAR PRADESH,Urban,35-39,Primary,157335,147507,304842
16520,9,State - UTTAR PRADESH,Urban,40-44,Primary,136975,122574,259549
16521,9,State - UTTAR PRADESH,Urban,45-49,Primary,117204,109496,226700
16522,9,State - UTTAR PRADESH,Urban,50-54,Primary,91470,83406,174876
16523,9,State - UTTAR PRADESH,Urban,55-59,Primary,66669,70359,137028
16524,9,State - UTTAR PRADESH,Urban,60-64,Primary,68847,62594,131441
16525,9,State - UTTAR PRADESH,Urban,65-69,Primary,43808,41390,85198
16526,9,State - UTTAR PRADESH,Urban,70-74,Primary,32944,27961,60905
16527,9,State - UTTAR PRADESH,Urban,75-79,Primary,14929,14727,29656
16528,9,State - UTTAR PRADESH,Urban,80+,Primary,23149,19939,43088
16529,9,State - UTTAR PRADESH,Urban,Age not stated,Primary,22648,18985,41633
16530,10,State - BIHAR,Total,All ages,Primary,7625383,5529586,13154969
16531,10,State - BIHAR,Total,0-6,Primary,0,0,0
16532,10,State - BIHAR,Total,7,Primary,0,0,0
16533,10,State - BIHAR,Total,8,Primary,0,0,0
16534,10,State - BIHAR,Total,9,Primary,110548,91943,202491
16535,10,State - BIHAR,Total,10,Primary,408707,328271,736978
16536,10,State - BIHAR,Total,11,Primary,523479,431706,955185
16537,10,State - BIHAR,Total,12,Primary,843324,700595,1543919
16538,10,State - BIHAR,Total,13,Primary,543665,478081,1021746
16539,10,State - BIHAR,Total,14,Primary,414489,362225,776714
16540,10,State - BIHAR,Total,15,Primary,314130,241052,555182
16541,10,State - BIHAR,Total,16,Primary,218375,158018,376393
16542,10,State - BIHAR,Total,17,Primary,125811,84113,209924
16543,10,State - BIHAR,Total,18,Primary,215743,125543,341286
16544,10,State - BIHAR,Total,19,Primary,111479,80049,191528
16545,10,State - BIHAR,Total,20-24,Primary,666187,462692,1128879
16546,10,State - BIHAR,Total,25-29,Primary,594359,442169,1036528
16547,10,State - BIHAR,Total,30-34,Primary,511719,374647,886366
16548,10,State - BIHAR,Total,35-39,Primary,444943,299777,744720
16549,10,State - BIHAR,Total,40-44,Primary,345071,214935,560006
16550,10,State - BIHAR,Total,45-49,Primary,278183,174904,453087
16551,10,State - BIHAR,Total,50-54,Primary,229802,128612,358414
16552,10,State - BIHAR,Total,55-59,Primary,167142,110694,277836
16553,10,State - BIHAR,Total,60-64,Primary,202135,100927,303062
16554,10,State - BIHAR,Total,65-69,Primary,143682,59004,202686
16555,10,State - BIHAR,Total,70-74,Primary,99459,31130,130589
16556,10,State - BIHAR,Total,75-79,Primary,40812,13827,54639
16557,10,State - BIHAR,Total,80+,Primary,51275,19264,70539
16558,10,State - BIHAR,Total,Age not stated,Primary,20864,15408,36272
16559,10,State - BIHAR,Rural,All ages,Primary,6878975,4838808,11717783
16560,10,State - BIHAR,Rural,0-6,Primary,0,0,0
16561,10,State - BIHAR,Rural,7,Primary,0,0,0
16562,10,State - BIHAR,Rural,8,Primary,0,0,0
16563,10,State - BIHAR,Rural,9,Primary,95905,78677,174582
16564,10,State - BIHAR,Rural,10,Primary,359754,286231,645985
16565,10,State - BIHAR,Rural,11,Primary,461397,376515,837912
16566,10,State - BIHAR,Rural,12,Primary,758262,624036,1382298
16567,10,State - BIHAR,Rural,13,Primary,489129,426872,916001
16568,10,State - BIHAR,Rural,14,Primary,374343,324940,699283
16569,10,State - BIHAR,Rural,15,Primary,286564,217669,504233
16570,10,State - BIHAR,Rural,16,Primary,198912,142290,341202
16571,10,State - BIHAR,Rural,17,Primary,114268,75504,189772
16572,10,State - BIHAR,Rural,18,Primary,196608,112637,309245
16573,10,State - BIHAR,Rural,19,Primary,101300,72483,173783
16574,10,State - BIHAR,Rural,20-24,Primary,606445,415309,1021754
16575,10,State - BIHAR,Rural,25-29,Primary,544957,393244,938201
16576,10,State - BIHAR,Rural,30-34,Primary,468654,330099,798753
16577,10,State - BIHAR,Rural,35-39,Primary,404830,258409,663239
16578,10,State - BIHAR,Rural,40-44,Primary,310900,181072,491972
16579,10,State - BIHAR,Rural,45-49,Primary,248908,143704,392612
16580,10,State - BIHAR,Rural,50-54,Primary,205308,102992,308300
16581,10,State - BIHAR,Rural,55-59,Primary,149631,88254,237885
16582,10,State - BIHAR,Rural,60-64,Primary,181987,80530,262517
16583,10,State - BIHAR,Rural,65-69,Primary,130278,45877,176155
16584,10,State - BIHAR,Rural,70-74,Primary,89597,23406,113003
16585,10,State - BIHAR,Rural,75-79,Primary,36603,9936,46539
16586,10,State - BIHAR,Rural,80+,Primary,45907,14967,60874
16587,10,State - BIHAR,Rural,Age not stated,Primary,18528,13155,31683
16588,10,State - BIHAR,Urban,All ages,Primary,746408,690778,1437186
16589,10,State - BIHAR,Urban,0-6,Primary,0,0,0
16590,10,State - BIHAR,Urban,7,Primary,0,0,0
16591,10,State - BIHAR,Urban,8,Primary,0,0,0
16592,10,State - BIHAR,Urban,9,Primary,14643,13266,27909
16593,10,State - BIHAR,Urban,10,Primary,48953,42040,90993
16594,10,State - BIHAR,Urban,11,Primary,62082,55191,117273
16595,10,State - BIHAR,Urban,12,Primary,85062,76559,161621
16596,10,State - BIHAR,Urban,13,Primary,54536,51209,105745
16597,10,State - BIHAR,Urban,14,Primary,40146,37285,77431
16598,10,State - BIHAR,Urban,15,Primary,27566,23383,50949
16599,10,State - BIHAR,Urban,16,Primary,19463,15728,35191
16600,10,State - BIHAR,Urban,17,Primary,11543,8609,20152
16601,10,State - BIHAR,Urban,18,Primary,19135,12906,32041
16602,10,State - BIHAR,Urban,19,Primary,10179,7566,17745
16603,10,State - BIHAR,Urban,20-24,Primary,59742,47383,107125
16604,10,State - BIHAR,Urban,25-29,Primary,49402,48925,98327
16605,10,State - BIHAR,Urban,30-34,Primary,43065,44548,87613
16606,10,State - BIHAR,Urban,35-39,Primary,40113,41368,81481
16607,10,State - BIHAR,Urban,40-44,Primary,34171,33863,68034
16608,10,State - BIHAR,Urban,45-49,Primary,29275,31200,60475
16609,10,State - BIHAR,Urban,50-54,Primary,24494,25620,50114
16610,10,State - BIHAR,Urban,55-59,Primary,17511,22440,39951
16611,10,State - BIHAR,Urban,60-64,Primary,20148,20397,40545
16612,10,State - BIHAR,Urban,65-69,Primary,13404,13127,26531
16613,10,State - BIHAR,Urban,70-74,Primary,9862,7724,17586
16614,10,State - BIHAR,Urban,75-79,Primary,4209,3891,8100
16615,10,State - BIHAR,Urban,80+,Primary,5368,4297,9665
16616,10,State - BIHAR,Urban,Age not stated,Primary,2336,2253,4589
16617,11,State - SIKKIM,Total,All ages,Primary,62664,52937,115601
16618,11,State - SIKKIM,Total,0-6,Primary,0,0,0
16619,11,State - SIKKIM,Total,7,Primary,0,0,0
16620,11,State - SIKKIM,Total,8,Primary,0,0,0
16621,11,State - SIKKIM,Total,9,Primary,610,664,1274
16622,11,State - SIKKIM,Total,10,Primary,1766,1882,3648
16623,11,State - SIKKIM,Total,11,Primary,2911,3221,6132
16624,11,State - SIKKIM,Total,12,Primary,3559,3839,7398
16625,11,State - SIKKIM,Total,13,Primary,3490,3745,7235
16626,11,State - SIKKIM,Total,14,Primary,3151,3282,6433
16627,11,State - SIKKIM,Total,15,Primary,2632,2586,5218
16628,11,State - SIKKIM,Total,16,Primary,2114,2097,4211
16629,11,State - SIKKIM,Total,17,Primary,1819,1590,3409
16630,11,State - SIKKIM,Total,18,Primary,1732,1547,3279
16631,11,State - SIKKIM,Total,19,Primary,1478,1384,2862
16632,11,State - SIKKIM,Total,20-24,Primary,7907,7204,15111
16633,11,State - SIKKIM,Total,25-29,Primary,7035,6345,13380
16634,11,State - SIKKIM,Total,30-34,Primary,5570,4638,10208
16635,11,State - SIKKIM,Total,35-39,Primary,4499,3398,7897
16636,11,State - SIKKIM,Total,40-44,Primary,3662,2102,5764
16637,11,State - SIKKIM,Total,45-49,Primary,2660,1294,3954
16638,11,State - SIKKIM,Total,50-54,Primary,2159,781,2940
16639,11,State - SIKKIM,Total,55-59,Primary,1486,450,1936
16640,11,State - SIKKIM,Total,60-64,Primary,954,339,1293
16641,11,State - SIKKIM,Total,65-69,Primary,629,247,876
16642,11,State - SIKKIM,Total,70-74,Primary,385,105,490
16643,11,State - SIKKIM,Total,75-79,Primary,193,45,238
16644,11,State - SIKKIM,Total,80+,Primary,165,60,225
16645,11,State - SIKKIM,Total,Age not stated,Primary,98,92,190
16646,11,State - SIKKIM,Rural,All ages,Primary,48838,41240,90078
16647,11,State - SIKKIM,Rural,0-6,Primary,0,0,0
16648,11,State - SIKKIM,Rural,7,Primary,0,0,0
16649,11,State - SIKKIM,Rural,8,Primary,0,0,0
16650,11,State - SIKKIM,Rural,9,Primary,436,463,899
16651,11,State - SIKKIM,Rural,10,Primary,1264,1351,2615
16652,11,State - SIKKIM,Rural,11,Primary,2042,2379,4421
16653,11,State - SIKKIM,Rural,12,Primary,2652,2890,5542
16654,11,State - SIKKIM,Rural,13,Primary,2714,2985,5699
16655,11,State - SIKKIM,Rural,14,Primary,2523,2741,5264
16656,11,State - SIKKIM,Rural,15,Primary,2185,2176,4361
16657,11,State - SIKKIM,Rural,16,Primary,1765,1739,3504
16658,11,State - SIKKIM,Rural,17,Primary,1504,1339,2843
16659,11,State - SIKKIM,Rural,18,Primary,1423,1290,2713
16660,11,State - SIKKIM,Rural,19,Primary,1184,1148,2332
16661,11,State - SIKKIM,Rural,20-24,Primary,6357,5983,12340
16662,11,State - SIKKIM,Rural,25-29,Primary,5613,5089,10702
16663,11,State - SIKKIM,Rural,30-34,Primary,4416,3599,8015
16664,11,State - SIKKIM,Rural,35-39,Primary,3500,2559,6059
16665,11,State - SIKKIM,Rural,40-44,Primary,2854,1442,4296
16666,11,State - SIKKIM,Rural,45-49,Primary,1954,830,2784
16667,11,State - SIKKIM,Rural,50-54,Primary,1584,457,2041
16668,11,State - SIKKIM,Rural,55-59,Primary,1060,247,1307
16669,11,State - SIKKIM,Rural,60-64,Primary,709,203,912
16670,11,State - SIKKIM,Rural,65-69,Primary,472,138,610
16671,11,State - SIKKIM,Rural,70-74,Primary,281,51,332
16672,11,State - SIKKIM,Rural,75-79,Primary,142,17,159
16673,11,State - SIKKIM,Rural,80+,Primary,123,40,163
16674,11,State - SIKKIM,Rural,Age not stated,Primary,81,84,165
16675,11,State - SIKKIM,Urban,All ages,Primary,13826,11697,25523
16676,11,State - SIKKIM,Urban,0-6,Primary,0,0,0
16677,11,State - SIKKIM,Urban,7,Primary,0,0,0
16678,11,State - SIKKIM,Urban,8,Primary,0,0,0
16679,11,State - SIKKIM,Urban,9,Primary,174,201,375
16680,11,State - SIKKIM,Urban,10,Primary,502,531,1033
16681,11,State - SIKKIM,Urban,11,Primary,869,842,1711
16682,11,State - SIKKIM,Urban,12,Primary,907,949,1856
16683,11,State - SIKKIM,Urban,13,Primary,776,760,1536
16684,11,State - SIKKIM,Urban,14,Primary,628,541,1169
16685,11,State - SIKKIM,Urban,15,Primary,447,410,857
16686,11,State - SIKKIM,Urban,16,Primary,349,358,707
16687,11,State - SIKKIM,Urban,17,Primary,315,251,566
16688,11,State - SIKKIM,Urban,18,Primary,309,257,566
16689,11,State - SIKKIM,Urban,19,Primary,294,236,530
16690,11,State - SIKKIM,Urban,20-24,Primary,1550,1221,2771
16691,11,State - SIKKIM,Urban,25-29,Primary,1422,1256,2678
16692,11,State - SIKKIM,Urban,30-34,Primary,1154,1039,2193
16693,11,State - SIKKIM,Urban,35-39,Primary,999,839,1838
16694,11,State - SIKKIM,Urban,40-44,Primary,808,660,1468
16695,11,State - SIKKIM,Urban,45-49,Primary,706,464,1170
16696,11,State - SIKKIM,Urban,50-54,Primary,575,324,899
16697,11,State - SIKKIM,Urban,55-59,Primary,426,203,629
16698,11,State - SIKKIM,Urban,60-64,Primary,245,136,381
16699,11,State - SIKKIM,Urban,65-69,Primary,157,109,266
16700,11,State - SIKKIM,Urban,70-74,Primary,104,54,158
16701,11,State - SIKKIM,Urban,75-79,Primary,51,28,79
16702,11,State - SIKKIM,Urban,80+,Primary,42,20,62
16703,11,State - SIKKIM,Urban,Age not stated,Primary,17,8,25
16704,12,State - ARUNACHAL PRADESH,Total,All ages,Primary,102518,86851,189369
16705,12,State - ARUNACHAL PRADESH,Total,0-6,Primary,0,0,0
16706,12,State - ARUNACHAL PRADESH,Total,7,Primary,0,0,0
16707,12,State - ARUNACHAL PRADESH,Total,8,Primary,0,0,0
16708,12,State - ARUNACHAL PRADESH,Total,9,Primary,1620,1510,3130
16709,12,State - ARUNACHAL PRADESH,Total,10,Primary,4217,3828,8045
16710,12,State - ARUNACHAL PRADESH,Total,11,Primary,6965,6426,13391
16711,12,State - ARUNACHAL PRADESH,Total,12,Primary,9256,9054,18310
16712,12,State - ARUNACHAL PRADESH,Total,13,Primary,8118,8036,16154
16713,12,State - ARUNACHAL PRADESH,Total,14,Primary,7131,6752,13883
16714,12,State - ARUNACHAL PRADESH,Total,15,Primary,5568,5134,10702
16715,12,State - ARUNACHAL PRADESH,Total,16,Primary,3926,3679,7605
16716,12,State - ARUNACHAL PRADESH,Total,17,Primary,2660,2400,5060
16717,12,State - ARUNACHAL PRADESH,Total,18,Primary,2989,2669,5658
16718,12,State - ARUNACHAL PRADESH,Total,19,Primary,1946,1757,3703
16719,12,State - ARUNACHAL PRADESH,Total,20-24,Primary,8618,8676,17294
16720,12,State - ARUNACHAL PRADESH,Total,25-29,Primary,8223,7961,16184
16721,12,State - ARUNACHAL PRADESH,Total,30-34,Primary,6960,6188,13148
16722,12,State - ARUNACHAL PRADESH,Total,35-39,Primary,6451,5222,11673
16723,12,State - ARUNACHAL PRADESH,Total,40-44,Primary,5508,3302,8810
16724,12,State - ARUNACHAL PRADESH,Total,45-49,Primary,4525,2059,6584
16725,12,State - ARUNACHAL PRADESH,Total,50-54,Primary,3143,910,4053
16726,12,State - ARUNACHAL PRADESH,Total,55-59,Primary,1881,443,2324
16727,12,State - ARUNACHAL PRADESH,Total,60-64,Primary,1285,305,1590
16728,12,State - ARUNACHAL PRADESH,Total,65-69,Primary,635,181,816
16729,12,State - ARUNACHAL PRADESH,Total,70-74,Primary,382,84,466
16730,12,State - ARUNACHAL PRADESH,Total,75-79,Primary,167,42,209
16731,12,State - ARUNACHAL PRADESH,Total,80+,Primary,256,170,426
16732,12,State - ARUNACHAL PRADESH,Total,Age not stated,Primary,88,63,151
16733,12,State - ARUNACHAL PRADESH,Rural,All ages,Primary,79508,65486,144994
16734,12,State - ARUNACHAL PRADESH,Rural,0-6,Primary,0,0,0
16735,12,State - ARUNACHAL PRADESH,Rural,7,Primary,0,0,0
16736,12,State - ARUNACHAL PRADESH,Rural,8,Primary,0,0,0
16737,12,State - ARUNACHAL PRADESH,Rural,9,Primary,1235,1134,2369
16738,12,State - ARUNACHAL PRADESH,Rural,10,Primary,3156,2825,5981
16739,12,State - ARUNACHAL PRADESH,Rural,11,Primary,5100,4596,9696
16740,12,State - ARUNACHAL PRADESH,Rural,12,Primary,6881,6731,13612
16741,12,State - ARUNACHAL PRADESH,Rural,13,Primary,6093,5939,12032
16742,12,State - ARUNACHAL PRADESH,Rural,14,Primary,5634,5227,10861
16743,12,State - ARUNACHAL PRADESH,Rural,15,Primary,4517,4140,8657
16744,12,State - ARUNACHAL PRADESH,Rural,16,Primary,3259,3012,6271
16745,12,State - ARUNACHAL PRADESH,Rural,17,Primary,2210,1959,4169
16746,12,State - ARUNACHAL PRADESH,Rural,18,Primary,2473,2239,4712
16747,12,State - ARUNACHAL PRADESH,Rural,19,Primary,1601,1444,3045
16748,12,State - ARUNACHAL PRADESH,Rural,20-24,Primary,7026,6921,13947
16749,12,State - ARUNACHAL PRADESH,Rural,25-29,Primary,6554,6113,12667
16750,12,State - ARUNACHAL PRADESH,Rural,30-34,Primary,5555,4631,10186
16751,12,State - ARUNACHAL PRADESH,Rural,35-39,Primary,4959,3685,8644
16752,12,State - ARUNACHAL PRADESH,Rural,40-44,Primary,4089,2200,6289
16753,12,State - ARUNACHAL PRADESH,Rural,45-49,Primary,3281,1278,4559
16754,12,State - ARUNACHAL PRADESH,Rural,50-54,Primary,2262,542,2804
16755,12,State - ARUNACHAL PRADESH,Rural,55-59,Primary,1377,299,1676
16756,12,State - ARUNACHAL PRADESH,Rural,60-64,Primary,1023,209,1232
16757,12,State - ARUNACHAL PRADESH,Rural,65-69,Primary,503,122,625
16758,12,State - ARUNACHAL PRADESH,Rural,70-74,Primary,315,59,374
16759,12,State - ARUNACHAL PRADESH,Rural,75-79,Primary,129,22,151
16760,12,State - ARUNACHAL PRADESH,Rural,80+,Primary,206,113,319
16761,12,State - ARUNACHAL PRADESH,Rural,Age not stated,Primary,70,46,116
16762,12,State - ARUNACHAL PRADESH,Urban,All ages,Primary,23010,21365,44375
16763,12,State - ARUNACHAL PRADESH,Urban,0-6,Primary,0,0,0
16764,12,State - ARUNACHAL PRADESH,Urban,7,Primary,0,0,0
16765,12,State - ARUNACHAL PRADESH,Urban,8,Primary,0,0,0
16766,12,State - ARUNACHAL PRADESH,Urban,9,Primary,385,376,761
16767,12,State - ARUNACHAL PRADESH,Urban,10,Primary,1061,1003,2064
16768,12,State - ARUNACHAL PRADESH,Urban,11,Primary,1865,1830,3695
16769,12,State - ARUNACHAL PRADESH,Urban,12,Primary,2375,2323,4698
16770,12,State - ARUNACHAL PRADESH,Urban,13,Primary,2025,2097,4122
16771,12,State - ARUNACHAL PRADESH,Urban,14,Primary,1497,1525,3022
16772,12,State - ARUNACHAL PRADESH,Urban,15,Primary,1051,994,2045
16773,12,State - ARUNACHAL PRADESH,Urban,16,Primary,667,667,1334
16774,12,State - ARUNACHAL PRADESH,Urban,17,Primary,450,441,891
16775,12,State - ARUNACHAL PRADESH,Urban,18,Primary,516,430,946
16776,12,State - ARUNACHAL PRADESH,Urban,19,Primary,345,313,658
16777,12,State - ARUNACHAL PRADESH,Urban,20-24,Primary,1592,1755,3347
16778,12,State - ARUNACHAL PRADESH,Urban,25-29,Primary,1669,1848,3517
16779,12,State - ARUNACHAL PRADESH,Urban,30-34,Primary,1405,1557,2962
16780,12,State - ARUNACHAL PRADESH,Urban,35-39,Primary,1492,1537,3029
16781,12,State - ARUNACHAL PRADESH,Urban,40-44,Primary,1419,1102,2521
16782,12,State - ARUNACHAL PRADESH,Urban,45-49,Primary,1244,781,2025
16783,12,State - ARUNACHAL PRADESH,Urban,50-54,Primary,881,368,1249
16784,12,State - ARUNACHAL PRADESH,Urban,55-59,Primary,504,144,648
16785,12,State - ARUNACHAL PRADESH,Urban,60-64,Primary,262,96,358
16786,12,State - ARUNACHAL PRADESH,Urban,65-69,Primary,132,59,191
16787,12,State - ARUNACHAL PRADESH,Urban,70-74,Primary,67,25,92
16788,12,State - ARUNACHAL PRADESH,Urban,75-79,Primary,38,20,58
16789,12,State - ARUNACHAL PRADESH,Urban,80+,Primary,50,57,107
16790,12,State - ARUNACHAL PRADESH,Urban,Age not stated,Primary,18,17,35
16791,13,State - NAGALAND,Total,All ages,Primary,170554,159804,330358
16792,13,State - NAGALAND,Total,0-6,Primary,0,0,0
16793,13,State - NAGALAND,Total,7,Primary,0,0,0
16794,13,State - NAGALAND,Total,8,Primary,0,0,0
16795,13,State - NAGALAND,Total,9,Primary,1898,1884,3782
16796,13,State - NAGALAND,Total,10,Primary,6346,6198,12544
16797,13,State - NAGALAND,Total,11,Primary,12011,11637,23648
16798,13,State - NAGALAND,Total,12,Primary,15089,14196,29285
16799,13,State - NAGALAND,Total,13,Primary,13437,12028,25465
16800,13,State - NAGALAND,Total,14,Primary,9472,8425,17897
16801,13,State - NAGALAND,Total,15,Primary,7169,6346,13515
16802,13,State - NAGALAND,Total,16,Primary,5207,4926,10133
16803,13,State - NAGALAND,Total,17,Primary,3991,3688,7679
16804,13,State - NAGALAND,Total,18,Primary,4099,3949,8048
16805,13,State - NAGALAND,Total,19,Primary,3208,2956,6164
16806,13,State - NAGALAND,Total,20-24,Primary,15462,15572,31034
16807,13,State - NAGALAND,Total,25-29,Primary,13352,14733,28085
16808,13,State - NAGALAND,Total,30-34,Primary,11845,12935,24780
16809,13,State - NAGALAND,Total,35-39,Primary,10506,11710,22216
16810,13,State - NAGALAND,Total,40-44,Primary,9714,9357,19071
16811,13,State - NAGALAND,Total,45-49,Primary,8285,6935,15220
16812,13,State - NAGALAND,Total,50-54,Primary,6379,4783,11162
16813,13,State - NAGALAND,Total,55-59,Primary,4342,2825,7167
16814,13,State - NAGALAND,Total,60-64,Primary,3610,2256,5866
16815,13,State - NAGALAND,Total,65-69,Primary,2254,1226,3480
16816,13,State - NAGALAND,Total,70-74,Primary,1283,559,1842
16817,13,State - NAGALAND,Total,75-79,Primary,699,291,990
16818,13,State - NAGALAND,Total,80+,Primary,810,333,1143
16819,13,State - NAGALAND,Total,Age not stated,Primary,86,56,142
16820,13,State - NAGALAND,Rural,All ages,Primary,126574,119225,245799
16821,13,State - NAGALAND,Rural,0-6,Primary,0,0,0
16822,13,State - NAGALAND,Rural,7,Primary,0,0,0
16823,13,State - NAGALAND,Rural,8,Primary,0,0,0
16824,13,State - NAGALAND,Rural,9,Primary,1259,1263,2522
16825,13,State - NAGALAND,Rural,10,Primary,4229,3975,8204
16826,13,State - NAGALAND,Rural,11,Primary,7915,7490,15405
16827,13,State - NAGALAND,Rural,12,Primary,10476,9803,20279
16828,13,State - NAGALAND,Rural,13,Primary,9557,8584,18141
16829,13,State - NAGALAND,Rural,14,Primary,7105,6418,13523
16830,13,State - NAGALAND,Rural,15,Primary,5704,5064,10768
16831,13,State - NAGALAND,Rural,16,Primary,4108,3941,8049
16832,13,State - NAGALAND,Rural,17,Primary,3167,2958,6125
16833,13,State - NAGALAND,Rural,18,Primary,3224,3253,6477
16834,13,State - NAGALAND,Rural,19,Primary,2479,2357,4836
16835,13,State - NAGALAND,Rural,20-24,Primary,11964,12541,24505
16836,13,State - NAGALAND,Rural,25-29,Primary,10153,11532,21685
16837,13,State - NAGALAND,Rural,30-34,Primary,9131,10124,19255
16838,13,State - NAGALAND,Rural,35-39,Primary,8072,8973,17045
16839,13,State - NAGALAND,Rural,40-44,Primary,7433,7100,14533
16840,13,State - NAGALAND,Rural,45-49,Primary,6105,5120,11225
16841,13,State - NAGALAND,Rural,50-54,Primary,4683,3485,8168
16842,13,State - NAGALAND,Rural,55-59,Primary,3131,1983,5114
16843,13,State - NAGALAND,Rural,60-64,Primary,2700,1607,4307
16844,13,State - NAGALAND,Rural,65-69,Primary,1721,822,2543
16845,13,State - NAGALAND,Rural,70-74,Primary,1003,367,1370
16846,13,State - NAGALAND,Rural,75-79,Primary,552,190,742
16847,13,State - NAGALAND,Rural,80+,Primary,625,225,850
16848,13,State - NAGALAND,Rural,Age not stated,Primary,78,50,128
16849,13,State - NAGALAND,Urban,All ages,Primary,43980,40579,84559
16850,13,State - NAGALAND,Urban,0-6,Primary,0,0,0
16851,13,State - NAGALAND,Urban,7,Primary,0,0,0
16852,13,State - NAGALAND,Urban,8,Primary,0,0,0
16853,13,State - NAGALAND,Urban,9,Primary,639,621,1260
16854,13,State - NAGALAND,Urban,10,Primary,2117,2223,4340
16855,13,State - NAGALAND,Urban,11,Primary,4096,4147,8243
16856,13,State - NAGALAND,Urban,12,Primary,4613,4393,9006
16857,13,State - NAGALAND,Urban,13,Primary,3880,3444,7324
16858,13,State - NAGALAND,Urban,14,Primary,2367,2007,4374
16859,13,State - NAGALAND,Urban,15,Primary,1465,1282,2747
16860,13,State - NAGALAND,Urban,16,Primary,1099,985,2084
16861,13,State - NAGALAND,Urban,17,Primary,824,730,1554
16862,13,State - NAGALAND,Urban,18,Primary,875,696,1571
16863,13,State - NAGALAND,Urban,19,Primary,729,599,1328
16864,13,State - NAGALAND,Urban,20-24,Primary,3498,3031,6529
16865,13,State - NAGALAND,Urban,25-29,Primary,3199,3201,6400
16866,13,State - NAGALAND,Urban,30-34,Primary,2714,2811,5525
16867,13,State - NAGALAND,Urban,35-39,Primary,2434,2737,5171
16868,13,State - NAGALAND,Urban,40-44,Primary,2281,2257,4538
16869,13,State - NAGALAND,Urban,45-49,Primary,2180,1815,3995
16870,13,State - NAGALAND,Urban,50-54,Primary,1696,1298,2994
16871,13,State - NAGALAND,Urban,55-59,Primary,1211,842,2053
16872,13,State - NAGALAND,Urban,60-64,Primary,910,649,1559
16873,13,State - NAGALAND,Urban,65-69,Primary,533,404,937
16874,13,State - NAGALAND,Urban,70-74,Primary,280,192,472
16875,13,State - NAGALAND,Urban,75-79,Primary,147,101,248
16876,13,State - NAGALAND,Urban,80+,Primary,185,108,293
16877,13,State - NAGALAND,Urban,Age not stated,Primary,8,6,14
16878,14,State - MANIPUR,Total,All ages,Primary,164889,162064,326953
16879,14,State - MANIPUR,Total,0-6,Primary,0,0,0
16880,14,State - MANIPUR,Total,7,Primary,0,0,0
16881,14,State - MANIPUR,Total,8,Primary,0,0,0
16882,14,State - MANIPUR,Total,9,Primary,4485,4188,8673
16883,14,State - MANIPUR,Total,10,Primary,11193,10307,21500
16884,14,State - MANIPUR,Total,11,Primary,16527,15345,31872
16885,14,State - MANIPUR,Total,12,Primary,18516,17326,35842
16886,14,State - MANIPUR,Total,13,Primary,14821,13984,28805
16887,14,State - MANIPUR,Total,14,Primary,9843,9379,19222
16888,14,State - MANIPUR,Total,15,Primary,6795,6292,13087
16889,14,State - MANIPUR,Total,16,Primary,4243,4200,8443
16890,14,State - MANIPUR,Total,17,Primary,2945,3010,5955
16891,14,State - MANIPUR,Total,18,Primary,3230,3318,6548
16892,14,State - MANIPUR,Total,19,Primary,2140,2380,4520
16893,14,State - MANIPUR,Total,20-24,Primary,10679,12903,23582
16894,14,State - MANIPUR,Total,25-29,Primary,9482,11719,21201
16895,14,State - MANIPUR,Total,30-34,Primary,8047,10012,18059
16896,14,State - MANIPUR,Total,35-39,Primary,7564,8969,16533
16897,14,State - MANIPUR,Total,40-44,Primary,6687,7730,14417
16898,14,State - MANIPUR,Total,45-49,Primary,6321,6633,12954
16899,14,State - MANIPUR,Total,50-54,Primary,5492,5152,10644
16900,14,State - MANIPUR,Total,55-59,Primary,4471,3694,8165
16901,14,State - MANIPUR,Total,60-64,Primary,4050,2501,6551
16902,14,State - MANIPUR,Total,65-69,Primary,2517,1270,3787
16903,14,State - MANIPUR,Total,70-74,Primary,1872,691,2563
16904,14,State - MANIPUR,Total,75-79,Primary,1294,371,1665
16905,14,State - MANIPUR,Total,80+,Primary,1378,388,1766
16906,14,State - MANIPUR,Total,Age not stated,Primary,297,302,599
16907,14,State - MANIPUR,Rural,All ages,Primary,127663,122482,250145
16908,14,State - MANIPUR,Rural,0-6,Primary,0,0,0
16909,14,State - MANIPUR,Rural,7,Primary,0,0,0
16910,14,State - MANIPUR,Rural,8,Primary,0,0,0
16911,14,State - MANIPUR,Rural,9,Primary,3330,3047,6377
16912,14,State - MANIPUR,Rural,10,Primary,7980,7286,15266
16913,14,State - MANIPUR,Rural,11,Primary,11493,10551,22044
16914,14,State - MANIPUR,Rural,12,Primary,13206,12108,25314
16915,14,State - MANIPUR,Rural,13,Primary,10872,9981,20853
16916,14,State - MANIPUR,Rural,14,Primary,7573,7128,14701
16917,14,State - MANIPUR,Rural,15,Primary,5573,5084,10657
16918,14,State - MANIPUR,Rural,16,Primary,3540,3524,7064
16919,14,State - MANIPUR,Rural,17,Primary,2452,2491,4943
16920,14,State - MANIPUR,Rural,18,Primary,2744,2777,5521
16921,14,State - MANIPUR,Rural,19,Primary,1822,1983,3805
16922,14,State - MANIPUR,Rural,20-24,Primary,8959,10736,19695
16923,14,State - MANIPUR,Rural,25-29,Primary,7930,9688,17618
16924,14,State - MANIPUR,Rural,30-34,Primary,6785,8119,14904
16925,14,State - MANIPUR,Rural,35-39,Primary,6376,7164,13540
16926,14,State - MANIPUR,Rural,40-44,Primary,5586,6053,11639
16927,14,State - MANIPUR,Rural,45-49,Primary,5172,5118,10290
16928,14,State - MANIPUR,Rural,50-54,Primary,4434,3705,8139
16929,14,State - MANIPUR,Rural,55-59,Primary,3535,2476,6011
16930,14,State - MANIPUR,Rural,60-64,Primary,3121,1638,4759
16931,14,State - MANIPUR,Rural,65-69,Primary,1860,789,2649
16932,14,State - MANIPUR,Rural,70-74,Primary,1356,386,1742
16933,14,State - MANIPUR,Rural,75-79,Primary,855,192,1047
16934,14,State - MANIPUR,Rural,80+,Primary,862,229,1091
16935,14,State - MANIPUR,Rural,Age not stated,Primary,247,229,476
16936,14,State - MANIPUR,Urban,All ages,Primary,37226,39582,76808
16937,14,State - MANIPUR,Urban,0-6,Primary,0,0,0
16938,14,State - MANIPUR,Urban,7,Primary,0,0,0
16939,14,State - MANIPUR,Urban,8,Primary,0,0,0
16940,14,State - MANIPUR,Urban,9,Primary,1155,1141,2296
16941,14,State - MANIPUR,Urban,10,Primary,3213,3021,6234
16942,14,State - MANIPUR,Urban,11,Primary,5034,4794,9828
16943,14,State - MANIPUR,Urban,12,Primary,5310,5218,10528
16944,14,State - MANIPUR,Urban,13,Primary,3949,4003,7952
16945,14,State - MANIPUR,Urban,14,Primary,2270,2251,4521
16946,14,State - MANIPUR,Urban,15,Primary,1222,1208,2430
16947,14,State - MANIPUR,Urban,16,Primary,703,676,1379
16948,14,State - MANIPUR,Urban,17,Primary,493,519,1012
16949,14,State - MANIPUR,Urban,18,Primary,486,541,1027
16950,14,State - MANIPUR,Urban,19,Primary,318,397,715
16951,14,State - MANIPUR,Urban,20-24,Primary,1720,2167,3887
16952,14,State - MANIPUR,Urban,25-29,Primary,1552,2031,3583
16953,14,State - MANIPUR,Urban,30-34,Primary,1262,1893,3155
16954,14,State - MANIPUR,Urban,35-39,Primary,1188,1805,2993
16955,14,State - MANIPUR,Urban,40-44,Primary,1101,1677,2778
16956,14,State - MANIPUR,Urban,45-49,Primary,1149,1515,2664
16957,14,State - MANIPUR,Urban,50-54,Primary,1058,1447,2505
16958,14,State - MANIPUR,Urban,55-59,Primary,936,1218,2154
16959,14,State - MANIPUR,Urban,60-64,Primary,929,863,1792
16960,14,State - MANIPUR,Urban,65-69,Primary,657,481,1138
16961,14,State - MANIPUR,Urban,70-74,Primary,516,305,821
16962,14,State - MANIPUR,Urban,75-79,Primary,439,179,618
16963,14,State - MANIPUR,Urban,80+,Primary,516,159,675
16964,14,State - MANIPUR,Urban,Age not stated,Primary,50,73,123
16965,15,State - MIZORAM,Total,All ages,Primary,108434,99016,207450
16966,15,State - MIZORAM,Total,0-6,Primary,0,0,0
16967,15,State - MIZORAM,Total,7,Primary,0,0,0
16968,15,State - MIZORAM,Total,8,Primary,0,0,0
16969,15,State - MIZORAM,Total,9,Primary,1166,1362,2528
16970,15,State - MIZORAM,Total,10,Primary,3857,4359,8216
16971,15,State - MIZORAM,Total,11,Primary,7057,7261,14318
16972,15,State - MIZORAM,Total,12,Primary,7732,7313,15045
16973,15,State - MIZORAM,Total,13,Primary,6523,5638,12161
16974,15,State - MIZORAM,Total,14,Primary,4479,3489,7968
16975,15,State - MIZORAM,Total,15,Primary,2922,2152,5074
16976,15,State - MIZORAM,Total,16,Primary,2270,1758,4028
16977,15,State - MIZORAM,Total,17,Primary,2065,1578,3643
16978,15,State - MIZORAM,Total,18,Primary,2030,1748,3778
16979,15,State - MIZORAM,Total,19,Primary,1960,1675,3635
16980,15,State - MIZORAM,Total,20-24,Primary,11057,9805,20862
16981,15,State - MIZORAM,Total,25-29,Primary,11121,9954,21075
16982,15,State - MIZORAM,Total,30-34,Primary,9654,9446,19100
16983,15,State - MIZORAM,Total,35-39,Primary,7889,7999,15888
16984,15,State - MIZORAM,Total,40-44,Primary,5874,6215,12089
16985,15,State - MIZORAM,Total,45-49,Primary,5451,5813,11264
16986,15,State - MIZORAM,Total,50-54,Primary,4513,4243,8756
16987,15,State - MIZORAM,Total,55-59,Primary,3497,2835,6332
16988,15,State - MIZORAM,Total,60-64,Primary,3015,2229,5244
16989,15,State - MIZORAM,Total,65-69,Primary,1614,982,2596
16990,15,State - MIZORAM,Total,70-74,Primary,1248,576,1824
16991,15,State - MIZORAM,Total,75-79,Primary,753,293,1046
16992,15,State - MIZORAM,Total,80+,Primary,628,258,886
16993,15,State - MIZORAM,Total,Age not stated,Primary,59,35,94
16994,15,State - MIZORAM,Rural,All ages,Primary,58312,48894,107206
16995,15,State - MIZORAM,Rural,0-6,Primary,0,0,0
16996,15,State - MIZORAM,Rural,7,Primary,0,0,0
16997,15,State - MIZORAM,Rural,8,Primary,0,0,0
16998,15,State - MIZORAM,Rural,9,Primary,560,668,1228
16999,15,State - MIZORAM,Rural,10,Primary,1690,1839,3529
17000,15,State - MIZORAM,Rural,11,Primary,2896,2861,5757
17001,15,State - MIZORAM,Rural,12,Primary,3337,3125,6462
17002,15,State - MIZORAM,Rural,13,Primary,3195,2742,5937
17003,15,State - MIZORAM,Rural,14,Primary,2570,2000,4570
17004,15,State - MIZORAM,Rural,15,Primary,1865,1331,3196
17005,15,State - MIZORAM,Rural,16,Primary,1478,1096,2574
17006,15,State - MIZORAM,Rural,17,Primary,1335,968,2303
17007,15,State - MIZORAM,Rural,18,Primary,1232,1030,2262
17008,15,State - MIZORAM,Rural,19,Primary,1183,1030,2213
17009,15,State - MIZORAM,Rural,20-24,Primary,6730,5939,12669
17010,15,State - MIZORAM,Rural,25-29,Primary,6665,5751,12416
17011,15,State - MIZORAM,Rural,30-34,Primary,5765,5197,10962
17012,15,State - MIZORAM,Rural,35-39,Primary,4584,4091,8675
17013,15,State - MIZORAM,Rural,40-44,Primary,3142,2844,5986
17014,15,State - MIZORAM,Rural,45-49,Primary,2876,2467,5343
17015,15,State - MIZORAM,Rural,50-54,Primary,2224,1582,3806
17016,15,State - MIZORAM,Rural,55-59,Primary,1673,985,2658
17017,15,State - MIZORAM,Rural,60-64,Primary,1458,764,2222
17018,15,State - MIZORAM,Rural,65-69,Primary,772,286,1058
17019,15,State - MIZORAM,Rural,70-74,Primary,508,142,650
17020,15,State - MIZORAM,Rural,75-79,Primary,301,75,376
17021,15,State - MIZORAM,Rural,80+,Primary,245,63,308
17022,15,State - MIZORAM,Rural,Age not stated,Primary,28,18,46
17023,15,State - MIZORAM,Urban,All ages,Primary,50122,50122,100244
17024,15,State - MIZORAM,Urban,0-6,Primary,0,0,0
17025,15,State - MIZORAM,Urban,7,Primary,0,0,0
17026,15,State - MIZORAM,Urban,8,Primary,0,0,0
17027,15,State - MIZORAM,Urban,9,Primary,606,694,1300
17028,15,State - MIZORAM,Urban,10,Primary,2167,2520,4687
17029,15,State - MIZORAM,Urban,11,Primary,4161,4400,8561
17030,15,State - MIZORAM,Urban,12,Primary,4395,4188,8583
17031,15,State - MIZORAM,Urban,13,Primary,3328,2896,6224
17032,15,State - MIZORAM,Urban,14,Primary,1909,1489,3398
17033,15,State - MIZORAM,Urban,15,Primary,1057,821,1878
17034,15,State - MIZORAM,Urban,16,Primary,792,662,1454
17035,15,State - MIZORAM,Urban,17,Primary,730,610,1340
17036,15,State - MIZORAM,Urban,18,Primary,798,718,1516
17037,15,State - MIZORAM,Urban,19,Primary,777,645,1422
17038,15,State - MIZORAM,Urban,20-24,Primary,4327,3866,8193
17039,15,State - MIZORAM,Urban,25-29,Primary,4456,4203,8659
17040,15,State - MIZORAM,Urban,30-34,Primary,3889,4249,8138
17041,15,State - MIZORAM,Urban,35-39,Primary,3305,3908,7213
17042,15,State - MIZORAM,Urban,40-44,Primary,2732,3371,6103
17043,15,State - MIZORAM,Urban,45-49,Primary,2575,3346,5921
17044,15,State - MIZORAM,Urban,50-54,Primary,2289,2661,4950
17045,15,State - MIZORAM,Urban,55-59,Primary,1824,1850,3674
17046,15,State - MIZORAM,Urban,60-64,Primary,1557,1465,3022
17047,15,State - MIZORAM,Urban,65-69,Primary,842,696,1538
17048,15,State - MIZORAM,Urban,70-74,Primary,740,434,1174
17049,15,State - MIZORAM,Urban,75-79,Primary,452,218,670
17050,15,State - MIZORAM,Urban,80+,Primary,383,195,578
17051,15,State - MIZORAM,Urban,Age not stated,Primary,31,17,48
17052,16,State - TRIPURA,Total,All ages,Primary,363404,335252,698656
17053,16,State - TRIPURA,Total,0-6,Primary,0,0,0
17054,16,State - TRIPURA,Total,7,Primary,0,0,0
17055,16,State - TRIPURA,Total,8,Primary,0,0,0
17056,16,State - TRIPURA,Total,9,Primary,1697,1743,3440
17057,16,State - TRIPURA,Total,10,Primary,7917,7771,15688
17058,16,State - TRIPURA,Total,11,Primary,20952,20364,41316
17059,16,State - TRIPURA,Total,12,Primary,28463,27000,55463
17060,16,State - TRIPURA,Total,13,Primary,25188,23812,49000
17061,16,State - TRIPURA,Total,14,Primary,16363,14928,31291
17062,16,State - TRIPURA,Total,15,Primary,10594,8954,19548
17063,16,State - TRIPURA,Total,16,Primary,8073,6709,14782
17064,16,State - TRIPURA,Total,17,Primary,7061,5639,12700
17065,16,State - TRIPURA,Total,18,Primary,7722,7731,15453
17066,16,State - TRIPURA,Total,19,Primary,6539,7338,13877
17067,16,State - TRIPURA,Total,20-24,Primary,38114,40657,78771
17068,16,State - TRIPURA,Total,25-29,Primary,36333,37410,73743
17069,16,State - TRIPURA,Total,30-34,Primary,28944,28505,57449
17070,16,State - TRIPURA,Total,35-39,Primary,26997,26554,53551
17071,16,State - TRIPURA,Total,40-44,Primary,21532,19798,41330
17072,16,State - TRIPURA,Total,45-49,Primary,18750,15781,34531
17073,16,State - TRIPURA,Total,50-54,Primary,15575,11402,26977
17074,16,State - TRIPURA,Total,55-59,Primary,10736,7456,18192
17075,16,State - TRIPURA,Total,60-64,Primary,8918,5601,14519
17076,16,State - TRIPURA,Total,65-69,Primary,6653,3974,10627
17077,16,State - TRIPURA,Total,70-74,Primary,4648,2644,7292
17078,16,State - TRIPURA,Total,75-79,Primary,2582,1571,4153
17079,16,State - TRIPURA,Total,80+,Primary,2949,1815,4764
17080,16,State - TRIPURA,Total,Age not stated,Primary,104,95,199
17081,16,State - TRIPURA,Rural,All ages,Primary,283731,250628,534359
17082,16,State - TRIPURA,Rural,0-6,Primary,0,0,0
17083,16,State - TRIPURA,Rural,7,Primary,0,0,0
17084,16,State - TRIPURA,Rural,8,Primary,0,0,0
17085,16,State - TRIPURA,Rural,9,Primary,1421,1429,2850
17086,16,State - TRIPURA,Rural,10,Primary,6164,5937,12101
17087,16,State - TRIPURA,Rural,11,Primary,15616,15059,30675
17088,16,State - TRIPURA,Rural,12,Primary,22113,20845,42958
17089,16,State - TRIPURA,Rural,13,Primary,19978,18586,38564
17090,16,State - TRIPURA,Rural,14,Primary,13429,12295,25724
17091,16,State - TRIPURA,Rural,15,Primary,8855,7510,16365
17092,16,State - TRIPURA,Rural,16,Primary,6686,5540,12226
17093,16,State - TRIPURA,Rural,17,Primary,5798,4553,10351
17094,16,State - TRIPURA,Rural,18,Primary,6253,6348,12601
17095,16,State - TRIPURA,Rural,19,Primary,5185,5923,11108
17096,16,State - TRIPURA,Rural,20-24,Primary,30377,32615,62992
17097,16,State - TRIPURA,Rural,25-29,Primary,28957,28958,57915
17098,16,State - TRIPURA,Rural,30-34,Primary,22630,21341,43971
17099,16,State - TRIPURA,Rural,35-39,Primary,20710,19197,39907
17100,16,State - TRIPURA,Rural,40-44,Primary,16291,13785,30076
17101,16,State - TRIPURA,Rural,45-49,Primary,14178,10585,24763
17102,16,State - TRIPURA,Rural,50-54,Primary,11719,7330,19049
17103,16,State - TRIPURA,Rural,55-59,Primary,7977,4577,12554
17104,16,State - TRIPURA,Rural,60-64,Primary,6760,3252,10012
17105,16,State - TRIPURA,Rural,65-69,Primary,5057,2136,7193
17106,16,State - TRIPURA,Rural,70-74,Primary,3488,1264,4752
17107,16,State - TRIPURA,Rural,75-79,Primary,1853,664,2517
17108,16,State - TRIPURA,Rural,80+,Primary,2178,845,3023
17109,16,State - TRIPURA,Rural,Age not stated,Primary,58,54,112
17110,16,State - TRIPURA,Urban,All ages,Primary,79673,84624,164297
17111,16,State - TRIPURA,Urban,0-6,Primary,0,0,0
17112,16,State - TRIPURA,Urban,7,Primary,0,0,0
17113,16,State - TRIPURA,Urban,8,Primary,0,0,0
17114,16,State - TRIPURA,Urban,9,Primary,276,314,590
17115,16,State - TRIPURA,Urban,10,Primary,1753,1834,3587
17116,16,State - TRIPURA,Urban,11,Primary,5336,5305,10641
17117,16,State - TRIPURA,Urban,12,Primary,6350,6155,12505
17118,16,State - TRIPURA,Urban,13,Primary,5210,5226,10436
17119,16,State - TRIPURA,Urban,14,Primary,2934,2633,5567
17120,16,State - TRIPURA,Urban,15,Primary,1739,1444,3183
17121,16,State - TRIPURA,Urban,16,Primary,1387,1169,2556
17122,16,State - TRIPURA,Urban,17,Primary,1263,1086,2349
17123,16,State - TRIPURA,Urban,18,Primary,1469,1383,2852
17124,16,State - TRIPURA,Urban,19,Primary,1354,1415,2769
17125,16,State - TRIPURA,Urban,20-24,Primary,7737,8042,15779
17126,16,State - TRIPURA,Urban,25-29,Primary,7376,8452,15828
17127,16,State - TRIPURA,Urban,30-34,Primary,6314,7164,13478
17128,16,State - TRIPURA,Urban,35-39,Primary,6287,7357,13644
17129,16,State - TRIPURA,Urban,40-44,Primary,5241,6013,11254
17130,16,State - TRIPURA,Urban,45-49,Primary,4572,5196,9768
17131,16,State - TRIPURA,Urban,50-54,Primary,3856,4072,7928
17132,16,State - TRIPURA,Urban,55-59,Primary,2759,2879,5638
17133,16,State - TRIPURA,Urban,60-64,Primary,2158,2349,4507
17134,16,State - TRIPURA,Urban,65-69,Primary,1596,1838,3434
17135,16,State - TRIPURA,Urban,70-74,Primary,1160,1380,2540
17136,16,State - TRIPURA,Urban,75-79,Primary,729,907,1636
17137,16,State - TRIPURA,Urban,80+,Primary,771,970,1741
17138,16,State - TRIPURA,Urban,Age not stated,Primary,46,41,87
17139,17,State - MEGHALAYA,Total,All ages,Primary,203761,209168,412929
17140,17,State - MEGHALAYA,Total,0-6,Primary,0,0,0
17141,17,State - MEGHALAYA,Total,7,Primary,0,0,0
17142,17,State - MEGHALAYA,Total,8,Primary,0,0,0
17143,17,State - MEGHALAYA,Total,9,Primary,2861,3147,6008
17144,17,State - MEGHALAYA,Total,10,Primary,6923,7581,14504
17145,17,State - MEGHALAYA,Total,11,Primary,11947,13365,25312
17146,17,State - MEGHALAYA,Total,12,Primary,14473,16261,30734
17147,17,State - MEGHALAYA,Total,13,Primary,14352,16149,30501
17148,17,State - MEGHALAYA,Total,14,Primary,13173,14284,27457
17149,17,State - MEGHALAYA,Total,15,Primary,11063,11460,22523
17150,17,State - MEGHALAYA,Total,16,Primary,9190,9052,18242
17151,17,State - MEGHALAYA,Total,17,Primary,7076,6589,13665
17152,17,State - MEGHALAYA,Total,18,Primary,6419,6409,12828
17153,17,State - MEGHALAYA,Total,19,Primary,4863,5059,9922
17154,17,State - MEGHALAYA,Total,20-24,Primary,20947,23614,44561
17155,17,State - MEGHALAYA,Total,25-29,Primary,18068,19863,37931
17156,17,State - MEGHALAYA,Total,30-34,Primary,13413,14283,27696
17157,17,State - MEGHALAYA,Total,35-39,Primary,11886,12269,24155
17158,17,State - MEGHALAYA,Total,40-44,Primary,9656,9073,18729
17159,17,State - MEGHALAYA,Total,45-49,Primary,8492,6808,15300
17160,17,State - MEGHALAYA,Total,50-54,Primary,6133,4707,10840
17161,17,State - MEGHALAYA,Total,55-59,Primary,4153,2989,7142
17162,17,State - MEGHALAYA,Total,60-64,Primary,3339,2373,5712
17163,17,State - MEGHALAYA,Total,65-69,Primary,2255,1530,3785
17164,17,State - MEGHALAYA,Total,70-74,Primary,1294,886,2180
17165,17,State - MEGHALAYA,Total,75-79,Primary,676,504,1180
17166,17,State - MEGHALAYA,Total,80+,Primary,796,637,1433
17167,17,State - MEGHALAYA,Total,Age not stated,Primary,313,276,589
17168,17,State - MEGHALAYA,Rural,All ages,Primary,162619,165336,327955
17169,17,State - MEGHALAYA,Rural,0-6,Primary,0,0,0
17170,17,State - MEGHALAYA,Rural,7,Primary,0,0,0
17171,17,State - MEGHALAYA,Rural,8,Primary,0,0,0
17172,17,State - MEGHALAYA,Rural,9,Primary,2290,2503,4793
17173,17,State - MEGHALAYA,Rural,10,Primary,5011,5576,10587
17174,17,State - MEGHALAYA,Rural,11,Primary,8178,9362,17540
17175,17,State - MEGHALAYA,Rural,12,Primary,10377,11899,22276
17176,17,State - MEGHALAYA,Rural,13,Primary,10702,12429,23131
17177,17,State - MEGHALAYA,Rural,14,Primary,10640,11703,22343
17178,17,State - MEGHALAYA,Rural,15,Primary,9289,9609,18898
17179,17,State - MEGHALAYA,Rural,16,Primary,7805,7738,15543
17180,17,State - MEGHALAYA,Rural,17,Primary,6057,5700,11757
17181,17,State - MEGHALAYA,Rural,18,Primary,5508,5640,11148
17182,17,State - MEGHALAYA,Rural,19,Primary,4109,4410,8519
17183,17,State - MEGHALAYA,Rural,20-24,Primary,17592,20286,37878
17184,17,State - MEGHALAYA,Rural,25-29,Primary,14932,16469,31401
17185,17,State - MEGHALAYA,Rural,30-34,Primary,10946,11498,22444
17186,17,State - MEGHALAYA,Rural,35-39,Primary,9677,9461,19138
17187,17,State - MEGHALAYA,Rural,40-44,Primary,7786,6761,14547
17188,17,State - MEGHALAYA,Rural,45-49,Primary,6730,4936,11666
17189,17,State - MEGHALAYA,Rural,50-54,Primary,4850,3278,8128
17190,17,State - MEGHALAYA,Rural,55-59,Primary,3211,2042,5253
17191,17,State - MEGHALAYA,Rural,60-64,Primary,2659,1605,4264
17192,17,State - MEGHALAYA,Rural,65-69,Primary,1833,1038,2871
17193,17,State - MEGHALAYA,Rural,70-74,Primary,1024,530,1554
17194,17,State - MEGHALAYA,Rural,75-79,Primary,538,261,799
17195,17,State - MEGHALAYA,Rural,80+,Primary,617,363,980
17196,17,State - MEGHALAYA,Rural,Age not stated,Primary,258,239,497
17197,17,State - MEGHALAYA,Urban,All ages,Primary,41142,43832,84974
17198,17,State - MEGHALAYA,Urban,0-6,Primary,0,0,0
17199,17,State - MEGHALAYA,Urban,7,Primary,0,0,0
17200,17,State - MEGHALAYA,Urban,8,Primary,0,0,0
17201,17,State - MEGHALAYA,Urban,9,Primary,571,644,1215
17202,17,State - MEGHALAYA,Urban,10,Primary,1912,2005,3917
17203,17,State - MEGHALAYA,Urban,11,Primary,3769,4003,7772
17204,17,State - MEGHALAYA,Urban,12,Primary,4096,4362,8458
17205,17,State - MEGHALAYA,Urban,13,Primary,3650,3720,7370
17206,17,State - MEGHALAYA,Urban,14,Primary,2533,2581,5114
17207,17,State - MEGHALAYA,Urban,15,Primary,1774,1851,3625
17208,17,State - MEGHALAYA,Urban,16,Primary,1385,1314,2699
17209,17,State - MEGHALAYA,Urban,17,Primary,1019,889,1908
17210,17,State - MEGHALAYA,Urban,18,Primary,911,769,1680
17211,17,State - MEGHALAYA,Urban,19,Primary,754,649,1403
17212,17,State - MEGHALAYA,Urban,20-24,Primary,3355,3328,6683
17213,17,State - MEGHALAYA,Urban,25-29,Primary,3136,3394,6530
17214,17,State - MEGHALAYA,Urban,30-34,Primary,2467,2785,5252
17215,17,State - MEGHALAYA,Urban,35-39,Primary,2209,2808,5017
17216,17,State - MEGHALAYA,Urban,40-44,Primary,1870,2312,4182
17217,17,State - MEGHALAYA,Urban,45-49,Primary,1762,1872,3634
17218,17,State - MEGHALAYA,Urban,50-54,Primary,1283,1429,2712
17219,17,State - MEGHALAYA,Urban,55-59,Primary,942,947,1889
17220,17,State - MEGHALAYA,Urban,60-64,Primary,680,768,1448
17221,17,State - MEGHALAYA,Urban,65-69,Primary,422,492,914
17222,17,State - MEGHALAYA,Urban,70-74,Primary,270,356,626
17223,17,State - MEGHALAYA,Urban,75-79,Primary,138,243,381
17224,17,State - MEGHALAYA,Urban,80+,Primary,179,274,453
17225,17,State - MEGHALAYA,Urban,Age not stated,Primary,55,37,92
17226,18,State - ASSAM,Total,All ages,Primary,2378849,2004541,4383390
17227,18,State - ASSAM,Total,0-6,Primary,0,0,0
17228,18,State - ASSAM,Total,7,Primary,0,0,0
17229,18,State - ASSAM,Total,8,Primary,0,0,0
17230,18,State - ASSAM,Total,9,Primary,38913,40389,79302
17231,18,State - ASSAM,Total,10,Primary,117363,116066,233429
17232,18,State - ASSAM,Total,11,Primary,182172,181775,363947
17233,18,State - ASSAM,Total,12,Primary,226469,218443,444912
17234,18,State - ASSAM,Total,13,Primary,173424,164977,338401
17235,18,State - ASSAM,Total,14,Primary,113827,100862,214689
17236,18,State - ASSAM,Total,15,Primary,77963,59657,137620
17237,18,State - ASSAM,Total,16,Primary,62298,43239,105537
17238,18,State - ASSAM,Total,17,Primary,49133,32537,81670
17239,18,State - ASSAM,Total,18,Primary,64378,49806,114184
17240,18,State - ASSAM,Total,19,Primary,44106,41756,85862
17241,18,State - ASSAM,Total,20-24,Primary,228729,210968,439697
17242,18,State - ASSAM,Total,25-29,Primary,204774,178997,383771
17243,18,State - ASSAM,Total,30-34,Primary,154043,130552,284595
17244,18,State - ASSAM,Total,35-39,Primary,143192,113730,256922
17245,18,State - ASSAM,Total,40-44,Primary,111774,83019,194793
17246,18,State - ASSAM,Total,45-49,Primary,103322,72316,175638
17247,18,State - ASSAM,Total,50-54,Primary,79107,51178,130285
17248,18,State - ASSAM,Total,55-59,Primary,60516,37358,97874
17249,18,State - ASSAM,Total,60-64,Primary,53053,31815,84868
17250,18,State - ASSAM,Total,65-69,Primary,35567,19991,55558
17251,18,State - ASSAM,Total,70-74,Primary,25965,11836,37801
17252,18,State - ASSAM,Total,75-79,Primary,13464,5848,19312
17253,18,State - ASSAM,Total,80+,Primary,14378,6616,20994
17254,18,State - ASSAM,Total,Age not stated,Primary,919,810,1729
17255,18,State - ASSAM,Rural,All ages,Primary,2066648,1721223,3787871
17256,18,State - ASSAM,Rural,0-6,Primary,0,0,0
17257,18,State - ASSAM,Rural,7,Primary,0,0,0
17258,18,State - ASSAM,Rural,8,Primary,0,0,0
17259,18,State - ASSAM,Rural,9,Primary,33171,34326,67497
17260,18,State - ASSAM,Rural,10,Primary,100256,99166,199422
17261,18,State - ASSAM,Rural,11,Primary,155327,155719,311046
17262,18,State - ASSAM,Rural,12,Primary,197817,191879,389696
17263,18,State - ASSAM,Rural,13,Primary,152758,146530,299288
17264,18,State - ASSAM,Rural,14,Primary,101818,90863,192681
17265,18,State - ASSAM,Rural,15,Primary,70598,54132,124730
17266,18,State - ASSAM,Rural,16,Primary,56616,39174,95790
17267,18,State - ASSAM,Rural,17,Primary,44221,29366,73587
17268,18,State - ASSAM,Rural,18,Primary,58065,45322,103387
17269,18,State - ASSAM,Rural,19,Primary,39488,37914,77402
17270,18,State - ASSAM,Rural,20-24,Primary,202841,188402,391243
17271,18,State - ASSAM,Rural,25-29,Primary,179775,156467,336242
17272,18,State - ASSAM,Rural,30-34,Primary,133534,111281,244815
17273,18,State - ASSAM,Rural,35-39,Primary,122203,94081,216284
17274,18,State - ASSAM,Rural,40-44,Primary,93745,67011,160756
17275,18,State - ASSAM,Rural,45-49,Primary,86333,57244,143577
17276,18,State - ASSAM,Rural,50-54,Primary,65984,39976,105960
17277,18,State - ASSAM,Rural,55-59,Primary,50776,28430,79206
17278,18,State - ASSAM,Rural,60-64,Primary,45025,23646,68671
17279,18,State - ASSAM,Rural,65-69,Primary,30274,14186,44460
17280,18,State - ASSAM,Rural,70-74,Primary,21988,7881,29869
17281,18,State - ASSAM,Rural,75-79,Primary,11236,3399,14635
17282,18,State - ASSAM,Rural,80+,Primary,12074,4199,16273
17283,18,State - ASSAM,Rural,Age not stated,Primary,725,629,1354
17284,18,State - ASSAM,Urban,All ages,Primary,312201,283318,595519
17285,18,State - ASSAM,Urban,0-6,Primary,0,0,0
17286,18,State - ASSAM,Urban,7,Primary,0,0,0
17287,18,State - ASSAM,Urban,8,Primary,0,0,0
17288,18,State - ASSAM,Urban,9,Primary,5742,6063,11805
17289,18,State - ASSAM,Urban,10,Primary,17107,16900,34007
17290,18,State - ASSAM,Urban,11,Primary,26845,26056,52901
17291,18,State - ASSAM,Urban,12,Primary,28652,26564,55216
17292,18,State - ASSAM,Urban,13,Primary,20666,18447,39113
17293,18,State - ASSAM,Urban,14,Primary,12009,9999,22008
17294,18,State - ASSAM,Urban,15,Primary,7365,5525,12890
17295,18,State - ASSAM,Urban,16,Primary,5682,4065,9747
17296,18,State - ASSAM,Urban,17,Primary,4912,3171,8083
17297,18,State - ASSAM,Urban,18,Primary,6313,4484,10797
17298,18,State - ASSAM,Urban,19,Primary,4618,3842,8460
17299,18,State - ASSAM,Urban,20-24,Primary,25888,22566,48454
17300,18,State - ASSAM,Urban,25-29,Primary,24999,22530,47529
17301,18,State - ASSAM,Urban,30-34,Primary,20509,19271,39780
17302,18,State - ASSAM,Urban,35-39,Primary,20989,19649,40638
17303,18,State - ASSAM,Urban,40-44,Primary,18029,16008,34037
17304,18,State - ASSAM,Urban,45-49,Primary,16989,15072,32061
17305,18,State - ASSAM,Urban,50-54,Primary,13123,11202,24325
17306,18,State - ASSAM,Urban,55-59,Primary,9740,8928,18668
17307,18,State - ASSAM,Urban,60-64,Primary,8028,8169,16197
17308,18,State - ASSAM,Urban,65-69,Primary,5293,5805,11098
17309,18,State - ASSAM,Urban,70-74,Primary,3977,3955,7932
17310,18,State - ASSAM,Urban,75-79,Primary,2228,2449,4677
17311,18,State - ASSAM,Urban,80+,Primary,2304,2417,4721
17312,18,State - ASSAM,Urban,Age not stated,Primary,194,181,375
17313,19,State - WEST BENGAL,Total,All ages,Primary,7897027,7057564,14954591
17314,19,State - WEST BENGAL,Total,0-6,Primary,0,0,0
17315,19,State - WEST BENGAL,Total,7,Primary,0,0,0
17316,19,State - WEST BENGAL,Total,8,Primary,0,0,0
17317,19,State - WEST BENGAL,Total,9,Primary,106036,113185,219221
17318,19,State - WEST BENGAL,Total,10,Primary,348326,354240,702566
17319,19,State - WEST BENGAL,Total,11,Primary,521915,523621,1045536
17320,19,State - WEST BENGAL,Total,12,Primary,612770,595648,1208418
17321,19,State - WEST BENGAL,Total,13,Primary,459472,455828,915300
17322,19,State - WEST BENGAL,Total,14,Primary,313904,296915,610819
17323,19,State - WEST BENGAL,Total,15,Primary,223336,187796,411132
17324,19,State - WEST BENGAL,Total,16,Primary,189446,142470,331916
17325,19,State - WEST BENGAL,Total,17,Primary,169431,117665,287096
17326,19,State - WEST BENGAL,Total,18,Primary,230072,184872,414944
17327,19,State - WEST BENGAL,Total,19,Primary,168706,158717,327423
17328,19,State - WEST BENGAL,Total,20-24,Primary,910897,851030,1761927
17329,19,State - WEST BENGAL,Total,25-29,Primary,761380,732589,1493969
17330,19,State - WEST BENGAL,Total,30-34,Primary,591963,568401,1160364
17331,19,State - WEST BENGAL,Total,35-39,Primary,562301,521122,1083423
17332,19,State - WEST BENGAL,Total,40-44,Primary,440092,364142,804234
17333,19,State - WEST BENGAL,Total,45-49,Primary,353644,281894,635538
17334,19,State - WEST BENGAL,Total,50-54,Primary,276254,189366,465620
17335,19,State - WEST BENGAL,Total,55-59,Primary,201669,137694,339363
17336,19,State - WEST BENGAL,Total,60-64,Primary,161290,101617,262907
17337,19,State - WEST BENGAL,Total,65-69,Primary,117616,69852,187468
17338,19,State - WEST BENGAL,Total,70-74,Primary,80102,44311,124413
17339,19,State - WEST BENGAL,Total,75-79,Primary,42047,25383,67430
17340,19,State - WEST BENGAL,Total,80+,Primary,48629,34616,83245
17341,19,State - WEST BENGAL,Total,Age not stated,Primary,5729,4590,10319
17342,19,State - WEST BENGAL,Rural,All ages,Primary,5687905,4938876,10626781
17343,19,State - WEST BENGAL,Rural,0-6,Primary,0,0,0
17344,19,State - WEST BENGAL,Rural,7,Primary,0,0,0
17345,19,State - WEST BENGAL,Rural,8,Primary,0,0,0
17346,19,State - WEST BENGAL,Rural,9,Primary,69314,74648,143962
17347,19,State - WEST BENGAL,Rural,10,Primary,237806,243830,481636
17348,19,State - WEST BENGAL,Rural,11,Primary,362108,368110,730218
17349,19,State - WEST BENGAL,Rural,12,Primary,446331,439568,885899
17350,19,State - WEST BENGAL,Rural,13,Primary,344812,347126,691938
17351,19,State - WEST BENGAL,Rural,14,Primary,240659,229485,470144
17352,19,State - WEST BENGAL,Rural,15,Primary,172844,144093,316937
17353,19,State - WEST BENGAL,Rural,16,Primary,147201,107706,254907
17354,19,State - WEST BENGAL,Rural,17,Primary,130974,87777,218751
17355,19,State - WEST BENGAL,Rural,18,Primary,178177,140873,319050
17356,19,State - WEST BENGAL,Rural,19,Primary,129250,120623,249873
17357,19,State - WEST BENGAL,Rural,20-24,Primary,689201,642516,1331717
17358,19,State - WEST BENGAL,Rural,25-29,Primary,557121,531433,1088554
17359,19,State - WEST BENGAL,Rural,30-34,Primary,419127,395692,814819
17360,19,State - WEST BENGAL,Rural,35-39,Primary,396456,352062,748518
17361,19,State - WEST BENGAL,Rural,40-44,Primary,304353,237767,542120
17362,19,State - WEST BENGAL,Rural,45-49,Primary,238045,173513,411558
17363,19,State - WEST BENGAL,Rural,50-54,Primary,186413,109598,296011
17364,19,State - WEST BENGAL,Rural,55-59,Primary,135869,74533,210402
17365,19,State - WEST BENGAL,Rural,60-64,Primary,107669,48488,156157
17366,19,State - WEST BENGAL,Rural,65-69,Primary,79786,30161,109947
17367,19,State - WEST BENGAL,Rural,70-74,Primary,53286,16019,69305
17368,19,State - WEST BENGAL,Rural,75-79,Primary,27510,7797,35307
17369,19,State - WEST BENGAL,Rural,80+,Primary,30608,13237,43845
17370,19,State - WEST BENGAL,Rural,Age not stated,Primary,2985,2221,5206
17371,19,State - WEST BENGAL,Urban,All ages,Primary,2209122,2118688,4327810
17372,19,State - WEST BENGAL,Urban,0-6,Primary,0,0,0
17373,19,State - WEST BENGAL,Urban,7,Primary,0,0,0
17374,19,State - WEST BENGAL,Urban,8,Primary,0,0,0
17375,19,State - WEST BENGAL,Urban,9,Primary,36722,38537,75259
17376,19,State - WEST BENGAL,Urban,10,Primary,110520,110410,220930
17377,19,State - WEST BENGAL,Urban,11,Primary,159807,155511,315318
17378,19,State - WEST BENGAL,Urban,12,Primary,166439,156080,322519
17379,19,State - WEST BENGAL,Urban,13,Primary,114660,108702,223362
17380,19,State - WEST BENGAL,Urban,14,Primary,73245,67430,140675
17381,19,State - WEST BENGAL,Urban,15,Primary,50492,43703,94195
17382,19,State - WEST BENGAL,Urban,16,Primary,42245,34764,77009
17383,19,State - WEST BENGAL,Urban,17,Primary,38457,29888,68345
17384,19,State - WEST BENGAL,Urban,18,Primary,51895,43999,95894
17385,19,State - WEST BENGAL,Urban,19,Primary,39456,38094,77550
17386,19,State - WEST BENGAL,Urban,20-24,Primary,221696,208514,430210
17387,19,State - WEST BENGAL,Urban,25-29,Primary,204259,201156,405415
17388,19,State - WEST BENGAL,Urban,30-34,Primary,172836,172709,345545
17389,19,State - WEST BENGAL,Urban,35-39,Primary,165845,169060,334905
17390,19,State - WEST BENGAL,Urban,40-44,Primary,135739,126375,262114
17391,19,State - WEST BENGAL,Urban,45-49,Primary,115599,108381,223980
17392,19,State - WEST BENGAL,Urban,50-54,Primary,89841,79768,169609
17393,19,State - WEST BENGAL,Urban,55-59,Primary,65800,63161,128961
17394,19,State - WEST BENGAL,Urban,60-64,Primary,53621,53129,106750
17395,19,State - WEST BENGAL,Urban,65-69,Primary,37830,39691,77521
17396,19,State - WEST BENGAL,Urban,70-74,Primary,26816,28292,55108
17397,19,State - WEST BENGAL,Urban,75-79,Primary,14537,17586,32123
17398,19,State - WEST BENGAL,Urban,80+,Primary,18021,21379,39400
17399,19,State - WEST BENGAL,Urban,Age not stated,Primary,2744,2369,5113
17400,20,State - JHARKHAND,Total,All ages,Primary,2752242,2056362,4808604
17401,20,State - JHARKHAND,Total,0-6,Primary,0,0,0
17402,20,State - JHARKHAND,Total,7,Primary,0,0,0
17403,20,State - JHARKHAND,Total,8,Primary,0,0,0
17404,20,State - JHARKHAND,Total,9,Primary,27661,26263,53924
17405,20,State - JHARKHAND,Total,10,Primary,110989,99642,210631
17406,20,State - JHARKHAND,Total,11,Primary,168202,154339,322541
17407,20,State - JHARKHAND,Total,12,Primary,284187,256666,540853
17408,20,State - JHARKHAND,Total,13,Primary,209986,199993,409979
17409,20,State - JHARKHAND,Total,14,Primary,158288,145838,304126
17410,20,State - JHARKHAND,Total,15,Primary,115069,92793,207862
17411,20,State - JHARKHAND,Total,16,Primary,74361,57283,131644
17412,20,State - JHARKHAND,Total,17,Primary,45098,32421,77519
17413,20,State - JHARKHAND,Total,18,Primary,72398,50127,122525
17414,20,State - JHARKHAND,Total,19,Primary,37750,32956,70706
17415,20,State - JHARKHAND,Total,20-24,Primary,247792,194252,442044
17416,20,State - JHARKHAND,Total,25-29,Primary,236285,172429,408714
17417,20,State - JHARKHAND,Total,30-34,Primary,193135,133435,326570
17418,20,State - JHARKHAND,Total,35-39,Primary,171143,107048,278191
17419,20,State - JHARKHAND,Total,40-44,Primary,137866,77845,215711
17420,20,State - JHARKHAND,Total,45-49,Primary,120172,62552,182724
17421,20,State - JHARKHAND,Total,50-54,Primary,92351,47254,139605
17422,20,State - JHARKHAND,Total,55-59,Primary,71090,38016,109106
17423,20,State - JHARKHAND,Total,60-64,Primary,69781,31285,101066
17424,20,State - JHARKHAND,Total,65-69,Primary,46437,17579,64016
17425,20,State - JHARKHAND,Total,70-74,Primary,28556,9763,38319
17426,20,State - JHARKHAND,Total,75-79,Primary,12165,4691,16856
17427,20,State - JHARKHAND,Total,80+,Primary,14177,5679,19856
17428,20,State - JHARKHAND,Total,Age not stated,Primary,7303,6213,13516
17429,20,State - JHARKHAND,Rural,All ages,Primary,2219230,1539919,3759149
17430,20,State - JHARKHAND,Rural,0-6,Primary,0,0,0
17431,20,State - JHARKHAND,Rural,7,Primary,0,0,0
17432,20,State - JHARKHAND,Rural,8,Primary,0,0,0
17433,20,State - JHARKHAND,Rural,9,Primary,20116,18912,39028
17434,20,State - JHARKHAND,Rural,10,Primary,84667,74499,159166
17435,20,State - JHARKHAND,Rural,11,Primary,125505,114159,239664
17436,20,State - JHARKHAND,Rural,12,Primary,224672,201696,426368
17437,20,State - JHARKHAND,Rural,13,Primary,164825,156788,321613
17438,20,State - JHARKHAND,Rural,14,Primary,127372,117496,244868
17439,20,State - JHARKHAND,Rural,15,Primary,95674,76766,172440
17440,20,State - JHARKHAND,Rural,16,Primary,62061,47304,109365
17441,20,State - JHARKHAND,Rural,17,Primary,37219,26297,63516
17442,20,State - JHARKHAND,Rural,18,Primary,60720,41690,102410
17443,20,State - JHARKHAND,Rural,19,Primary,31181,27134,58315
17444,20,State - JHARKHAND,Rural,20-24,Primary,208394,156973,365367
17445,20,State - JHARKHAND,Rural,25-29,Primary,200384,134687,335071
17446,20,State - JHARKHAND,Rural,30-34,Primary,162285,100103,262388
17447,20,State - JHARKHAND,Rural,35-39,Primary,141356,74590,215946
17448,20,State - JHARKHAND,Rural,40-44,Primary,111088,50765,161853
17449,20,State - JHARKHAND,Rural,45-49,Primary,95345,37129,132474
17450,20,State - JHARKHAND,Rural,50-54,Primary,72097,25845,97942
17451,20,State - JHARKHAND,Rural,55-59,Primary,55094,20403,75497
17452,20,State - JHARKHAND,Rural,60-64,Primary,55519,16436,71955
17453,20,State - JHARKHAND,Rural,65-69,Primary,37570,8762,46332
17454,20,State - JHARKHAND,Rural,70-74,Primary,22280,4202,26482
17455,20,State - JHARKHAND,Rural,75-79,Primary,9213,1717,10930
17456,20,State - JHARKHAND,Rural,80+,Primary,10663,2668,13331
17457,20,State - JHARKHAND,Rural,Age not stated,Primary,3930,2898,6828
17458,20,State - JHARKHAND,Urban,All ages,Primary,533012,516443,1049455
17459,20,State - JHARKHAND,Urban,0-6,Primary,0,0,0
17460,20,State - JHARKHAND,Urban,7,Primary,0,0,0
17461,20,State - JHARKHAND,Urban,8,Primary,0,0,0
17462,20,State - JHARKHAND,Urban,9,Primary,7545,7351,14896
17463,20,State - JHARKHAND,Urban,10,Primary,26322,25143,51465
17464,20,State - JHARKHAND,Urban,11,Primary,42697,40180,82877
17465,20,State - JHARKHAND,Urban,12,Primary,59515,54970,114485
17466,20,State - JHARKHAND,Urban,13,Primary,45161,43205,88366
17467,20,State - JHARKHAND,Urban,14,Primary,30916,28342,59258
17468,20,State - JHARKHAND,Urban,15,Primary,19395,16027,35422
17469,20,State - JHARKHAND,Urban,16,Primary,12300,9979,22279
17470,20,State - JHARKHAND,Urban,17,Primary,7879,6124,14003
17471,20,State - JHARKHAND,Urban,18,Primary,11678,8437,20115
17472,20,State - JHARKHAND,Urban,19,Primary,6569,5822,12391
17473,20,State - JHARKHAND,Urban,20-24,Primary,39398,37279,76677
17474,20,State - JHARKHAND,Urban,25-29,Primary,35901,37742,73643
17475,20,State - JHARKHAND,Urban,30-34,Primary,30850,33332,64182
17476,20,State - JHARKHAND,Urban,35-39,Primary,29787,32458,62245
17477,20,State - JHARKHAND,Urban,40-44,Primary,26778,27080,53858
17478,20,State - JHARKHAND,Urban,45-49,Primary,24827,25423,50250
17479,20,State - JHARKHAND,Urban,50-54,Primary,20254,21409,41663
17480,20,State - JHARKHAND,Urban,55-59,Primary,15996,17613,33609
17481,20,State - JHARKHAND,Urban,60-64,Primary,14262,14849,29111
17482,20,State - JHARKHAND,Urban,65-69,Primary,8867,8817,17684
17483,20,State - JHARKHAND,Urban,70-74,Primary,6276,5561,11837
17484,20,State - JHARKHAND,Urban,75-79,Primary,2952,2974,5926
17485,20,State - JHARKHAND,Urban,80+,Primary,3514,3011,6525
17486,20,State - JHARKHAND,Urban,Age not stated,Primary,3373,3315,6688
17487,21,State - ODISHA,Total,All ages,Primary,4157327,3557389,7714716
17488,21,State - ODISHA,Total,0-6,Primary,0,0,0
17489,21,State - ODISHA,Total,7,Primary,0,0,0
17490,21,State - ODISHA,Total,8,Primary,0,0,0
17491,21,State - ODISHA,Total,9,Primary,35876,35614,71490
17492,21,State - ODISHA,Total,10,Primary,163234,155991,319225
17493,21,State - ODISHA,Total,11,Primary,296579,282861,579440
17494,21,State - ODISHA,Total,12,Primary,333761,312688,646449
17495,21,State - ODISHA,Total,13,Primary,222864,213496,436360
17496,21,State - ODISHA,Total,14,Primary,122845,115170,238015
17497,21,State - ODISHA,Total,15,Primary,92725,84179,176904
17498,21,State - ODISHA,Total,16,Primary,77335,70861,148196
17499,21,State - ODISHA,Total,17,Primary,65803,61288,127091
17500,21,State - ODISHA,Total,18,Primary,96486,84570,181056
17501,21,State - ODISHA,Total,19,Primary,64528,60854,125382
17502,21,State - ODISHA,Total,20-24,Primary,366814,347389,714203
17503,21,State - ODISHA,Total,25-29,Primary,330440,315492,645932
17504,21,State - ODISHA,Total,30-34,Primary,283404,277067,560471
17505,21,State - ODISHA,Total,35-39,Primary,296822,271133,567955
17506,21,State - ODISHA,Total,40-44,Primary,269199,222206,491405
17507,21,State - ODISHA,Total,45-49,Primary,251979,194132,446111
17508,21,State - ODISHA,Total,50-54,Primary,211220,155130,366350
17509,21,State - ODISHA,Total,55-59,Primary,164070,115140,279210
17510,21,State - ODISHA,Total,60-64,Primary,153142,79318,232460
17511,21,State - ODISHA,Total,65-69,Primary,98443,43056,141499
17512,21,State - ODISHA,Total,70-74,Primary,74364,27002,101366
17513,21,State - ODISHA,Total,75-79,Primary,37215,12844,50059
17514,21,State - ODISHA,Total,80+,Primary,39495,12506,52001
17515,21,State - ODISHA,Total,Age not stated,Primary,8684,7402,16086
17516,21,State - ODISHA,Rural,All ages,Primary,3588993,2985309,6574302
17517,21,State - ODISHA,Rural,0-6,Primary,0,0,0
17518,21,State - ODISHA,Rural,7,Primary,0,0,0
17519,21,State - ODISHA,Rural,8,Primary,0,0,0
17520,21,State - ODISHA,Rural,9,Primary,29388,28984,58372
17521,21,State - ODISHA,Rural,10,Primary,136162,130057,266219
17522,21,State - ODISHA,Rural,11,Primary,249344,238247,487591
17523,21,State - ODISHA,Rural,12,Primary,283847,266457,550304
17524,21,State - ODISHA,Rural,13,Primary,190488,183813,374301
17525,21,State - ODISHA,Rural,14,Primary,106618,100529,207147
17526,21,State - ODISHA,Rural,15,Primary,81823,74758,156581
17527,21,State - ODISHA,Rural,16,Primary,68185,63111,131296
17528,21,State - ODISHA,Rural,17,Primary,57871,54517,112388
17529,21,State - ODISHA,Rural,18,Primary,84735,75227,159962
17530,21,State - ODISHA,Rural,19,Primary,56290,53650,109940
17531,21,State - ODISHA,Rural,20-24,Primary,321331,304264,625595
17532,21,State - ODISHA,Rural,25-29,Primary,288631,271977,560608
17533,21,State - ODISHA,Rural,30-34,Primary,245777,235947,481724
17534,21,State - ODISHA,Rural,35-39,Primary,257766,226160,483926
17535,21,State - ODISHA,Rural,40-44,Primary,233236,181417,414653
17536,21,State - ODISHA,Rural,45-49,Primary,217550,154494,372044
17537,21,State - ODISHA,Rural,50-54,Primary,182478,122280,304758
17538,21,State - ODISHA,Rural,55-59,Primary,142331,89948,232279
17539,21,State - ODISHA,Rural,60-64,Primary,134134,59356,193490
17540,21,State - ODISHA,Rural,65-69,Primary,85594,30452,116046
17541,21,State - ODISHA,Rural,70-74,Primary,63751,18049,81800
17542,21,State - ODISHA,Rural,75-79,Primary,31647,8016,39663
17543,21,State - ODISHA,Rural,80+,Primary,32781,7677,40458
17544,21,State - ODISHA,Rural,Age not stated,Primary,7235,5922,13157
17545,21,State - ODISHA,Urban,All ages,Primary,568334,572080,1140414
17546,21,State - ODISHA,Urban,0-6,Primary,0,0,0
17547,21,State - ODISHA,Urban,7,Primary,0,0,0
17548,21,State - ODISHA,Urban,8,Primary,0,0,0
17549,21,State - ODISHA,Urban,9,Primary,6488,6630,13118
17550,21,State - ODISHA,Urban,10,Primary,27072,25934,53006
17551,21,State - ODISHA,Urban,11,Primary,47235,44614,91849
17552,21,State - ODISHA,Urban,12,Primary,49914,46231,96145
17553,21,State - ODISHA,Urban,13,Primary,32376,29683,62059
17554,21,State - ODISHA,Urban,14,Primary,16227,14641,30868
17555,21,State - ODISHA,Urban,15,Primary,10902,9421,20323
17556,21,State - ODISHA,Urban,16,Primary,9150,7750,16900
17557,21,State - ODISHA,Urban,17,Primary,7932,6771,14703
17558,21,State - ODISHA,Urban,18,Primary,11751,9343,21094
17559,21,State - ODISHA,Urban,19,Primary,8238,7204,15442
17560,21,State - ODISHA,Urban,20-24,Primary,45483,43125,88608
17561,21,State - ODISHA,Urban,25-29,Primary,41809,43515,85324
17562,21,State - ODISHA,Urban,30-34,Primary,37627,41120,78747
17563,21,State - ODISHA,Urban,35-39,Primary,39056,44973,84029
17564,21,State - ODISHA,Urban,40-44,Primary,35963,40789,76752
17565,21,State - ODISHA,Urban,45-49,Primary,34429,39638,74067
17566,21,State - ODISHA,Urban,50-54,Primary,28742,32850,61592
17567,21,State - ODISHA,Urban,55-59,Primary,21739,25192,46931
17568,21,State - ODISHA,Urban,60-64,Primary,19008,19962,38970
17569,21,State - ODISHA,Urban,65-69,Primary,12849,12604,25453
17570,21,State - ODISHA,Urban,70-74,Primary,10613,8953,19566
17571,21,State - ODISHA,Urban,75-79,Primary,5568,4828,10396
17572,21,State - ODISHA,Urban,80+,Primary,6714,4829,11543
17573,21,State - ODISHA,Urban,Age not stated,Primary,1449,1480,2929
17574,22,State - CHHATTISGARH,Total,All ages,Primary,2267581,1924563,4192144
17575,22,State - CHHATTISGARH,Total,0-6,Primary,0,0,0
17576,22,State - CHHATTISGARH,Total,7,Primary,0,0,0
17577,22,State - CHHATTISGARH,Total,8,Primary,0,0,0
17578,22,State - CHHATTISGARH,Total,9,Primary,9575,9670,19245
17579,22,State - CHHATTISGARH,Total,10,Primary,51554,50820,102374
17580,22,State - CHHATTISGARH,Total,11,Primary,144095,140985,285080
17581,22,State - CHHATTISGARH,Total,12,Primary,205812,199782,405594
17582,22,State - CHHATTISGARH,Total,13,Primary,190117,185826,375943
17583,22,State - CHHATTISGARH,Total,14,Primary,134673,126419,261092
17584,22,State - CHHATTISGARH,Total,15,Primary,81156,70046,151202
17585,22,State - CHHATTISGARH,Total,16,Primary,54083,46412,100495
17586,22,State - CHHATTISGARH,Total,17,Primary,39601,34012,73613
17587,22,State - CHHATTISGARH,Total,18,Primary,53105,46444,99549
17588,22,State - CHHATTISGARH,Total,19,Primary,37474,38745,76219
17589,22,State - CHHATTISGARH,Total,20-24,Primary,231318,241941,473259
17590,22,State - CHHATTISGARH,Total,25-29,Primary,210488,196362,406850
17591,22,State - CHHATTISGARH,Total,30-34,Primary,156737,148876,305613
17592,22,State - CHHATTISGARH,Total,35-39,Primary,151287,118245,269532
17593,22,State - CHHATTISGARH,Total,40-44,Primary,125534,84507,210041
17594,22,State - CHHATTISGARH,Total,45-49,Primary,116299,62013,178312
17595,22,State - CHHATTISGARH,Total,50-54,Primary,88528,43493,132021
17596,22,State - CHHATTISGARH,Total,55-59,Primary,67960,31025,98985
17597,22,State - CHHATTISGARH,Total,60-64,Primary,53635,22873,76508
17598,22,State - CHHATTISGARH,Total,65-69,Primary,30584,11492,42076
17599,22,State - CHHATTISGARH,Total,70-74,Primary,16788,6005,22793
17600,22,State - CHHATTISGARH,Total,75-79,Primary,7200,2717,9917
17601,22,State - CHHATTISGARH,Total,80+,Primary,8310,4431,12741
17602,22,State - CHHATTISGARH,Total,Age not stated,Primary,1668,1422,3090
17603,22,State - CHHATTISGARH,Rural,All ages,Primary,1790520,1480598,3271118
17604,22,State - CHHATTISGARH,Rural,0-6,Primary,0,0,0
17605,22,State - CHHATTISGARH,Rural,7,Primary,0,0,0
17606,22,State - CHHATTISGARH,Rural,8,Primary,0,0,0
17607,22,State - CHHATTISGARH,Rural,9,Primary,6293,6151,12444
17608,22,State - CHHATTISGARH,Rural,10,Primary,35472,34675,70147
17609,22,State - CHHATTISGARH,Rural,11,Primary,107851,105703,213554
17610,22,State - CHHATTISGARH,Rural,12,Primary,160435,156506,316941
17611,22,State - CHHATTISGARH,Rural,13,Primary,151605,149460,301065
17612,22,State - CHHATTISGARH,Rural,14,Primary,111106,105185,216291
17613,22,State - CHHATTISGARH,Rural,15,Primary,66718,58308,125026
17614,22,State - CHHATTISGARH,Rural,16,Primary,43750,38369,82119
17615,22,State - CHHATTISGARH,Rural,17,Primary,31261,27929,59190
17616,22,State - CHHATTISGARH,Rural,18,Primary,41784,38568,80352
17617,22,State - CHHATTISGARH,Rural,19,Primary,29104,32120,61224
17618,22,State - CHHATTISGARH,Rural,20-24,Primary,182420,197630,380050
17619,22,State - CHHATTISGARH,Rural,25-29,Primary,167700,156115,323815
17620,22,State - CHHATTISGARH,Rural,30-34,Primary,125408,116808,242216
17621,22,State - CHHATTISGARH,Rural,35-39,Primary,122054,88042,210096
17622,22,State - CHHATTISGARH,Rural,40-44,Primary,100321,59004,159325
17623,22,State - CHHATTISGARH,Rural,45-49,Primary,92646,39626,132272
17624,22,State - CHHATTISGARH,Rural,50-54,Primary,69718,26667,96385
17625,22,State - CHHATTISGARH,Rural,55-59,Primary,54195,18858,73053
17626,22,State - CHHATTISGARH,Rural,60-64,Primary,42958,12797,55755
17627,22,State - CHHATTISGARH,Rural,65-69,Primary,23925,5451,29376
17628,22,State - CHHATTISGARH,Rural,70-74,Primary,12153,2429,14582
17629,22,State - CHHATTISGARH,Rural,75-79,Primary,4810,900,5710
17630,22,State - CHHATTISGARH,Rural,80+,Primary,5797,2438,8235
17631,22,State - CHHATTISGARH,Rural,Age not stated,Primary,1036,859,1895
17632,22,State - CHHATTISGARH,Urban,All ages,Primary,477061,443965,921026
17633,22,State - CHHATTISGARH,Urban,0-6,Primary,0,0,0
17634,22,State - CHHATTISGARH,Urban,7,Primary,0,0,0
17635,22,State - CHHATTISGARH,Urban,8,Primary,0,0,0
17636,22,State - CHHATTISGARH,Urban,9,Primary,3282,3519,6801
17637,22,State - CHHATTISGARH,Urban,10,Primary,16082,16145,32227
17638,22,State - CHHATTISGARH,Urban,11,Primary,36244,35282,71526
17639,22,State - CHHATTISGARH,Urban,12,Primary,45377,43276,88653
17640,22,State - CHHATTISGARH,Urban,13,Primary,38512,36366,74878
17641,22,State - CHHATTISGARH,Urban,14,Primary,23567,21234,44801
17642,22,State - CHHATTISGARH,Urban,15,Primary,14438,11738,26176
17643,22,State - CHHATTISGARH,Urban,16,Primary,10333,8043,18376
17644,22,State - CHHATTISGARH,Urban,17,Primary,8340,6083,14423
17645,22,State - CHHATTISGARH,Urban,18,Primary,11321,7876,19197
17646,22,State - CHHATTISGARH,Urban,19,Primary,8370,6625,14995
17647,22,State - CHHATTISGARH,Urban,20-24,Primary,48898,44311,93209
17648,22,State - CHHATTISGARH,Urban,25-29,Primary,42788,40247,83035
17649,22,State - CHHATTISGARH,Urban,30-34,Primary,31329,32068,63397
17650,22,State - CHHATTISGARH,Urban,35-39,Primary,29233,30203,59436
17651,22,State - CHHATTISGARH,Urban,40-44,Primary,25213,25503,50716
17652,22,State - CHHATTISGARH,Urban,45-49,Primary,23653,22387,46040
17653,22,State - CHHATTISGARH,Urban,50-54,Primary,18810,16826,35636
17654,22,State - CHHATTISGARH,Urban,55-59,Primary,13765,12167,25932
17655,22,State - CHHATTISGARH,Urban,60-64,Primary,10677,10076,20753
17656,22,State - CHHATTISGARH,Urban,65-69,Primary,6659,6041,12700
17657,22,State - CHHATTISGARH,Urban,70-74,Primary,4635,3576,8211
17658,22,State - CHHATTISGARH,Urban,75-79,Primary,2390,1817,4207
17659,22,State - CHHATTISGARH,Urban,80+,Primary,2513,1993,4506
17660,22,State - CHHATTISGARH,Urban,Age not stated,Primary,632,563,1195
17661,23,State - MADHYA PRADESH,Total,All ages,Primary,6640472,5237769,11878241
17662,23,State - MADHYA PRADESH,Total,0-6,Primary,0,0,0
17663,23,State - MADHYA PRADESH,Total,7,Primary,0,0,0
17664,23,State - MADHYA PRADESH,Total,8,Primary,0,0,0
17665,23,State - MADHYA PRADESH,Total,9,Primary,58904,58503,117407
17666,23,State - MADHYA PRADESH,Total,10,Primary,266032,239596,505628
17667,23,State - MADHYA PRADESH,Total,11,Primary,451776,439938,891714
17668,23,State - MADHYA PRADESH,Total,12,Primary,621941,570332,1192273
17669,23,State - MADHYA PRADESH,Total,13,Primary,493967,470919,964886
17670,23,State - MADHYA PRADESH,Total,14,Primary,359296,323975,683271
17671,23,State - MADHYA PRADESH,Total,15,Primary,237136,208848,445984
17672,23,State - MADHYA PRADESH,Total,16,Primary,171121,148897,320018
17673,23,State - MADHYA PRADESH,Total,17,Primary,120030,100593,220623
17674,23,State - MADHYA PRADESH,Total,18,Primary,169918,134460,304378
17675,23,State - MADHYA PRADESH,Total,19,Primary,112813,95674,208487
17676,23,State - MADHYA PRADESH,Total,20-24,Primary,644525,536222,1180747
17677,23,State - MADHYA PRADESH,Total,25-29,Primary,554075,449906,1003981
17678,23,State - MADHYA PRADESH,Total,30-34,Primary,469657,374952,844609
17679,23,State - MADHYA PRADESH,Total,35-39,Primary,435391,306750,742141
17680,23,State - MADHYA PRADESH,Total,40-44,Primary,360759,229570,590329
17681,23,State - MADHYA PRADESH,Total,45-49,Primary,310781,173729,484510
17682,23,State - MADHYA PRADESH,Total,50-54,Primary,247532,120046,367578
17683,23,State - MADHYA PRADESH,Total,55-59,Primary,169629,84987,254616
17684,23,State - MADHYA PRADESH,Total,60-64,Primary,151144,70353,221497
17685,23,State - MADHYA PRADESH,Total,65-69,Primary,95213,41408,136621
17686,23,State - MADHYA PRADESH,Total,70-74,Primary,66795,24135,90930
17687,23,State - MADHYA PRADESH,Total,75-79,Primary,29639,11975,41614
17688,23,State - MADHYA PRADESH,Total,80+,Primary,37344,17475,54819
17689,23,State - MADHYA PRADESH,Total,Age not stated,Primary,5054,4526,9580
17690,23,State - MADHYA PRADESH,Rural,All ages,Primary,5042491,3797918,8840409
17691,23,State - MADHYA PRADESH,Rural,0-6,Primary,0,0,0
17692,23,State - MADHYA PRADESH,Rural,7,Primary,0,0,0
17693,23,State - MADHYA PRADESH,Rural,8,Primary,0,0,0
17694,23,State - MADHYA PRADESH,Rural,9,Primary,41364,40946,82310
17695,23,State - MADHYA PRADESH,Rural,10,Primary,193116,172544,365660
17696,23,State - MADHYA PRADESH,Rural,11,Primary,325952,320663,646615
17697,23,State - MADHYA PRADESH,Rural,12,Primary,467693,432788,900481
17698,23,State - MADHYA PRADESH,Rural,13,Primary,376703,363916,740619
17699,23,State - MADHYA PRADESH,Rural,14,Primary,284301,260920,545221
17700,23,State - MADHYA PRADESH,Rural,15,Primary,189688,170268,359956
17701,23,State - MADHYA PRADESH,Rural,16,Primary,136427,121476,257903
17702,23,State - MADHYA PRADESH,Rural,17,Primary,93178,80433,173611
17703,23,State - MADHYA PRADESH,Rural,18,Primary,132462,107996,240458
17704,23,State - MADHYA PRADESH,Rural,19,Primary,86139,76487,162626
17705,23,State - MADHYA PRADESH,Rural,20-24,Primary,498756,415976,914732
17706,23,State - MADHYA PRADESH,Rural,25-29,Primary,429444,333236,762680
17707,23,State - MADHYA PRADESH,Rural,30-34,Primary,364063,269816,633879
17708,23,State - MADHYA PRADESH,Rural,35-39,Primary,334590,205282,539872
17709,23,State - MADHYA PRADESH,Rural,40-44,Primary,272150,143670,415820
17710,23,State - MADHYA PRADESH,Rural,45-49,Primary,230272,98666,328938
17711,23,State - MADHYA PRADESH,Rural,50-54,Primary,183144,64967,248111
17712,23,State - MADHYA PRADESH,Rural,55-59,Primary,126560,43893,170453
17713,23,State - MADHYA PRADESH,Rural,60-64,Primary,112017,33190,145207
17714,23,State - MADHYA PRADESH,Rural,65-69,Primary,69745,17452,87197
17715,23,State - MADHYA PRADESH,Rural,70-74,Primary,47005,9047,56052
17716,23,State - MADHYA PRADESH,Rural,75-79,Primary,19920,3839,23759
17717,23,State - MADHYA PRADESH,Rural,80+,Primary,24748,7854,32602
17718,23,State - MADHYA PRADESH,Rural,Age not stated,Primary,3054,2593,5647
17719,23,State - MADHYA PRADESH,Urban,All ages,Primary,1597981,1439851,3037832
17720,23,State - MADHYA PRADESH,Urban,0-6,Primary,0,0,0
17721,23,State - MADHYA PRADESH,Urban,7,Primary,0,0,0
17722,23,State - MADHYA PRADESH,Urban,8,Primary,0,0,0
17723,23,State - MADHYA PRADESH,Urban,9,Primary,17540,17557,35097
17724,23,State - MADHYA PRADESH,Urban,10,Primary,72916,67052,139968
17725,23,State - MADHYA PRADESH,Urban,11,Primary,125824,119275,245099
17726,23,State - MADHYA PRADESH,Urban,12,Primary,154248,137544,291792
17727,23,State - MADHYA PRADESH,Urban,13,Primary,117264,107003,224267
17728,23,State - MADHYA PRADESH,Urban,14,Primary,74995,63055,138050
17729,23,State - MADHYA PRADESH,Urban,15,Primary,47448,38580,86028
17730,23,State - MADHYA PRADESH,Urban,16,Primary,34694,27421,62115
17731,23,State - MADHYA PRADESH,Urban,17,Primary,26852,20160,47012
17732,23,State - MADHYA PRADESH,Urban,18,Primary,37456,26464,63920
17733,23,State - MADHYA PRADESH,Urban,19,Primary,26674,19187,45861
17734,23,State - MADHYA PRADESH,Urban,20-24,Primary,145769,120246,266015
17735,23,State - MADHYA PRADESH,Urban,25-29,Primary,124631,116670,241301
17736,23,State - MADHYA PRADESH,Urban,30-34,Primary,105594,105136,210730
17737,23,State - MADHYA PRADESH,Urban,35-39,Primary,100801,101468,202269
17738,23,State - MADHYA PRADESH,Urban,40-44,Primary,88609,85900,174509
17739,23,State - MADHYA PRADESH,Urban,45-49,Primary,80509,75063,155572
17740,23,State - MADHYA PRADESH,Urban,50-54,Primary,64388,55079,119467
17741,23,State - MADHYA PRADESH,Urban,55-59,Primary,43069,41094,84163
17742,23,State - MADHYA PRADESH,Urban,60-64,Primary,39127,37163,76290
17743,23,State - MADHYA PRADESH,Urban,65-69,Primary,25468,23956,49424
17744,23,State - MADHYA PRADESH,Urban,70-74,Primary,19790,15088,34878
17745,23,State - MADHYA PRADESH,Urban,75-79,Primary,9719,8136,17855
17746,23,State - MADHYA PRADESH,Urban,80+,Primary,12596,9621,22217
17747,23,State - MADHYA PRADESH,Urban,Age not stated,Primary,2000,1933,3933
17748,24,State - GUJARAT,Total,All ages,Primary,5568559,4988442,10557001
17749,24,State - GUJARAT,Total,0-6,Primary,0,0,0
17750,24,State - GUJARAT,Total,7,Primary,0,0,0
17751,24,State - GUJARAT,Total,8,Primary,0,0,0
17752,24,State - GUJARAT,Total,9,Primary,63359,54514,117873
17753,24,State - GUJARAT,Total,10,Primary,271392,234539,505931
17754,24,State - GUJARAT,Total,11,Primary,475906,402992,878898
17755,24,State - GUJARAT,Total,12,Primary,480079,408874,888953
17756,24,State - GUJARAT,Total,13,Primary,334445,293170,627615
17757,24,State - GUJARAT,Total,14,Primary,179020,177368,356388
17758,24,State - GUJARAT,Total,15,Primary,127283,144022,271305
17759,24,State - GUJARAT,Total,16,Primary,102705,129311,232016
17760,24,State - GUJARAT,Total,17,Primary,95433,118741,214174
17761,24,State - GUJARAT,Total,18,Primary,124148,139477,263625
17762,24,State - GUJARAT,Total,19,Primary,95580,113673,209253
17763,24,State - GUJARAT,Total,20-24,Primary,521654,556526,1078180
17764,24,State - GUJARAT,Total,25-29,Primary,476299,459403,935702
17765,24,State - GUJARAT,Total,30-34,Primary,428883,391724,820607
17766,24,State - GUJARAT,Total,35-39,Primary,382936,326807,709743
17767,24,State - GUJARAT,Total,40-44,Primary,331630,278232,609862
17768,24,State - GUJARAT,Total,45-49,Primary,296268,220762,517030
17769,24,State - GUJARAT,Total,50-54,Primary,239807,164993,404800
17770,24,State - GUJARAT,Total,55-59,Primary,177393,122925,300318
17771,24,State - GUJARAT,Total,60-64,Primary,135057,91144,226201
17772,24,State - GUJARAT,Total,65-69,Primary,84090,57196,141286
17773,24,State - GUJARAT,Total,70-74,Primary,63255,39907,103162
17774,24,State - GUJARAT,Total,75-79,Primary,30686,21816,52502
17775,24,State - GUJARAT,Total,80+,Primary,32544,23650,56194
17776,24,State - GUJARAT,Total,Age not stated,Primary,18707,16676,35383
17777,24,State - GUJARAT,Rural,All ages,Primary,3391739,2904700,6296439
17778,24,State - GUJARAT,Rural,0-6,Primary,0,0,0
17779,24,State - GUJARAT,Rural,7,Primary,0,0,0
17780,24,State - GUJARAT,Rural,8,Primary,0,0,0
17781,24,State - GUJARAT,Rural,9,Primary,35506,31801,67307
17782,24,State - GUJARAT,Rural,10,Primary,162661,145850,308511
17783,24,State - GUJARAT,Rural,11,Primary,284194,248176,532370
17784,24,State - GUJARAT,Rural,12,Primary,295282,259202,554484
17785,24,State - GUJARAT,Rural,13,Primary,209339,189650,398989
17786,24,State - GUJARAT,Rural,14,Primary,118179,123100,241279
17787,24,State - GUJARAT,Rural,15,Primary,86960,103977,190937
17788,24,State - GUJARAT,Rural,16,Primary,70174,92744,162918
17789,24,State - GUJARAT,Rural,17,Primary,63336,83559,146895
17790,24,State - GUJARAT,Rural,18,Primary,79282,96845,176127
17791,24,State - GUJARAT,Rural,19,Primary,58942,76325,135267
17792,24,State - GUJARAT,Rural,20-24,Primary,321815,349155,670970
17793,24,State - GUJARAT,Rural,25-29,Primary,292121,265606,557727
17794,24,State - GUJARAT,Rural,30-34,Primary,263187,220087,483274
17795,24,State - GUJARAT,Rural,35-39,Primary,230584,169661,400245
17796,24,State - GUJARAT,Rural,40-44,Primary,196512,136854,333366
17797,24,State - GUJARAT,Rural,45-49,Primary,173410,99976,273386
17798,24,State - GUJARAT,Rural,50-54,Primary,139279,71817,211096
17799,24,State - GUJARAT,Rural,55-59,Primary,104062,50691,154753
17800,24,State - GUJARAT,Rural,60-64,Primary,79437,35039,114476
17801,24,State - GUJARAT,Rural,65-69,Primary,49170,20216,69386
17802,24,State - GUJARAT,Rural,70-74,Primary,36088,12909,48997
17803,24,State - GUJARAT,Rural,75-79,Primary,16001,5905,21906
17804,24,State - GUJARAT,Rural,80+,Primary,16757,7318,24075
17805,24,State - GUJARAT,Rural,Age not stated,Primary,9461,8237,17698
17806,24,State - GUJARAT,Urban,All ages,Primary,2176820,2083742,4260562
17807,24,State - GUJARAT,Urban,0-6,Primary,0,0,0
17808,24,State - GUJARAT,Urban,7,Primary,0,0,0
17809,24,State - GUJARAT,Urban,8,Primary,0,0,0
17810,24,State - GUJARAT,Urban,9,Primary,27853,22713,50566
17811,24,State - GUJARAT,Urban,10,Primary,108731,88689,197420
17812,24,State - GUJARAT,Urban,11,Primary,191712,154816,346528
17813,24,State - GUJARAT,Urban,12,Primary,184797,149672,334469
17814,24,State - GUJARAT,Urban,13,Primary,125106,103520,228626
17815,24,State - GUJARAT,Urban,14,Primary,60841,54268,115109
17816,24,State - GUJARAT,Urban,15,Primary,40323,40045,80368
17817,24,State - GUJARAT,Urban,16,Primary,32531,36567,69098
17818,24,State - GUJARAT,Urban,17,Primary,32097,35182,67279
17819,24,State - GUJARAT,Urban,18,Primary,44866,42632,87498
17820,24,State - GUJARAT,Urban,19,Primary,36638,37348,73986
17821,24,State - GUJARAT,Urban,20-24,Primary,199839,207371,407210
17822,24,State - GUJARAT,Urban,25-29,Primary,184178,193797,377975
17823,24,State - GUJARAT,Urban,30-34,Primary,165696,171637,337333
17824,24,State - GUJARAT,Urban,35-39,Primary,152352,157146,309498
17825,24,State - GUJARAT,Urban,40-44,Primary,135118,141378,276496
17826,24,State - GUJARAT,Urban,45-49,Primary,122858,120786,243644
17827,24,State - GUJARAT,Urban,50-54,Primary,100528,93176,193704
17828,24,State - GUJARAT,Urban,55-59,Primary,73331,72234,145565
17829,24,State - GUJARAT,Urban,60-64,Primary,55620,56105,111725
17830,24,State - GUJARAT,Urban,65-69,Primary,34920,36980,71900
17831,24,State - GUJARAT,Urban,70-74,Primary,27167,26998,54165
17832,24,State - GUJARAT,Urban,75-79,Primary,14685,15911,30596
17833,24,State - GUJARAT,Urban,80+,Primary,15787,16332,32119
17834,24,State - GUJARAT,Urban,Age not stated,Primary,9246,8439,17685
17835,25,State - DAMAN & DIU,Total,All ages,Primary,26048,15399,41447
17836,25,State - DAMAN & DIU,Total,0-6,Primary,0,0,0
17837,25,State - DAMAN & DIU,Total,7,Primary,0,0,0
17838,25,State - DAMAN & DIU,Total,8,Primary,0,0,0
17839,25,State - DAMAN & DIU,Total,9,Primary,156,171,327
17840,25,State - DAMAN & DIU,Total,10,Primary,728,648,1376
17841,25,State - DAMAN & DIU,Total,11,Primary,1413,1285,2698
17842,25,State - DAMAN & DIU,Total,12,Primary,1329,1180,2509
17843,25,State - DAMAN & DIU,Total,13,Primary,950,790,1740
17844,25,State - DAMAN & DIU,Total,14,Primary,483,310,793
17845,25,State - DAMAN & DIU,Total,15,Primary,412,187,599
17846,25,State - DAMAN & DIU,Total,16,Primary,444,142,586
17847,25,State - DAMAN & DIU,Total,17,Primary,604,175,779
17848,25,State - DAMAN & DIU,Total,18,Primary,1207,236,1443
17849,25,State - DAMAN & DIU,Total,19,Primary,986,256,1242
17850,25,State - DAMAN & DIU,Total,20-24,Primary,5125,1731,6856
17851,25,State - DAMAN & DIU,Total,25-29,Primary,3534,1824,5358
17852,25,State - DAMAN & DIU,Total,30-34,Primary,2306,1475,3781
17853,25,State - DAMAN & DIU,Total,35-39,Primary,1813,1348,3161
17854,25,State - DAMAN & DIU,Total,40-44,Primary,1338,1041,2379
17855,25,State - DAMAN & DIU,Total,45-49,Primary,1009,871,1880
17856,25,State - DAMAN & DIU,Total,50-54,Primary,678,602,1280
17857,25,State - DAMAN & DIU,Total,55-59,Primary,505,444,949
17858,25,State - DAMAN & DIU,Total,60-64,Primary,401,325,726
17859,25,State - DAMAN & DIU,Total,65-69,Primary,254,155,409
17860,25,State - DAMAN & DIU,Total,70-74,Primary,189,96,285
17861,25,State - DAMAN & DIU,Total,75-79,Primary,85,47,132
17862,25,State - DAMAN & DIU,Total,80+,Primary,74,46,120
17863,25,State - DAMAN & DIU,Total,Age not stated,Primary,25,14,39
17864,25,State - DAMAN & DIU,Rural,All ages,Primary,6564,4873,11437
17865,25,State - DAMAN & DIU,Rural,0-6,Primary,0,0,0
17866,25,State - DAMAN & DIU,Rural,7,Primary,0,0,0
17867,25,State - DAMAN & DIU,Rural,8,Primary,0,0,0
17868,25,State - DAMAN & DIU,Rural,9,Primary,58,85,143
17869,25,State - DAMAN & DIU,Rural,10,Primary,333,312,645
17870,25,State - DAMAN & DIU,Rural,11,Primary,585,505,1090
17871,25,State - DAMAN & DIU,Rural,12,Primary,518,457,975
17872,25,State - DAMAN & DIU,Rural,13,Primary,319,283,602
17873,25,State - DAMAN & DIU,Rural,14,Primary,150,101,251
17874,25,State - DAMAN & DIU,Rural,15,Primary,111,59,170
17875,25,State - DAMAN & DIU,Rural,16,Primary,85,64,149
17876,25,State - DAMAN & DIU,Rural,17,Primary,108,72,180
17877,25,State - DAMAN & DIU,Rural,18,Primary,166,85,251
17878,25,State - DAMAN & DIU,Rural,19,Primary,138,93,231
17879,25,State - DAMAN & DIU,Rural,20-24,Primary,742,588,1330
17880,25,State - DAMAN & DIU,Rural,25-29,Primary,662,559,1221
17881,25,State - DAMAN & DIU,Rural,30-34,Primary,592,474,1066
17882,25,State - DAMAN & DIU,Rural,35-39,Primary,525,386,911
17883,25,State - DAMAN & DIU,Rural,40-44,Primary,421,255,676
17884,25,State - DAMAN & DIU,Rural,45-49,Primary,365,210,575
17885,25,State - DAMAN & DIU,Rural,50-54,Primary,251,133,384
17886,25,State - DAMAN & DIU,Rural,55-59,Primary,191,69,260
17887,25,State - DAMAN & DIU,Rural,60-64,Primary,116,42,158
17888,25,State - DAMAN & DIU,Rural,65-69,Primary,53,19,72
17889,25,State - DAMAN & DIU,Rural,70-74,Primary,45,6,51
17890,25,State - DAMAN & DIU,Rural,75-79,Primary,13,3,16
17891,25,State - DAMAN & DIU,Rural,80+,Primary,13,6,19
17892,25,State - DAMAN & DIU,Rural,Age not stated,Primary,4,7,11
17893,25,State - DAMAN & DIU,Urban,All ages,Primary,19484,10526,30010
17894,25,State - DAMAN & DIU,Urban,0-6,Primary,0,0,0
17895,25,State - DAMAN & DIU,Urban,7,Primary,0,0,0
17896,25,State - DAMAN & DIU,Urban,8,Primary,0,0,0
17897,25,State - DAMAN & DIU,Urban,9,Primary,98,86,184
17898,25,State - DAMAN & DIU,Urban,10,Primary,395,336,731
17899,25,State - DAMAN & DIU,Urban,11,Primary,828,780,1608
17900,25,State - DAMAN & DIU,Urban,12,Primary,811,723,1534
17901,25,State - DAMAN & DIU,Urban,13,Primary,631,507,1138
17902,25,State - DAMAN & DIU,Urban,14,Primary,333,209,542
17903,25,State - DAMAN & DIU,Urban,15,Primary,301,128,429
17904,25,State - DAMAN & DIU,Urban,16,Primary,359,78,437
17905,25,State - DAMAN & DIU,Urban,17,Primary,496,103,599
17906,25,State - DAMAN & DIU,Urban,18,Primary,1041,151,1192
17907,25,State - DAMAN & DIU,Urban,19,Primary,848,163,1011
17908,25,State - DAMAN & DIU,Urban,20-24,Primary,4383,1143,5526
17909,25,State - DAMAN & DIU,Urban,25-29,Primary,2872,1265,4137
17910,25,State - DAMAN & DIU,Urban,30-34,Primary,1714,1001,2715
17911,25,State - DAMAN & DIU,Urban,35-39,Primary,1288,962,2250
17912,25,State - DAMAN & DIU,Urban,40-44,Primary,917,786,1703
17913,25,State - DAMAN & DIU,Urban,45-49,Primary,644,661,1305
17914,25,State - DAMAN & DIU,Urban,50-54,Primary,427,469,896
17915,25,State - DAMAN & DIU,Urban,55-59,Primary,314,375,689
17916,25,State - DAMAN & DIU,Urban,60-64,Primary,285,283,568
17917,25,State - DAMAN & DIU,Urban,65-69,Primary,201,136,337
17918,25,State - DAMAN & DIU,Urban,70-74,Primary,144,90,234
17919,25,State - DAMAN & DIU,Urban,75-79,Primary,72,44,116
17920,25,State - DAMAN & DIU,Urban,80+,Primary,61,40,101
17921,25,State - DAMAN & DIU,Urban,Age not stated,Primary,21,7,28
17922,26,State - DADRA & NAGAR HAVELI,Total,All ages,Primary,28803,19633,48436
17923,26,State - DADRA & NAGAR HAVELI,Total,0-6,Primary,0,0,0
17924,26,State - DADRA & NAGAR HAVELI,Total,7,Primary,0,0,0
17925,26,State - DADRA & NAGAR HAVELI,Total,8,Primary,0,0,0
17926,26,State - DADRA & NAGAR HAVELI,Total,9,Primary,364,300,664
17927,26,State - DADRA & NAGAR HAVELI,Total,10,Primary,1438,1433,2871
17928,26,State - DADRA & NAGAR HAVELI,Total,11,Primary,2635,2347,4982
17929,26,State - DADRA & NAGAR HAVELI,Total,12,Primary,2668,2298,4966
17930,26,State - DADRA & NAGAR HAVELI,Total,13,Primary,2139,1822,3961
17931,26,State - DADRA & NAGAR HAVELI,Total,14,Primary,1238,993,2231
17932,26,State - DADRA & NAGAR HAVELI,Total,15,Primary,755,600,1355
17933,26,State - DADRA & NAGAR HAVELI,Total,16,Primary,536,412,948
17934,26,State - DADRA & NAGAR HAVELI,Total,17,Primary,568,325,893
17935,26,State - DADRA & NAGAR HAVELI,Total,18,Primary,927,402,1329
17936,26,State - DADRA & NAGAR HAVELI,Total,19,Primary,835,379,1214
17937,26,State - DADRA & NAGAR HAVELI,Total,20-24,Primary,4150,2229,6379
17938,26,State - DADRA & NAGAR HAVELI,Total,25-29,Primary,3101,1836,4937
17939,26,State - DADRA & NAGAR HAVELI,Total,30-34,Primary,2121,1268,3389
17940,26,State - DADRA & NAGAR HAVELI,Total,35-39,Primary,1639,1017,2656
17941,26,State - DADRA & NAGAR HAVELI,Total,40-44,Primary,1148,636,1784
17942,26,State - DADRA & NAGAR HAVELI,Total,45-49,Primary,877,438,1315
17943,26,State - DADRA & NAGAR HAVELI,Total,50-54,Primary,592,288,880
17944,26,State - DADRA & NAGAR HAVELI,Total,55-59,Primary,401,214,615
17945,26,State - DADRA & NAGAR HAVELI,Total,60-64,Primary,287,153,440
17946,26,State - DADRA & NAGAR HAVELI,Total,65-69,Primary,182,98,280
17947,26,State - DADRA & NAGAR HAVELI,Total,70-74,Primary,79,59,138
17948,26,State - DADRA & NAGAR HAVELI,Total,75-79,Primary,30,22,52
17949,26,State - DADRA & NAGAR HAVELI,Total,80+,Primary,67,44,111
17950,26,State - DADRA & NAGAR HAVELI,Total,Age not stated,Primary,26,20,46
17951,26,State - DADRA & NAGAR HAVELI,Rural,All ages,Primary,16288,10399,26687
17952,26,State - DADRA & NAGAR HAVELI,Rural,0-6,Primary,0,0,0
17953,26,State - DADRA & NAGAR HAVELI,Rural,7,Primary,0,0,0
17954,26,State - DADRA & NAGAR HAVELI,Rural,8,Primary,0,0,0
17955,26,State - DADRA & NAGAR HAVELI,Rural,9,Primary,217,172,389
17956,26,State - DADRA & NAGAR HAVELI,Rural,10,Primary,897,886,1783
17957,26,State - DADRA & NAGAR HAVELI,Rural,11,Primary,1673,1463,3136
17958,26,State - DADRA & NAGAR HAVELI,Rural,12,Primary,1663,1430,3093
17959,26,State - DADRA & NAGAR HAVELI,Rural,13,Primary,1389,1230,2619
17960,26,State - DADRA & NAGAR HAVELI,Rural,14,Primary,884,692,1576
17961,26,State - DADRA & NAGAR HAVELI,Rural,15,Primary,538,446,984
17962,26,State - DADRA & NAGAR HAVELI,Rural,16,Primary,398,302,700
17963,26,State - DADRA & NAGAR HAVELI,Rural,17,Primary,357,237,594
17964,26,State - DADRA & NAGAR HAVELI,Rural,18,Primary,474,265,739
17965,26,State - DADRA & NAGAR HAVELI,Rural,19,Primary,441,256,697
17966,26,State - DADRA & NAGAR HAVELI,Rural,20-24,Primary,2220,1148,3368
17967,26,State - DADRA & NAGAR HAVELI,Rural,25-29,Primary,1576,687,2263
17968,26,State - DADRA & NAGAR HAVELI,Rural,30-34,Primary,1065,417,1482
17969,26,State - DADRA & NAGAR HAVELI,Rural,35-39,Primary,798,282,1080
17970,26,State - DADRA & NAGAR HAVELI,Rural,40-44,Primary,532,179,711
17971,26,State - DADRA & NAGAR HAVELI,Rural,45-49,Primary,429,120,549
17972,26,State - DADRA & NAGAR HAVELI,Rural,50-54,Primary,275,62,337
17973,26,State - DADRA & NAGAR HAVELI,Rural,55-59,Primary,192,55,247
17974,26,State - DADRA & NAGAR HAVELI,Rural,60-64,Primary,133,32,165
17975,26,State - DADRA & NAGAR HAVELI,Rural,65-69,Primary,76,16,92
17976,26,State - DADRA & NAGAR HAVELI,Rural,70-74,Primary,29,6,35
17977,26,State - DADRA & NAGAR HAVELI,Rural,75-79,Primary,4,5,9
17978,26,State - DADRA & NAGAR HAVELI,Rural,80+,Primary,19,5,24
17979,26,State - DADRA & NAGAR HAVELI,Rural,Age not stated,Primary,9,6,15
17980,26,State - DADRA & NAGAR HAVELI,Urban,All ages,Primary,12515,9234,21749
17981,26,State - DADRA & NAGAR HAVELI,Urban,0-6,Primary,0,0,0
17982,26,State - DADRA & NAGAR HAVELI,Urban,7,Primary,0,0,0
17983,26,State - DADRA & NAGAR HAVELI,Urban,8,Primary,0,0,0
17984,26,State - DADRA & NAGAR HAVELI,Urban,9,Primary,147,128,275
17985,26,State - DADRA & NAGAR HAVELI,Urban,10,Primary,541,547,1088
17986,26,State - DADRA & NAGAR HAVELI,Urban,11,Primary,962,884,1846
17987,26,State - DADRA & NAGAR HAVELI,Urban,12,Primary,1005,868,1873
17988,26,State - DADRA & NAGAR HAVELI,Urban,13,Primary,750,592,1342
17989,26,State - DADRA & NAGAR HAVELI,Urban,14,Primary,354,301,655
17990,26,State - DADRA & NAGAR HAVELI,Urban,15,Primary,217,154,371
17991,26,State - DADRA & NAGAR HAVELI,Urban,16,Primary,138,110,248
17992,26,State - DADRA & NAGAR HAVELI,Urban,17,Primary,211,88,299
17993,26,State - DADRA & NAGAR HAVELI,Urban,18,Primary,453,137,590
17994,26,State - DADRA & NAGAR HAVELI,Urban,19,Primary,394,123,517
17995,26,State - DADRA & NAGAR HAVELI,Urban,20-24,Primary,1930,1081,3011
17996,26,State - DADRA & NAGAR HAVELI,Urban,25-29,Primary,1525,1149,2674
17997,26,State - DADRA & NAGAR HAVELI,Urban,30-34,Primary,1056,851,1907
17998,26,State - DADRA & NAGAR HAVELI,Urban,35-39,Primary,841,735,1576
17999,26,State - DADRA & NAGAR HAVELI,Urban,40-44,Primary,616,457,1073
18000,26,State - DADRA & NAGAR HAVELI,Urban,45-49,Primary,448,318,766
18001,26,State - DADRA & NAGAR HAVELI,Urban,50-54,Primary,317,226,543
18002,26,State - DADRA & NAGAR HAVELI,Urban,55-59,Primary,209,159,368
18003,26,State - DADRA & NAGAR HAVELI,Urban,60-64,Primary,154,121,275
18004,26,State - DADRA & NAGAR HAVELI,Urban,65-69,Primary,106,82,188
18005,26,State - DADRA & NAGAR HAVELI,Urban,70-74,Primary,50,53,103
18006,26,State - DADRA & NAGAR HAVELI,Urban,75-79,Primary,26,17,43
18007,26,State - DADRA & NAGAR HAVELI,Urban,80+,Primary,48,39,87
18008,26,State - DADRA & NAGAR HAVELI,Urban,Age not stated,Primary,17,14,31
18009,27,State - MAHARASHTRA,Total,All ages,Primary,8346143,8282058,16628201
18010,27,State - MAHARASHTRA,Total,0-6,Primary,0,0,0
18011,27,State - MAHARASHTRA,Total,7,Primary,0,0,0
18012,27,State - MAHARASHTRA,Total,8,Primary,0,0,0
18013,27,State - MAHARASHTRA,Total,9,Primary,55754,53997,109751
18014,27,State - MAHARASHTRA,Total,10,Primary,287777,269479,557256
18015,27,State - MAHARASHTRA,Total,11,Primary,717809,657500,1375309
18016,27,State - MAHARASHTRA,Total,12,Primary,841886,749347,1591233
18017,27,State - MAHARASHTRA,Total,13,Primary,712484,627538,1340022
18018,27,State - MAHARASHTRA,Total,14,Primary,360707,300368,661075
18019,27,State - MAHARASHTRA,Total,15,Primary,180739,146447,327186
18020,27,State - MAHARASHTRA,Total,16,Primary,126589,107464,234053
18021,27,State - MAHARASHTRA,Total,17,Primary,108082,91981,200063
18022,27,State - MAHARASHTRA,Total,18,Primary,147704,128567,276271
18023,27,State - MAHARASHTRA,Total,19,Primary,115559,116498,232057
18024,27,State - MAHARASHTRA,Total,20-24,Primary,682335,743949,1426284
18025,27,State - MAHARASHTRA,Total,25-29,Primary,596103,732972,1329075
18026,27,State - MAHARASHTRA,Total,30-34,Primary,526613,689018,1215631
18027,27,State - MAHARASHTRA,Total,35-39,Primary,513160,688551,1201711
18028,27,State - MAHARASHTRA,Total,40-44,Primary,487454,572716,1060170
18029,27,State - MAHARASHTRA,Total,45-49,Primary,449797,466539,916336
18030,27,State - MAHARASHTRA,Total,50-54,Primary,382560,348563,731123
18031,27,State - MAHARASHTRA,Total,55-59,Primary,285950,261643,547593
18032,27,State - MAHARASHTRA,Total,60-64,Primary,244833,207155,451988
18033,27,State - MAHARASHTRA,Total,65-69,Primary,201411,136373,337784
18034,27,State - MAHARASHTRA,Total,70-74,Primary,148592,76497,225089
18035,27,State - MAHARASHTRA,Total,75-79,Primary,74404,40119,114523
18036,27,State - MAHARASHTRA,Total,80+,Primary,72996,44419,117415
18037,27,State - MAHARASHTRA,Total,Age not stated,Primary,24845,24358,49203
18038,27,State - MAHARASHTRA,Rural,All ages,Primary,4784289,4652611,9436900
18039,27,State - MAHARASHTRA,Rural,0-6,Primary,0,0,0
18040,27,State - MAHARASHTRA,Rural,7,Primary,0,0,0
18041,27,State - MAHARASHTRA,Rural,8,Primary,0,0,0
18042,27,State - MAHARASHTRA,Rural,9,Primary,21969,20337,42306
18043,27,State - MAHARASHTRA,Rural,10,Primary,128700,117982,246682
18044,27,State - MAHARASHTRA,Rural,11,Primary,385967,351353,737320
18045,27,State - MAHARASHTRA,Rural,12,Primary,489931,436487,926418
18046,27,State - MAHARASHTRA,Rural,13,Primary,440159,393524,833683
18047,27,State - MAHARASHTRA,Rural,14,Primary,233532,200060,433592
18048,27,State - MAHARASHTRA,Rural,15,Primary,111693,94346,206039
18049,27,State - MAHARASHTRA,Rural,16,Primary,76281,67904,144185
18050,27,State - MAHARASHTRA,Rural,17,Primary,63121,56633,119754
18051,27,State - MAHARASHTRA,Rural,18,Primary,82988,80034,163022
18052,27,State - MAHARASHTRA,Rural,19,Primary,62967,72708,135675
18053,27,State - MAHARASHTRA,Rural,20-24,Primary,373022,458236,831258
18054,27,State - MAHARASHTRA,Rural,25-29,Primary,319570,436303,755873
18055,27,State - MAHARASHTRA,Rural,30-34,Primary,287279,408521,695800
18056,27,State - MAHARASHTRA,Rural,35-39,Primary,286232,394365,680597
18057,27,State - MAHARASHTRA,Rural,40-44,Primary,278366,311976,590342
18058,27,State - MAHARASHTRA,Rural,45-49,Primary,261386,237582,498968
18059,27,State - MAHARASHTRA,Rural,50-54,Primary,226975,172351,399326
18060,27,State - MAHARASHTRA,Rural,55-59,Primary,173377,123946,297323
18061,27,State - MAHARASHTRA,Rural,60-64,Primary,149418,92986,242404
18062,27,State - MAHARASHTRA,Rural,65-69,Primary,133017,58930,191947
18063,27,State - MAHARASHTRA,Rural,70-74,Primary,96924,26946,123870
18064,27,State - MAHARASHTRA,Rural,75-79,Primary,46283,11592,57875
18065,27,State - MAHARASHTRA,Rural,80+,Primary,42241,14880,57121
18066,27,State - MAHARASHTRA,Rural,Age not stated,Primary,12891,12629,25520
18067,27,State - MAHARASHTRA,Urban,All ages,Primary,3561854,3629447,7191301
18068,27,State - MAHARASHTRA,Urban,0-6,Primary,0,0,0
18069,27,State - MAHARASHTRA,Urban,7,Primary,0,0,0
18070,27,State - MAHARASHTRA,Urban,8,Primary,0,0,0
18071,27,State - MAHARASHTRA,Urban,9,Primary,33785,33660,67445
18072,27,State - MAHARASHTRA,Urban,10,Primary,159077,151497,310574
18073,27,State - MAHARASHTRA,Urban,11,Primary,331842,306147,637989
18074,27,State - MAHARASHTRA,Urban,12,Primary,351955,312860,664815
18075,27,State - MAHARASHTRA,Urban,13,Primary,272325,234014,506339
18076,27,State - MAHARASHTRA,Urban,14,Primary,127175,100308,227483
18077,27,State - MAHARASHTRA,Urban,15,Primary,69046,52101,121147
18078,27,State - MAHARASHTRA,Urban,16,Primary,50308,39560,89868
18079,27,State - MAHARASHTRA,Urban,17,Primary,44961,35348,80309
18080,27,State - MAHARASHTRA,Urban,18,Primary,64716,48533,113249
18081,27,State - MAHARASHTRA,Urban,19,Primary,52592,43790,96382
18082,27,State - MAHARASHTRA,Urban,20-24,Primary,309313,285713,595026
18083,27,State - MAHARASHTRA,Urban,25-29,Primary,276533,296669,573202
18084,27,State - MAHARASHTRA,Urban,30-34,Primary,239334,280497,519831
18085,27,State - MAHARASHTRA,Urban,35-39,Primary,226928,294186,521114
18086,27,State - MAHARASHTRA,Urban,40-44,Primary,209088,260740,469828
18087,27,State - MAHARASHTRA,Urban,45-49,Primary,188411,228957,417368
18088,27,State - MAHARASHTRA,Urban,50-54,Primary,155585,176212,331797
18089,27,State - MAHARASHTRA,Urban,55-59,Primary,112573,137697,250270
18090,27,State - MAHARASHTRA,Urban,60-64,Primary,95415,114169,209584
18091,27,State - MAHARASHTRA,Urban,65-69,Primary,68394,77443,145837
18092,27,State - MAHARASHTRA,Urban,70-74,Primary,51668,49551,101219
18093,27,State - MAHARASHTRA,Urban,75-79,Primary,28121,28527,56648
18094,27,State - MAHARASHTRA,Urban,80+,Primary,30755,29539,60294
18095,27,State - MAHARASHTRA,Urban,Age not stated,Primary,11954,11729,23683
18096,28,State - ANDHRA PRADESH,Total,All ages,Primary,6904114,6545186,13449300
18097,28,State - ANDHRA PRADESH,Total,0-6,Primary,0,0,0
18098,28,State - ANDHRA PRADESH,Total,7,Primary,0,0,0
18099,28,State - ANDHRA PRADESH,Total,8,Primary,0,0,0
18100,28,State - ANDHRA PRADESH,Total,9,Primary,105582,113053,218635
18101,28,State - ANDHRA PRADESH,Total,10,Primary,390935,402267,793202
18102,28,State - ANDHRA PRADESH,Total,11,Primary,564858,572760,1137618
18103,28,State - ANDHRA PRADESH,Total,12,Primary,600483,561055,1161538
18104,28,State - ANDHRA PRADESH,Total,13,Primary,372421,324745,697166
18105,28,State - ANDHRA PRADESH,Total,14,Primary,182942,148939,331881
18106,28,State - ANDHRA PRADESH,Total,15,Primary,116186,98537,214723
18107,28,State - ANDHRA PRADESH,Total,16,Primary,91964,83491,175455
18108,28,State - ANDHRA PRADESH,Total,17,Primary,81512,74028,155540
18109,28,State - ANDHRA PRADESH,Total,18,Primary,121424,129099,250523
18110,28,State - ANDHRA PRADESH,Total,19,Primary,92673,106012,198685
18111,28,State - ANDHRA PRADESH,Total,20-24,Primary,586486,683913,1270399
18112,28,State - ANDHRA PRADESH,Total,25-29,Primary,627414,724117,1351531
18113,28,State - ANDHRA PRADESH,Total,30-34,Primary,539873,563691,1103564
18114,28,State - ANDHRA PRADESH,Total,35-39,Primary,514112,511413,1025525
18115,28,State - ANDHRA PRADESH,Total,40-44,Primary,422203,351829,774032
18116,28,State - ANDHRA PRADESH,Total,45-49,Primary,374395,299436,673831
18117,28,State - ANDHRA PRADESH,Total,50-54,Primary,299242,216063,515305
18118,28,State - ANDHRA PRADESH,Total,55-59,Primary,214558,173655,388213
18119,28,State - ANDHRA PRADESH,Total,60-64,Primary,216286,153824,370110
18120,28,State - ANDHRA PRADESH,Total,65-69,Primary,153894,94821,248715
18121,28,State - ANDHRA PRADESH,Total,70-74,Primary,99750,54149,153899
18122,28,State - ANDHRA PRADESH,Total,75-79,Primary,44854,27962,72816
18123,28,State - ANDHRA PRADESH,Total,80+,Primary,46497,32633,79130
18124,28,State - ANDHRA PRADESH,Total,Age not stated,Primary,43570,43694,87264
18125,28,State - ANDHRA PRADESH,Rural,All ages,Primary,4848653,4308846,9157499
18126,28,State - ANDHRA PRADESH,Rural,0-6,Primary,0,0,0
18127,28,State - ANDHRA PRADESH,Rural,7,Primary,0,0,0
18128,28,State - ANDHRA PRADESH,Rural,8,Primary,0,0,0
18129,28,State - ANDHRA PRADESH,Rural,9,Primary,66429,71080,137509
18130,28,State - ANDHRA PRADESH,Rural,10,Primary,260845,267581,528426
18131,28,State - ANDHRA PRADESH,Rural,11,Primary,377095,380521,757616
18132,28,State - ANDHRA PRADESH,Rural,12,Primary,420074,389202,809276
18133,28,State - ANDHRA PRADESH,Rural,13,Primary,259047,226549,485596
18134,28,State - ANDHRA PRADESH,Rural,14,Primary,127602,105395,232997
18135,28,State - ANDHRA PRADESH,Rural,15,Primary,82786,72379,155165
18136,28,State - ANDHRA PRADESH,Rural,16,Primary,66840,62637,129477
18137,28,State - ANDHRA PRADESH,Rural,17,Primary,58696,53322,112018
18138,28,State - ANDHRA PRADESH,Rural,18,Primary,91947,97840,189787
18139,28,State - ANDHRA PRADESH,Rural,19,Primary,67487,77220,144707
18140,28,State - ANDHRA PRADESH,Rural,20-24,Primary,429886,492168,922054
18141,28,State - ANDHRA PRADESH,Rural,25-29,Primary,453621,504553,958174
18142,28,State - ANDHRA PRADESH,Rural,30-34,Primary,387471,379299,766770
18143,28,State - ANDHRA PRADESH,Rural,35-39,Primary,364205,325774,689979
18144,28,State - ANDHRA PRADESH,Rural,40-44,Primary,294504,208695,503199
18145,28,State - ANDHRA PRADESH,Rural,45-49,Primary,256904,167423,424327
18146,28,State - ANDHRA PRADESH,Rural,50-54,Primary,205302,115820,321122
18147,28,State - ANDHRA PRADESH,Rural,55-59,Primary,147303,95044,242347
18148,28,State - ANDHRA PRADESH,Rural,60-64,Primary,154568,85560,240128
18149,28,State - ANDHRA PRADESH,Rural,65-69,Primary,113903,50872,164775
18150,28,State - ANDHRA PRADESH,Rural,70-74,Primary,73074,27854,100928
18151,28,State - ANDHRA PRADESH,Rural,75-79,Primary,31896,13409,45305
18152,28,State - ANDHRA PRADESH,Rural,80+,Primary,32088,15894,47982
18153,28,State - ANDHRA PRADESH,Rural,Age not stated,Primary,25080,22755,47835
18154,28,State - ANDHRA PRADESH,Urban,All ages,Primary,2055461,2236340,4291801
18155,28,State - ANDHRA PRADESH,Urban,0-6,Primary,0,0,0
18156,28,State - ANDHRA PRADESH,Urban,7,Primary,0,0,0
18157,28,State - ANDHRA PRADESH,Urban,8,Primary,0,0,0
18158,28,State - ANDHRA PRADESH,Urban,9,Primary,39153,41973,81126
18159,28,State - ANDHRA PRADESH,Urban,10,Primary,130090,134686,264776
18160,28,State - ANDHRA PRADESH,Urban,11,Primary,187763,192239,380002
18161,28,State - ANDHRA PRADESH,Urban,12,Primary,180409,171853,352262
18162,28,State - ANDHRA PRADESH,Urban,13,Primary,113374,98196,211570
18163,28,State - ANDHRA PRADESH,Urban,14,Primary,55340,43544,98884
18164,28,State - ANDHRA PRADESH,Urban,15,Primary,33400,26158,59558
18165,28,State - ANDHRA PRADESH,Urban,16,Primary,25124,20854,45978
18166,28,State - ANDHRA PRADESH,Urban,17,Primary,22816,20706,43522
18167,28,State - ANDHRA PRADESH,Urban,18,Primary,29477,31259,60736
18168,28,State - ANDHRA PRADESH,Urban,19,Primary,25186,28792,53978
18169,28,State - ANDHRA PRADESH,Urban,20-24,Primary,156600,191745,348345
18170,28,State - ANDHRA PRADESH,Urban,25-29,Primary,173793,219564,393357
18171,28,State - ANDHRA PRADESH,Urban,30-34,Primary,152402,184392,336794
18172,28,State - ANDHRA PRADESH,Urban,35-39,Primary,149907,185639,335546
18173,28,State - ANDHRA PRADESH,Urban,40-44,Primary,127699,143134,270833
18174,28,State - ANDHRA PRADESH,Urban,45-49,Primary,117491,132013,249504
18175,28,State - ANDHRA PRADESH,Urban,50-54,Primary,93940,100243,194183
18176,28,State - ANDHRA PRADESH,Urban,55-59,Primary,67255,78611,145866
18177,28,State - ANDHRA PRADESH,Urban,60-64,Primary,61718,68264,129982
18178,28,State - ANDHRA PRADESH,Urban,65-69,Primary,39991,43949,83940
18179,28,State - ANDHRA PRADESH,Urban,70-74,Primary,26676,26295,52971
18180,28,State - ANDHRA PRADESH,Urban,75-79,Primary,12958,14553,27511
18181,28,State - ANDHRA PRADESH,Urban,80+,Primary,14409,16739,31148
18182,28,State - ANDHRA PRADESH,Urban,Age not stated,Primary,18490,20939,39429
18183,29,State - KARNATAKA,Total,All ages,Primary,4944027,4549079,9493106
18184,29,State - KARNATAKA,Total,0-6,Primary,0,0,0
18185,29,State - KARNATAKA,Total,7,Primary,0,0,0
18186,29,State - KARNATAKA,Total,8,Primary,0,0,0
18187,29,State - KARNATAKA,Total,9,Primary,34873,36559,71432
18188,29,State - KARNATAKA,Total,10,Primary,170436,170971,341407
18189,29,State - KARNATAKA,Total,11,Primary,397308,388180,785488
18190,29,State - KARNATAKA,Total,12,Primary,473113,440787,913900
18191,29,State - KARNATAKA,Total,13,Primary,357775,318051,675826
18192,29,State - KARNATAKA,Total,14,Primary,172012,141672,313684
18193,29,State - KARNATAKA,Total,15,Primary,81171,65543,146714
18194,29,State - KARNATAKA,Total,16,Primary,67675,56106,123781
18195,29,State - KARNATAKA,Total,17,Primary,59681,49206,108887
18196,29,State - KARNATAKA,Total,18,Primary,96935,85532,182467
18197,29,State - KARNATAKA,Total,19,Primary,71441,71673,143114
18198,29,State - KARNATAKA,Total,20-24,Primary,454093,453047,907140
18199,29,State - KARNATAKA,Total,25-29,Primary,443364,481041,924405
18200,29,State - KARNATAKA,Total,30-34,Primary,343832,368811,712643
18201,29,State - KARNATAKA,Total,35-39,Primary,334791,363391,698182
18202,29,State - KARNATAKA,Total,40-44,Primary,291870,261799,553669
18203,29,State - KARNATAKA,Total,45-49,Primary,288368,237616,525984
18204,29,State - KARNATAKA,Total,50-54,Primary,220717,167023,387740
18205,29,State - KARNATAKA,Total,55-59,Primary,166870,129819,296689
18206,29,State - KARNATAKA,Total,60-64,Primary,149010,102679,251689
18207,29,State - KARNATAKA,Total,65-69,Primary,112210,69809,182019
18208,29,State - KARNATAKA,Total,70-74,Primary,76670,40837,117507
18209,29,State - KARNATAKA,Total,75-79,Primary,38126,22471,60597
18210,29,State - KARNATAKA,Total,80+,Primary,38991,23998,62989
18211,29,State - KARNATAKA,Total,Age not stated,Primary,2695,2458,5153
18212,29,State - KARNATAKA,Rural,All ages,Primary,3241250,2811706,6052956
18213,29,State - KARNATAKA,Rural,0-6,Primary,0,0,0
18214,29,State - KARNATAKA,Rural,7,Primary,0,0,0
18215,29,State - KARNATAKA,Rural,8,Primary,0,0,0
18216,29,State - KARNATAKA,Rural,9,Primary,18625,19316,37941
18217,29,State - KARNATAKA,Rural,10,Primary,95963,94851,190814
18218,29,State - KARNATAKA,Rural,11,Primary,246815,237040,483855
18219,29,State - KARNATAKA,Rural,12,Primary,306829,282594,589423
18220,29,State - KARNATAKA,Rural,13,Primary,238380,211113,449493
18221,29,State - KARNATAKA,Rural,14,Primary,118450,99314,217764
18222,29,State - KARNATAKA,Rural,15,Primary,55160,47036,102196
18223,29,State - KARNATAKA,Rural,16,Primary,47507,40799,88306
18224,29,State - KARNATAKA,Rural,17,Primary,40650,34770,75420
18225,29,State - KARNATAKA,Rural,18,Primary,68414,61473,129887
18226,29,State - KARNATAKA,Rural,19,Primary,48386,49817,98203
18227,29,State - KARNATAKA,Rural,20-24,Primary,308116,307870,615986
18228,29,State - KARNATAKA,Rural,25-29,Primary,293911,314024,607935
18229,29,State - KARNATAKA,Rural,30-34,Primary,221352,233521,454873
18230,29,State - KARNATAKA,Rural,35-39,Primary,212227,220166,432393
18231,29,State - KARNATAKA,Rural,40-44,Primary,189206,152813,342019
18232,29,State - KARNATAKA,Rural,45-49,Primary,188270,131499,319769
18233,29,State - KARNATAKA,Rural,50-54,Primary,145730,88276,234006
18234,29,State - KARNATAKA,Rural,55-59,Primary,111127,67138,178265
18235,29,State - KARNATAKA,Rural,60-64,Primary,101710,49821,151531
18236,29,State - KARNATAKA,Rural,65-69,Primary,78608,32230,110838
18237,29,State - KARNATAKA,Rural,70-74,Primary,53143,17003,70146
18238,29,State - KARNATAKA,Rural,75-79,Primary,25715,8430,34145
18239,29,State - KARNATAKA,Rural,80+,Primary,25111,9230,34341
18240,29,State - KARNATAKA,Rural,Age not stated,Primary,1845,1562,3407
18241,29,State - KARNATAKA,Urban,All ages,Primary,1702777,1737373,3440150
18242,29,State - KARNATAKA,Urban,0-6,Primary,0,0,0
18243,29,State - KARNATAKA,Urban,7,Primary,0,0,0
18244,29,State - KARNATAKA,Urban,8,Primary,0,0,0
18245,29,State - KARNATAKA,Urban,9,Primary,16248,17243,33491
18246,29,State - KARNATAKA,Urban,10,Primary,74473,76120,150593
18247,29,State - KARNATAKA,Urban,11,Primary,150493,151140,301633
18248,29,State - KARNATAKA,Urban,12,Primary,166284,158193,324477
18249,29,State - KARNATAKA,Urban,13,Primary,119395,106938,226333
18250,29,State - KARNATAKA,Urban,14,Primary,53562,42358,95920
18251,29,State - KARNATAKA,Urban,15,Primary,26011,18507,44518
18252,29,State - KARNATAKA,Urban,16,Primary,20168,15307,35475
18253,29,State - KARNATAKA,Urban,17,Primary,19031,14436,33467
18254,29,State - KARNATAKA,Urban,18,Primary,28521,24059,52580
18255,29,State - KARNATAKA,Urban,19,Primary,23055,21856,44911
18256,29,State - KARNATAKA,Urban,20-24,Primary,145977,145177,291154
18257,29,State - KARNATAKA,Urban,25-29,Primary,149453,167017,316470
18258,29,State - KARNATAKA,Urban,30-34,Primary,122480,135290,257770
18259,29,State - KARNATAKA,Urban,35-39,Primary,122564,143225,265789
18260,29,State - KARNATAKA,Urban,40-44,Primary,102664,108986,211650
18261,29,State - KARNATAKA,Urban,45-49,Primary,100098,106117,206215
18262,29,State - KARNATAKA,Urban,50-54,Primary,74987,78747,153734
18263,29,State - KARNATAKA,Urban,55-59,Primary,55743,62681,118424
18264,29,State - KARNATAKA,Urban,60-64,Primary,47300,52858,100158
18265,29,State - KARNATAKA,Urban,65-69,Primary,33602,37579,71181
18266,29,State - KARNATAKA,Urban,70-74,Primary,23527,23834,47361
18267,29,State - KARNATAKA,Urban,75-79,Primary,12411,14041,26452
18268,29,State - KARNATAKA,Urban,80+,Primary,13880,14768,28648
18269,29,State - KARNATAKA,Urban,Age not stated,Primary,850,896,1746
18270,30,State - GOA,Total,All ages,Primary,94300,87195,181495
18271,30,State - GOA,Total,0-6,Primary,0,0,0
18272,30,State - GOA,Total,7,Primary,0,0,0
18273,30,State - GOA,Total,8,Primary,0,0,0
18274,30,State - GOA,Total,9,Primary,521,522,1043
18275,30,State - GOA,Total,10,Primary,3222,3156,6378
18276,30,State - GOA,Total,11,Primary,7827,7558,15385
18277,30,State - GOA,Total,12,Primary,8928,8248,17176
18278,30,State - GOA,Total,13,Primary,7447,6968,14415
18279,30,State - GOA,Total,14,Primary,3943,3080,7023
18280,30,State - GOA,Total,15,Primary,2081,1444,3525
18281,30,State - GOA,Total,16,Primary,1333,926,2259
18282,30,State - GOA,Total,17,Primary,1039,804,1843
18283,30,State - GOA,Total,18,Primary,1357,949,2306
18284,30,State - GOA,Total,19,Primary,1191,899,2090
18285,30,State - GOA,Total,20-24,Primary,7127,5696,12823
18286,30,State - GOA,Total,25-29,Primary,7053,6221,13274
18287,30,State - GOA,Total,30-34,Primary,6360,6255,12615
18288,30,State - GOA,Total,35-39,Primary,6414,6947,13361
18289,30,State - GOA,Total,40-44,Primary,5793,5943,11736
18290,30,State - GOA,Total,45-49,Primary,5677,5863,11540
18291,30,State - GOA,Total,50-54,Primary,4775,4420,9195
18292,30,State - GOA,Total,55-59,Primary,3845,3712,7557
18293,30,State - GOA,Total,60-64,Primary,3398,2882,6280
18294,30,State - GOA,Total,65-69,Primary,1963,1824,3787
18295,30,State - GOA,Total,70-74,Primary,1449,1259,2708
18296,30,State - GOA,Total,75-79,Primary,812,803,1615
18297,30,State - GOA,Total,80+,Primary,666,735,1401
18298,30,State - GOA,Total,Age not stated,Primary,79,81,160
18299,30,State - GOA,Rural,All ages,Primary,37650,35103,72753
18300,30,State - GOA,Rural,0-6,Primary,0,0,0
18301,30,State - GOA,Rural,7,Primary,0,0,0
18302,30,State - GOA,Rural,8,Primary,0,0,0
18303,30,State - GOA,Rural,9,Primary,181,174,355
18304,30,State - GOA,Rural,10,Primary,1099,1146,2245
18305,30,State - GOA,Rural,11,Primary,2783,2865,5648
18306,30,State - GOA,Rural,12,Primary,3320,3093,6413
18307,30,State - GOA,Rural,13,Primary,2926,2737,5663
18308,30,State - GOA,Rural,14,Primary,1635,1258,2893
18309,30,State - GOA,Rural,15,Primary,865,650,1515
18310,30,State - GOA,Rural,16,Primary,527,391,918
18311,30,State - GOA,Rural,17,Primary,419,375,794
18312,30,State - GOA,Rural,18,Primary,497,377,874
18313,30,State - GOA,Rural,19,Primary,466,355,821
18314,30,State - GOA,Rural,20-24,Primary,2720,2378,5098
18315,30,State - GOA,Rural,25-29,Primary,2753,2693,5446
18316,30,State - GOA,Rural,30-34,Primary,2634,2878,5512
18317,30,State - GOA,Rural,35-39,Primary,2760,3114,5874
18318,30,State - GOA,Rural,40-44,Primary,2460,2573,5033
18319,30,State - GOA,Rural,45-49,Primary,2473,2434,4907
18320,30,State - GOA,Rural,50-54,Primary,2086,1720,3806
18321,30,State - GOA,Rural,55-59,Primary,1757,1383,3140
18322,30,State - GOA,Rural,60-64,Primary,1406,1040,2446
18323,30,State - GOA,Rural,65-69,Primary,781,619,1400
18324,30,State - GOA,Rural,70-74,Primary,510,358,868
18325,30,State - GOA,Rural,75-79,Primary,293,234,527
18326,30,State - GOA,Rural,80+,Primary,267,222,489
18327,30,State - GOA,Rural,Age not stated,Primary,32,36,68
18328,30,State - GOA,Urban,All ages,Primary,56650,52092,108742
18329,30,State - GOA,Urban,0-6,Primary,0,0,0
18330,30,State - GOA,Urban,7,Primary,0,0,0
18331,30,State - GOA,Urban,8,Primary,0,0,0
18332,30,State - GOA,Urban,9,Primary,340,348,688
18333,30,State - GOA,Urban,10,Primary,2123,2010,4133
18334,30,State - GOA,Urban,11,Primary,5044,4693,9737
18335,30,State - GOA,Urban,12,Primary,5608,5155,10763
18336,30,State - GOA,Urban,13,Primary,4521,4231,8752
18337,30,State - GOA,Urban,14,Primary,2308,1822,4130
18338,30,State - GOA,Urban,15,Primary,1216,794,2010
18339,30,State - GOA,Urban,16,Primary,806,535,1341
18340,30,State - GOA,Urban,17,Primary,620,429,1049
18341,30,State - GOA,Urban,18,Primary,860,572,1432
18342,30,State - GOA,Urban,19,Primary,725,544,1269
18343,30,State - GOA,Urban,20-24,Primary,4407,3318,7725
18344,30,State - GOA,Urban,25-29,Primary,4300,3528,7828
18345,30,State - GOA,Urban,30-34,Primary,3726,3377,7103
18346,30,State - GOA,Urban,35-39,Primary,3654,3833,7487
18347,30,State - GOA,Urban,40-44,Primary,3333,3370,6703
18348,30,State - GOA,Urban,45-49,Primary,3204,3429,6633
18349,30,State - GOA,Urban,50-54,Primary,2689,2700,5389
18350,30,State - GOA,Urban,55-59,Primary,2088,2329,4417
18351,30,State - GOA,Urban,60-64,Primary,1992,1842,3834
18352,30,State - GOA,Urban,65-69,Primary,1182,1205,2387
18353,30,State - GOA,Urban,70-74,Primary,939,901,1840
18354,30,State - GOA,Urban,75-79,Primary,519,569,1088
18355,30,State - GOA,Urban,80+,Primary,399,513,912
18356,30,State - GOA,Urban,Age not stated,Primary,47,45,92
18357,31,State - LAKSHADWEEP,Total,All ages,Primary,6500,6313,12813
18358,31,State - LAKSHADWEEP,Total,0-6,Primary,0,0,0
18359,31,State - LAKSHADWEEP,Total,7,Primary,0,0,0
18360,31,State - LAKSHADWEEP,Total,8,Primary,0,0,0
18361,31,State - LAKSHADWEEP,Total,9,Primary,25,33,58
18362,31,State - LAKSHADWEEP,Total,10,Primary,151,192,343
18363,31,State - LAKSHADWEEP,Total,11,Primary,402,470,872
18364,31,State - LAKSHADWEEP,Total,12,Primary,471,558,1029
18365,31,State - LAKSHADWEEP,Total,13,Primary,438,544,982
18366,31,State - LAKSHADWEEP,Total,14,Primary,279,265,544
18367,31,State - LAKSHADWEEP,Total,15,Primary,143,84,227
18368,31,State - LAKSHADWEEP,Total,16,Primary,72,46,118
18369,31,State - LAKSHADWEEP,Total,17,Primary,41,30,71
18370,31,State - LAKSHADWEEP,Total,18,Primary,52,21,73
18371,31,State - LAKSHADWEEP,Total,19,Primary,61,53,114
18372,31,State - LAKSHADWEEP,Total,20-24,Primary,342,280,622
18373,31,State - LAKSHADWEEP,Total,25-29,Primary,486,489,975
18374,31,State - LAKSHADWEEP,Total,30-34,Primary,531,655,1186
18375,31,State - LAKSHADWEEP,Total,35-39,Primary,657,790,1447
18376,31,State - LAKSHADWEEP,Total,40-44,Primary,617,618,1235
18377,31,State - LAKSHADWEEP,Total,45-49,Primary,405,460,865
18378,31,State - LAKSHADWEEP,Total,50-54,Primary,361,328,689
18379,31,State - LAKSHADWEEP,Total,55-59,Primary,417,243,660
18380,31,State - LAKSHADWEEP,Total,60-64,Primary,261,107,368
18381,31,State - LAKSHADWEEP,Total,65-69,Primary,144,23,167
18382,31,State - LAKSHADWEEP,Total,70-74,Primary,64,7,71
18383,31,State - LAKSHADWEEP,Total,75-79,Primary,33,4,37
18384,31,State - LAKSHADWEEP,Total,80+,Primary,34,7,41
18385,31,State - LAKSHADWEEP,Total,Age not stated,Primary,13,6,19
18386,31,State - LAKSHADWEEP,Rural,All ages,Primary,1522,1533,3055
18387,31,State - LAKSHADWEEP,Rural,0-6,Primary,0,0,0
18388,31,State - LAKSHADWEEP,Rural,7,Primary,0,0,0
18389,31,State - LAKSHADWEEP,Rural,8,Primary,0,0,0
18390,31,State - LAKSHADWEEP,Rural,9,Primary,6,11,17
18391,31,State - LAKSHADWEEP,Rural,10,Primary,23,47,70
18392,31,State - LAKSHADWEEP,Rural,11,Primary,95,116,211
18393,31,State - LAKSHADWEEP,Rural,12,Primary,103,111,214
18394,31,State - LAKSHADWEEP,Rural,13,Primary,82,138,220
18395,31,State - LAKSHADWEEP,Rural,14,Primary,42,87,129
18396,31,State - LAKSHADWEEP,Rural,15,Primary,41,21,62
18397,31,State - LAKSHADWEEP,Rural,16,Primary,15,9,24
18398,31,State - LAKSHADWEEP,Rural,17,Primary,12,7,19
18399,31,State - LAKSHADWEEP,Rural,18,Primary,16,6,22
18400,31,State - LAKSHADWEEP,Rural,19,Primary,16,12,28
18401,31,State - LAKSHADWEEP,Rural,20-24,Primary,111,72,183
18402,31,State - LAKSHADWEEP,Rural,25-29,Primary,125,118,243
18403,31,State - LAKSHADWEEP,Rural,30-34,Primary,115,156,271
18404,31,State - LAKSHADWEEP,Rural,35-39,Primary,165,178,343
18405,31,State - LAKSHADWEEP,Rural,40-44,Primary,145,135,280
18406,31,State - LAKSHADWEEP,Rural,45-49,Primary,75,94,169
18407,31,State - LAKSHADWEEP,Rural,50-54,Primary,92,89,181
18408,31,State - LAKSHADWEEP,Rural,55-59,Primary,97,77,174
18409,31,State - LAKSHADWEEP,Rural,60-64,Primary,70,38,108
18410,31,State - LAKSHADWEEP,Rural,65-69,Primary,45,8,53
18411,31,State - LAKSHADWEEP,Rural,70-74,Primary,13,1,14
18412,31,State - LAKSHADWEEP,Rural,75-79,Primary,8,1,9
18413,31,State - LAKSHADWEEP,Rural,80+,Primary,6,0,6
18414,31,State - LAKSHADWEEP,Rural,Age not stated,Primary,4,1,5
18415,31,State - LAKSHADWEEP,Urban,All ages,Primary,4978,4780,9758
18416,31,State - LAKSHADWEEP,Urban,0-6,Primary,0,0,0
18417,31,State - LAKSHADWEEP,Urban,7,Primary,0,0,0
18418,31,State - LAKSHADWEEP,Urban,8,Primary,0,0,0
18419,31,State - LAKSHADWEEP,Urban,9,Primary,19,22,41
18420,31,State - LAKSHADWEEP,Urban,10,Primary,128,145,273
18421,31,State - LAKSHADWEEP,Urban,11,Primary,307,354,661
18422,31,State - LAKSHADWEEP,Urban,12,Primary,368,447,815
18423,31,State - LAKSHADWEEP,Urban,13,Primary,356,406,762
18424,31,State - LAKSHADWEEP,Urban,14,Primary,237,178,415
18425,31,State - LAKSHADWEEP,Urban,15,Primary,102,63,165
18426,31,State - LAKSHADWEEP,Urban,16,Primary,57,37,94
18427,31,State - LAKSHADWEEP,Urban,17,Primary,29,23,52
18428,31,State - LAKSHADWEEP,Urban,18,Primary,36,15,51
18429,31,State - LAKSHADWEEP,Urban,19,Primary,45,41,86
18430,31,State - LAKSHADWEEP,Urban,20-24,Primary,231,208,439
18431,31,State - LAKSHADWEEP,Urban,25-29,Primary,361,371,732
18432,31,State - LAKSHADWEEP,Urban,30-34,Primary,416,499,915
18433,31,State - LAKSHADWEEP,Urban,35-39,Primary,492,612,1104
18434,31,State - LAKSHADWEEP,Urban,40-44,Primary,472,483,955
18435,31,State - LAKSHADWEEP,Urban,45-49,Primary,330,366,696
18436,31,State - LAKSHADWEEP,Urban,50-54,Primary,269,239,508
18437,31,State - LAKSHADWEEP,Urban,55-59,Primary,320,166,486
18438,31,State - LAKSHADWEEP,Urban,60-64,Primary,191,69,260
18439,31,State - LAKSHADWEEP,Urban,65-69,Primary,99,15,114
18440,31,State - LAKSHADWEEP,Urban,70-74,Primary,51,6,57
18441,31,State - LAKSHADWEEP,Urban,75-79,Primary,25,3,28
18442,31,State - LAKSHADWEEP,Urban,80+,Primary,28,7,35
18443,31,State - LAKSHADWEEP,Urban,Age not stated,Primary,9,5,14
18444,32,State - KERALA,Total,All ages,Primary,2522296,2543414,5065710
18445,32,State - KERALA,Total,0-6,Primary,0,0,0
18446,32,State - KERALA,Total,7,Primary,0,0,0
18447,32,State - KERALA,Total,8,Primary,0,0,0
18448,32,State - KERALA,Total,9,Primary,14671,15431,30102
18449,32,State - KERALA,Total,10,Primary,88828,92874,181702
18450,32,State - KERALA,Total,11,Primary,219052,222769,441821
18451,32,State - KERALA,Total,12,Primary,242501,232829,475330
18452,32,State - KERALA,Total,13,Primary,198346,179459,377805
18453,32,State - KERALA,Total,14,Primary,70648,48595,119243
18454,32,State - KERALA,Total,15,Primary,19228,9634,28862
18455,32,State - KERALA,Total,16,Primary,7539,3802,11341
18456,32,State - KERALA,Total,17,Primary,5691,2951,8642
18457,32,State - KERALA,Total,18,Primary,7186,3829,11015
18458,32,State - KERALA,Total,19,Primary,7375,4192,11567
18459,32,State - KERALA,Total,20-24,Primary,55630,34585,90215
18460,32,State - KERALA,Total,25-29,Primary,96714,70052,166766
18461,32,State - KERALA,Total,30-34,Primary,118099,114009,232108
18462,32,State - KERALA,Total,35-39,Primary,165923,196551,362474
18463,32,State - KERALA,Total,40-44,Primary,182417,215024,397441
18464,32,State - KERALA,Total,45-49,Primary,213292,248766,462058
18465,32,State - KERALA,Total,50-54,Primary,203102,214268,417370
18466,32,State - KERALA,Total,55-59,Primary,192681,185412,378093
18467,32,State - KERALA,Total,60-64,Primary,153579,154651,308230
18468,32,State - KERALA,Total,65-69,Primary,100936,109702,210638
18469,32,State - KERALA,Total,70-74,Primary,71684,78097,149781
18470,32,State - KERALA,Total,75-79,Primary,43136,51841,94977
18471,32,State - KERALA,Total,80+,Primary,42448,52318,94766
18472,32,State - KERALA,Total,Age not stated,Primary,1590,1773,3363
18473,32,State - KERALA,Rural,All ages,Primary,1369388,1357288,2726676
18474,32,State - KERALA,Rural,0-6,Primary,0,0,0
18475,32,State - KERALA,Rural,7,Primary,0,0,0
18476,32,State - KERALA,Rural,8,Primary,0,0,0
18477,32,State - KERALA,Rural,9,Primary,7774,8142,15916
18478,32,State - KERALA,Rural,10,Primary,46839,48938,95777
18479,32,State - KERALA,Rural,11,Primary,114648,116727,231375
18480,32,State - KERALA,Rural,12,Primary,128764,124316,253080
18481,32,State - KERALA,Rural,13,Primary,105440,96172,201612
18482,32,State - KERALA,Rural,14,Primary,38564,26980,65544
18483,32,State - KERALA,Rural,15,Primary,10993,5619,16612
18484,32,State - KERALA,Rural,16,Primary,4330,2332,6662
18485,32,State - KERALA,Rural,17,Primary,3333,1837,5170
18486,32,State - KERALA,Rural,18,Primary,4280,2478,6758
18487,32,State - KERALA,Rural,19,Primary,4267,2577,6844
18488,32,State - KERALA,Rural,20-24,Primary,32278,21769,54047
18489,32,State - KERALA,Rural,25-29,Primary,56003,41980,97983
18490,32,State - KERALA,Rural,30-34,Primary,65949,63667,129616
18491,32,State - KERALA,Rural,35-39,Primary,91984,106624,198608
18492,32,State - KERALA,Rural,40-44,Primary,98952,112420,211372
18493,32,State - KERALA,Rural,45-49,Primary,116551,131136,247687
18494,32,State - KERALA,Rural,50-54,Primary,110853,112812,223665
18495,32,State - KERALA,Rural,55-59,Primary,104040,97705,201745
18496,32,State - KERALA,Rural,60-64,Primary,81002,79724,160726
18497,32,State - KERALA,Rural,65-69,Primary,54704,57693,112397
18498,32,State - KERALA,Rural,70-74,Primary,38653,40742,79395
18499,32,State - KERALA,Rural,75-79,Primary,23999,26900,50899
18500,32,State - KERALA,Rural,80+,Primary,24326,27069,51395
18501,32,State - KERALA,Rural,Age not stated,Primary,862,929,1791
18502,32,State - KERALA,Urban,All ages,Primary,1152908,1186126,2339034
18503,32,State - KERALA,Urban,0-6,Primary,0,0,0
18504,32,State - KERALA,Urban,7,Primary,0,0,0
18505,32,State - KERALA,Urban,8,Primary,0,0,0
18506,32,State - KERALA,Urban,9,Primary,6897,7289,14186
18507,32,State - KERALA,Urban,10,Primary,41989,43936,85925
18508,32,State - KERALA,Urban,11,Primary,104404,106042,210446
18509,32,State - KERALA,Urban,12,Primary,113737,108513,222250
18510,32,State - KERALA,Urban,13,Primary,92906,83287,176193
18511,32,State - KERALA,Urban,14,Primary,32084,21615,53699
18512,32,State - KERALA,Urban,15,Primary,8235,4015,12250
18513,32,State - KERALA,Urban,16,Primary,3209,1470,4679
18514,32,State - KERALA,Urban,17,Primary,2358,1114,3472
18515,32,State - KERALA,Urban,18,Primary,2906,1351,4257
18516,32,State - KERALA,Urban,19,Primary,3108,1615,4723
18517,32,State - KERALA,Urban,20-24,Primary,23352,12816,36168
18518,32,State - KERALA,Urban,25-29,Primary,40711,28072,68783
18519,32,State - KERALA,Urban,30-34,Primary,52150,50342,102492
18520,32,State - KERALA,Urban,35-39,Primary,73939,89927,163866
18521,32,State - KERALA,Urban,40-44,Primary,83465,102604,186069
18522,32,State - KERALA,Urban,45-49,Primary,96741,117630,214371
18523,32,State - KERALA,Urban,50-54,Primary,92249,101456,193705
18524,32,State - KERALA,Urban,55-59,Primary,88641,87707,176348
18525,32,State - KERALA,Urban,60-64,Primary,72577,74927,147504
18526,32,State - KERALA,Urban,65-69,Primary,46232,52009,98241
18527,32,State - KERALA,Urban,70-74,Primary,33031,37355,70386
18528,32,State - KERALA,Urban,75-79,Primary,19137,24941,44078
18529,32,State - KERALA,Urban,80+,Primary,18122,25249,43371
18530,32,State - KERALA,Urban,Age not stated,Primary,728,844,1572
18531,33,State - TAMIL NADU,Total,All ages,Primary,6479422,5845740,12325162
18532,33,State - TAMIL NADU,Total,0-6,Primary,0,0,0
18533,33,State - TAMIL NADU,Total,7,Primary,0,0,0
18534,33,State - TAMIL NADU,Total,8,Primary,0,0,0
18535,33,State - TAMIL NADU,Total,9,Primary,116319,116994,233313
18536,33,State - TAMIL NADU,Total,10,Primary,406346,395710,802056
18537,33,State - TAMIL NADU,Total,11,Primary,558991,529139,1088130
18538,33,State - TAMIL NADU,Total,12,Primary,467872,425749,893621
18539,33,State - TAMIL NADU,Total,13,Primary,249865,210703,460568
18540,33,State - TAMIL NADU,Total,14,Primary,83498,61762,145260
18541,33,State - TAMIL NADU,Total,15,Primary,47058,33544,80602
18542,33,State - TAMIL NADU,Total,16,Primary,36595,27046,63641
18543,33,State - TAMIL NADU,Total,17,Primary,40781,31117,71898
18544,33,State - TAMIL NADU,Total,18,Primary,52958,43942,96900
18545,33,State - TAMIL NADU,Total,19,Primary,54642,49571,104213
18546,33,State - TAMIL NADU,Total,20-24,Primary,363463,355514,718977
18547,33,State - TAMIL NADU,Total,25-29,Primary,525426,537998,1063424
18548,33,State - TAMIL NADU,Total,30-34,Primary,500611,517358,1017969
18549,33,State - TAMIL NADU,Total,35-39,Primary,531233,591911,1123144
18550,33,State - TAMIL NADU,Total,40-44,Primary,505905,480488,986393
18551,33,State - TAMIL NADU,Total,45-49,Primary,500215,432700,932915
18552,33,State - TAMIL NADU,Total,50-54,Primary,384665,304785,689450
18553,33,State - TAMIL NADU,Total,55-59,Primary,304460,235635,540095
18554,33,State - TAMIL NADU,Total,60-64,Primary,270793,182796,453589
18555,33,State - TAMIL NADU,Total,65-69,Primary,187963,118314,306277
18556,33,State - TAMIL NADU,Total,70-74,Primary,141793,76539,218332
18557,33,State - TAMIL NADU,Total,75-79,Primary,74015,42394,116409
18558,33,State - TAMIL NADU,Total,80+,Primary,70231,40358,110589
18559,33,State - TAMIL NADU,Total,Age not stated,Primary,3724,3673,7397
18560,33,State - TAMIL NADU,Rural,All ages,Primary,3681444,3046631,6728075
18561,33,State - TAMIL NADU,Rural,0-6,Primary,0,0,0
18562,33,State - TAMIL NADU,Rural,7,Primary,0,0,0
18563,33,State - TAMIL NADU,Rural,8,Primary,0,0,0
18564,33,State - TAMIL NADU,Rural,9,Primary,64321,63630,127951
18565,33,State - TAMIL NADU,Rural,10,Primary,224171,215744,439915
18566,33,State - TAMIL NADU,Rural,11,Primary,300405,281340,581745
18567,33,State - TAMIL NADU,Rural,12,Primary,256548,229582,486130
18568,33,State - TAMIL NADU,Rural,13,Primary,134442,112314,246756
18569,33,State - TAMIL NADU,Rural,14,Primary,46216,34531,80747
18570,33,State - TAMIL NADU,Rural,15,Primary,27736,20089,47825
18571,33,State - TAMIL NADU,Rural,16,Primary,21937,16655,38592
18572,33,State - TAMIL NADU,Rural,17,Primary,24800,19491,44291
18573,33,State - TAMIL NADU,Rural,18,Primary,32582,27897,60479
18574,33,State - TAMIL NADU,Rural,19,Primary,33526,31019,64545
18575,33,State - TAMIL NADU,Rural,20-24,Primary,219941,215528,435469
18576,33,State - TAMIL NADU,Rural,25-29,Primary,310935,314812,625747
18577,33,State - TAMIL NADU,Rural,30-34,Primary,286947,285822,572769
18578,33,State - TAMIL NADU,Rural,35-39,Primary,299721,312983,612704
18579,33,State - TAMIL NADU,Rural,40-44,Primary,285209,239446,524655
18580,33,State - TAMIL NADU,Rural,45-49,Primary,287287,209158,496445
18581,33,State - TAMIL NADU,Rural,50-54,Primary,220115,140204,360319
18582,33,State - TAMIL NADU,Rural,55-59,Primary,174374,104348,278722
18583,33,State - TAMIL NADU,Rural,60-64,Primary,157598,73662,231260
18584,33,State - TAMIL NADU,Rural,65-69,Primary,109774,45517,155291
18585,33,State - TAMIL NADU,Rural,70-74,Primary,81137,26175,107312
18586,33,State - TAMIL NADU,Rural,75-79,Primary,41039,13057,54096
18587,33,State - TAMIL NADU,Rural,80+,Primary,38350,11569,49919
18588,33,State - TAMIL NADU,Rural,Age not stated,Primary,2333,2058,4391
18589,33,State - TAMIL NADU,Urban,All ages,Primary,2797978,2799109,5597087
18590,33,State - TAMIL NADU,Urban,0-6,Primary,0,0,0
18591,33,State - TAMIL NADU,Urban,7,Primary,0,0,0
18592,33,State - TAMIL NADU,Urban,8,Primary,0,0,0
18593,33,State - TAMIL NADU,Urban,9,Primary,51998,53364,105362
18594,33,State - TAMIL NADU,Urban,10,Primary,182175,179966,362141
18595,33,State - TAMIL NADU,Urban,11,Primary,258586,247799,506385
18596,33,State - TAMIL NADU,Urban,12,Primary,211324,196167,407491
18597,33,State - TAMIL NADU,Urban,13,Primary,115423,98389,213812
18598,33,State - TAMIL NADU,Urban,14,Primary,37282,27231,64513
18599,33,State - TAMIL NADU,Urban,15,Primary,19322,13455,32777
18600,33,State - TAMIL NADU,Urban,16,Primary,14658,10391,25049
18601,33,State - TAMIL NADU,Urban,17,Primary,15981,11626,27607
18602,33,State - TAMIL NADU,Urban,18,Primary,20376,16045,36421
18603,33,State - TAMIL NADU,Urban,19,Primary,21116,18552,39668
18604,33,State - TAMIL NADU,Urban,20-24,Primary,143522,139986,283508
18605,33,State - TAMIL NADU,Urban,25-29,Primary,214491,223186,437677
18606,33,State - TAMIL NADU,Urban,30-34,Primary,213664,231536,445200
18607,33,State - TAMIL NADU,Urban,35-39,Primary,231512,278928,510440
18608,33,State - TAMIL NADU,Urban,40-44,Primary,220696,241042,461738
18609,33,State - TAMIL NADU,Urban,45-49,Primary,212928,223542,436470
18610,33,State - TAMIL NADU,Urban,50-54,Primary,164550,164581,329131
18611,33,State - TAMIL NADU,Urban,55-59,Primary,130086,131287,261373
18612,33,State - TAMIL NADU,Urban,60-64,Primary,113195,109134,222329
18613,33,State - TAMIL NADU,Urban,65-69,Primary,78189,72797,150986
18614,33,State - TAMIL NADU,Urban,70-74,Primary,60656,50364,111020
18615,33,State - TAMIL NADU,Urban,75-79,Primary,32976,29337,62313
18616,33,State - TAMIL NADU,Urban,80+,Primary,31881,28789,60670
18617,33,State - TAMIL NADU,Urban,Age not stated,Primary,1391,1615,3006
18618,34,State - PUDUCHERRY,Total,All ages,Primary,89632,98091,187723
18619,34,State - PUDUCHERRY,Total,0-6,Primary,0,0,0
18620,34,State - PUDUCHERRY,Total,7,Primary,0,0,0
18621,34,State - PUDUCHERRY,Total,8,Primary,0,0,0
18622,34,State - PUDUCHERRY,Total,9,Primary,1483,1488,2971
18623,34,State - PUDUCHERRY,Total,10,Primary,6183,6141,12324
18624,34,State - PUDUCHERRY,Total,11,Primary,9801,9476,19277
18625,34,State - PUDUCHERRY,Total,12,Primary,8503,8077,16580
18626,34,State - PUDUCHERRY,Total,13,Primary,5335,4669,10004
18627,34,State - PUDUCHERRY,Total,14,Primary,1656,1213,2869
18628,34,State - PUDUCHERRY,Total,15,Primary,761,456,1217
18629,34,State - PUDUCHERRY,Total,16,Primary,448,303,751
18630,34,State - PUDUCHERRY,Total,17,Primary,382,299,681
18631,34,State - PUDUCHERRY,Total,18,Primary,467,390,857
18632,34,State - PUDUCHERRY,Total,19,Primary,513,433,946
18633,34,State - PUDUCHERRY,Total,20-24,Primary,3379,3913,7292
18634,34,State - PUDUCHERRY,Total,25-29,Primary,6048,7152,13200
18635,34,State - PUDUCHERRY,Total,30-34,Primary,6391,8251,14642
18636,34,State - PUDUCHERRY,Total,35-39,Primary,7364,9744,17108
18637,34,State - PUDUCHERRY,Total,40-44,Primary,6676,8321,14997
18638,34,State - PUDUCHERRY,Total,45-49,Primary,6182,7262,13444
18639,34,State - PUDUCHERRY,Total,50-54,Primary,4447,5658,10105
18640,34,State - PUDUCHERRY,Total,55-59,Primary,3798,4625,8423
18641,34,State - PUDUCHERRY,Total,60-64,Primary,3342,3898,7240
18642,34,State - PUDUCHERRY,Total,65-69,Primary,2215,2402,4617
18643,34,State - PUDUCHERRY,Total,70-74,Primary,1952,1775,3727
18644,34,State - PUDUCHERRY,Total,75-79,Primary,1134,1070,2204
18645,34,State - PUDUCHERRY,Total,80+,Primary,1109,1005,2114
18646,34,State - PUDUCHERRY,Total,Age not stated,Primary,63,70,133
18647,34,State - PUDUCHERRY,Rural,All ages,Primary,30148,30615,60763
18648,34,State - PUDUCHERRY,Rural,0-6,Primary,0,0,0
18649,34,State - PUDUCHERRY,Rural,7,Primary,0,0,0
18650,34,State - PUDUCHERRY,Rural,8,Primary,0,0,0
18651,34,State - PUDUCHERRY,Rural,9,Primary,567,554,1121
18652,34,State - PUDUCHERRY,Rural,10,Primary,2142,2174,4316
18653,34,State - PUDUCHERRY,Rural,11,Primary,3301,3173,6474
18654,34,State - PUDUCHERRY,Rural,12,Primary,2790,2656,5446
18655,34,State - PUDUCHERRY,Rural,13,Primary,1736,1532,3268
18656,34,State - PUDUCHERRY,Rural,14,Primary,559,395,954
18657,34,State - PUDUCHERRY,Rural,15,Primary,221,142,363
18658,34,State - PUDUCHERRY,Rural,16,Primary,143,88,231
18659,34,State - PUDUCHERRY,Rural,17,Primary,115,100,215
18660,34,State - PUDUCHERRY,Rural,18,Primary,155,114,269
18661,34,State - PUDUCHERRY,Rural,19,Primary,174,140,314
18662,34,State - PUDUCHERRY,Rural,20-24,Primary,1094,1383,2477
18663,34,State - PUDUCHERRY,Rural,25-29,Primary,2060,2571,4631
18664,34,State - PUDUCHERRY,Rural,30-34,Primary,2032,2914,4946
18665,34,State - PUDUCHERRY,Rural,35-39,Primary,2486,3313,5799
18666,34,State - PUDUCHERRY,Rural,40-44,Primary,2261,2676,4937
18667,34,State - PUDUCHERRY,Rural,45-49,Primary,2219,2149,4368
18668,34,State - PUDUCHERRY,Rural,50-54,Primary,1611,1426,3037
18669,34,State - PUDUCHERRY,Rural,55-59,Primary,1326,1172,2498
18670,34,State - PUDUCHERRY,Rural,60-64,Primary,1109,845,1954
18671,34,State - PUDUCHERRY,Rural,65-69,Primary,714,491,1205
18672,34,State - PUDUCHERRY,Rural,70-74,Primary,626,269,895
18673,34,State - PUDUCHERRY,Rural,75-79,Primary,330,160,490
18674,34,State - PUDUCHERRY,Rural,80+,Primary,349,146,495
18675,34,State - PUDUCHERRY,Rural,Age not stated,Primary,28,32,60
18676,34,State - PUDUCHERRY,Urban,All ages,Primary,59484,67476,126960
18677,34,State - PUDUCHERRY,Urban,0-6,Primary,0,0,0
18678,34,State - PUDUCHERRY,Urban,7,Primary,0,0,0
18679,34,State - PUDUCHERRY,Urban,8,Primary,0,0,0
18680,34,State - PUDUCHERRY,Urban,9,Primary,916,934,1850
18681,34,State - PUDUCHERRY,Urban,10,Primary,4041,3967,8008
18682,34,State - PUDUCHERRY,Urban,11,Primary,6500,6303,12803
18683,34,State - PUDUCHERRY,Urban,12,Primary,5713,5421,11134
18684,34,State - PUDUCHERRY,Urban,13,Primary,3599,3137,6736
18685,34,State - PUDUCHERRY,Urban,14,Primary,1097,818,1915
18686,34,State - PUDUCHERRY,Urban,15,Primary,540,314,854
18687,34,State - PUDUCHERRY,Urban,16,Primary,305,215,520
18688,34,State - PUDUCHERRY,Urban,17,Primary,267,199,466
18689,34,State - PUDUCHERRY,Urban,18,Primary,312,276,588
18690,34,State - PUDUCHERRY,Urban,19,Primary,339,293,632
18691,34,State - PUDUCHERRY,Urban,20-24,Primary,2285,2530,4815
18692,34,State - PUDUCHERRY,Urban,25-29,Primary,3988,4581,8569
18693,34,State - PUDUCHERRY,Urban,30-34,Primary,4359,5337,9696
18694,34,State - PUDUCHERRY,Urban,35-39,Primary,4878,6431,11309
18695,34,State - PUDUCHERRY,Urban,40-44,Primary,4415,5645,10060
18696,34,State - PUDUCHERRY,Urban,45-49,Primary,3963,5113,9076
18697,34,State - PUDUCHERRY,Urban,50-54,Primary,2836,4232,7068
18698,34,State - PUDUCHERRY,Urban,55-59,Primary,2472,3453,5925
18699,34,State - PUDUCHERRY,Urban,60-64,Primary,2233,3053,5286
18700,34,State - PUDUCHERRY,Urban,65-69,Primary,1501,1911,3412
18701,34,State - PUDUCHERRY,Urban,70-74,Primary,1326,1506,2832
18702,34,State - PUDUCHERRY,Urban,75-79,Primary,804,910,1714
18703,34,State - PUDUCHERRY,Urban,80+,Primary,760,859,1619
18704,34,State - PUDUCHERRY,Urban,Age not stated,Primary,35,38,73
18705,35,State - ANDAMAN & NICOBAR ISLANDS,Total,All ages,Primary,37920,30495,68415
18706,35,State - ANDAMAN & NICOBAR ISLANDS,Total,0-6,Primary,0,0,0
18707,35,State - ANDAMAN & NICOBAR ISLANDS,Total,7,Primary,0,0,0
18708,35,State - ANDAMAN & NICOBAR ISLANDS,Total,8,Primary,0,0,0
18709,35,State - ANDAMAN & NICOBAR ISLANDS,Total,9,Primary,302,271,573
18710,35,State - ANDAMAN & NICOBAR ISLANDS,Total,10,Primary,1288,1240,2528
18711,35,State - ANDAMAN & NICOBAR ISLANDS,Total,11,Primary,2529,2557,5086
18712,35,State - ANDAMAN & NICOBAR ISLANDS,Total,12,Primary,2628,2641,5269
18713,35,State - ANDAMAN & NICOBAR ISLANDS,Total,13,Primary,2195,1948,4143
18714,35,State - ANDAMAN & NICOBAR ISLANDS,Total,14,Primary,1168,944,2112
18715,35,State - ANDAMAN & NICOBAR ISLANDS,Total,15,Primary,678,501,1179
18716,35,State - ANDAMAN & NICOBAR ISLANDS,Total,16,Primary,398,265,663
18717,35,State - ANDAMAN & NICOBAR ISLANDS,Total,17,Primary,360,206,566
18718,35,State - ANDAMAN & NICOBAR ISLANDS,Total,18,Primary,458,333,791
18719,35,State - ANDAMAN & NICOBAR ISLANDS,Total,19,Primary,450,328,778
18720,35,State - ANDAMAN & NICOBAR ISLANDS,Total,20-24,Primary,3043,2333,5376
18721,35,State - ANDAMAN & NICOBAR ISLANDS,Total,25-29,Primary,3736,3157,6893
18722,35,State - ANDAMAN & NICOBAR ISLANDS,Total,30-34,Primary,3208,2786,5994
18723,35,State - ANDAMAN & NICOBAR ISLANDS,Total,35-39,Primary,3106,2987,6093
18724,35,State - ANDAMAN & NICOBAR ISLANDS,Total,40-44,Primary,2612,2130,4742
18725,35,State - ANDAMAN & NICOBAR ISLANDS,Total,45-49,Primary,2821,2090,4911
18726,35,State - ANDAMAN & NICOBAR ISLANDS,Total,50-54,Primary,2109,1382,3491
18727,35,State - ANDAMAN & NICOBAR ISLANDS,Total,55-59,Primary,1634,971,2605
18728,35,State - ANDAMAN & NICOBAR ISLANDS,Total,60-64,Primary,1324,672,1996
18729,35,State - ANDAMAN & NICOBAR ISLANDS,Total,65-69,Primary,788,373,1161
18730,35,State - ANDAMAN & NICOBAR ISLANDS,Total,70-74,Primary,543,159,702
18731,35,State - ANDAMAN & NICOBAR ISLANDS,Total,75-79,Primary,272,98,370
18732,35,State - ANDAMAN & NICOBAR ISLANDS,Total,80+,Primary,244,103,347
18733,35,State - ANDAMAN & NICOBAR ISLANDS,Total,Age not stated,Primary,26,20,46
18734,35,State - ANDAMAN & NICOBAR ISLANDS,Rural,All ages,Primary,25673,20628,46301
18735,35,State - ANDAMAN & NICOBAR ISLANDS,Rural,0-6,Primary,0,0,0
18736,35,State - ANDAMAN & NICOBAR ISLANDS,Rural,7,Primary,0,0,0
18737,35,State - ANDAMAN & NICOBAR ISLANDS,Rural,8,Primary,0,0,0
18738,35,State - ANDAMAN & NICOBAR ISLANDS,Rural,9,Primary,175,170,345
18739,35,State - ANDAMAN & NICOBAR ISLANDS,Rural,10,Primary,777,767,1544
18740,35,State - ANDAMAN & NICOBAR ISLANDS,Rural,11,Primary,1539,1623,3162
18741,35,State - ANDAMAN & NICOBAR ISLANDS,Rural,12,Primary,1632,1720,3352
18742,35,State - ANDAMAN & NICOBAR ISLANDS,Rural,13,Primary,1414,1298,2712
18743,35,State - ANDAMAN & NICOBAR ISLANDS,Rural,14,Primary,778,653,1431
18744,35,State - ANDAMAN & NICOBAR ISLANDS,Rural,15,Primary,472,367,839
18745,35,State - ANDAMAN & NICOBAR ISLANDS,Rural,16,Primary,282,184,466
18746,35,State - ANDAMAN & NICOBAR ISLANDS,Rural,17,Primary,268,154,422
18747,35,State - ANDAMAN & NICOBAR ISLANDS,Rural,18,Primary,316,233,549
18748,35,State - ANDAMAN & NICOBAR ISLANDS,Rural,19,Primary,290,245,535
18749,35,State - ANDAMAN & NICOBAR ISLANDS,Rural,20-24,Primary,2055,1711,3766
18750,35,State - ANDAMAN & NICOBAR ISLANDS,Rural,25-29,Primary,2628,2258,4886
18751,35,State - ANDAMAN & NICOBAR ISLANDS,Rural,30-34,Primary,2312,1973,4285
18752,35,State - ANDAMAN & NICOBAR ISLANDS,Rural,35-39,Primary,2221,2071,4292
18753,35,State - ANDAMAN & NICOBAR ISLANDS,Rural,40-44,Primary,1819,1422,3241
18754,35,State - ANDAMAN & NICOBAR ISLANDS,Rural,45-49,Primary,1876,1396,3272
18755,35,State - ANDAMAN & NICOBAR ISLANDS,Rural,50-54,Primary,1462,907,2369
18756,35,State - ANDAMAN & NICOBAR ISLANDS,Rural,55-59,Primary,1095,610,1705
18757,35,State - ANDAMAN & NICOBAR ISLANDS,Rural,60-64,Primary,940,440,1380
18758,35,State - ANDAMAN & NICOBAR ISLANDS,Rural,65-69,Primary,556,213,769
18759,35,State - ANDAMAN & NICOBAR ISLANDS,Rural,70-74,Primary,389,92,481
18760,35,State - ANDAMAN & NICOBAR ISLANDS,Rural,75-79,Primary,191,51,242
18761,35,State - ANDAMAN & NICOBAR ISLANDS,Rural,80+,Primary,176,59,235
18762,35,State - ANDAMAN & NICOBAR ISLANDS,Rural,Age not stated,Primary,10,11,21
18763,35,State - ANDAMAN & NICOBAR ISLANDS,Urban,All ages,Primary,12247,9867,22114
18764,35,State - ANDAMAN & NICOBAR ISLANDS,Urban,0-6,Primary,0,0,0
18765,35,State - ANDAMAN & NICOBAR ISLANDS,Urban,7,Primary,0,0,0
18766,35,State - ANDAMAN & NICOBAR ISLANDS,Urban,8,Primary,0,0,0
18767,35,State - ANDAMAN & NICOBAR ISLANDS,Urban,9,Primary,127,101,228
18768,35,State - ANDAMAN & NICOBAR ISLANDS,Urban,10,Primary,511,473,984
18769,35,State - ANDAMAN & NICOBAR ISLANDS,Urban,11,Primary,990,934,1924
18770,35,State - ANDAMAN & NICOBAR ISLANDS,Urban,12,Primary,996,921,1917
18771,35,State - ANDAMAN & NICOBAR ISLANDS,Urban,13,Primary,781,650,1431
18772,35,State - ANDAMAN & NICOBAR ISLANDS,Urban,14,Primary,390,291,681
18773,35,State - ANDAMAN & NICOBAR ISLANDS,Urban,15,Primary,206,134,340
18774,35,State - ANDAMAN & NICOBAR ISLANDS,Urban,16,Primary,116,81,197
18775,35,State - ANDAMAN & NICOBAR ISLANDS,Urban,17,Primary,92,52,144
18776,35,State - ANDAMAN & NICOBAR ISLANDS,Urban,18,Primary,142,100,242
18777,35,State - ANDAMAN & NICOBAR ISLANDS,Urban,19,Primary,160,83,243
18778,35,State - ANDAMAN & NICOBAR ISLANDS,Urban,20-24,Primary,988,622,1610
18779,35,State - ANDAMAN & NICOBAR ISLANDS,Urban,25-29,Primary,1108,899,2007
18780,35,State - ANDAMAN & NICOBAR ISLANDS,Urban,30-34,Primary,896,813,1709
18781,35,State - ANDAMAN & NICOBAR ISLANDS,Urban,35-39,Primary,885,916,1801
18782,35,State - ANDAMAN & NICOBAR ISLANDS,Urban,40-44,Primary,793,708,1501
18783,35,State - ANDAMAN & NICOBAR ISLANDS,Urban,45-49,Primary,945,694,1639
18784,35,State - ANDAMAN & NICOBAR ISLANDS,Urban,50-54,Primary,647,475,1122
18785,35,State - ANDAMAN & NICOBAR ISLANDS,Urban,55-59,Primary,539,361,900
18786,35,State - ANDAMAN & NICOBAR ISLANDS,Urban,60-64,Primary,384,232,616
18787,35,State - ANDAMAN & NICOBAR ISLANDS,Urban,65-69,Primary,232,160,392
18788,35,State - ANDAMAN & NICOBAR ISLANDS,Urban,70-74,Primary,154,67,221
18789,35,State - ANDAMAN & NICOBAR ISLANDS,Urban,75-79,Primary,81,47,128
18790,35,State - ANDAMAN & NICOBAR ISLANDS,Urban,80+,Primary,68,44,112
18791,35,State - ANDAMAN & NICOBAR ISLANDS,Urban,Age not stated,Primary,16,9,25
18792,0,INDIA,Total,All ages,Middle,77629578,56273688,133903266
18793,0,INDIA,Total,0-6,Middle,0,0,0
18794,0,INDIA,Total,7,Middle,0,0,0
18795,0,INDIA,Total,8,Middle,0,0,0
18796,0,INDIA,Total,9,Middle,0,0,0
18797,0,INDIA,Total,10,Middle,0,0,0
18798,0,INDIA,Total,11,Middle,0,0,0
18799,0,INDIA,Total,12,Middle,1413978,1282557,2696535
18800,0,INDIA,Total,13,Middle,3518523,3326271,6844794
18801,0,INDIA,Total,14,Middle,6800377,6156427,12956804
18802,0,INDIA,Total,15,Middle,5764655,4835957,10600612
18803,0,INDIA,Total,16,Middle,3939977,3167501,7107478
18804,0,INDIA,Total,17,Middle,2433895,1885268,4319163
18805,0,INDIA,Total,18,Middle,2763224,2061496,4824720
18806,0,INDIA,Total,19,Middle,1783164,1452972,3236136
18807,0,INDIA,Total,20-24,Middle,9533146,7339574,16872720
18808,0,INDIA,Total,25-29,Middle,8527972,6350650,14878622
18809,0,INDIA,Total,30-34,Middle,7032851,4938081,11970932
18810,0,INDIA,Total,35-39,Middle,6201133,4082616,10283749
18811,0,INDIA,Total,40-44,Middle,4895118,2880159,7775277
18812,0,INDIA,Total,45-49,Middle,3858714,2160315,6019029
18813,0,INDIA,Total,50-54,Middle,2885435,1464872,4350307
18814,0,INDIA,Total,55-59,Middle,2058127,1031332,3089459
18815,0,INDIA,Total,60-64,Middle,1662081,734687,2396768
18816,0,INDIA,Total,65-69,Middle,1041615,435740,1477355
18817,0,INDIA,Total,70-74,Middle,646602,240424,887026
18818,0,INDIA,Total,75-79,Middle,301083,126385,427468
18819,0,INDIA,Total,80+,Middle,354064,175886,529950
18820,0,INDIA,Total,Age not stated,Middle,213844,144518,358362
18821,0,INDIA,Rural,All ages,Middle,53864377,36479421,90343798
18822,0,INDIA,Rural,0-6,Middle,0,0,0
18823,0,INDIA,Rural,7,Middle,0,0,0
18824,0,INDIA,Rural,8,Middle,0,0,0
18825,0,INDIA,Rural,9,Middle,0,0,0
18826,0,INDIA,Rural,10,Middle,0,0,0
18827,0,INDIA,Rural,11,Middle,0,0,0
18828,0,INDIA,Rural,12,Middle,941376,819394,1760770
18829,0,INDIA,Rural,13,Middle,2309307,2123473,4432780
18830,0,INDIA,Rural,14,Middle,4570751,4047610,8618361
18831,0,INDIA,Rural,15,Middle,4082445,3397222,7479667
18832,0,INDIA,Rural,16,Middle,2926273,2356642,5282915
18833,0,INDIA,Rural,17,Middle,1809760,1408913,3218673
18834,0,INDIA,Rural,18,Middle,2098836,1564661,3663497
18835,0,INDIA,Rural,19,Middle,1308252,1075305,2383557
18836,0,INDIA,Rural,20-24,Middle,6918773,5213035,12131808
18837,0,INDIA,Rural,25-29,Middle,6026580,4239432,10266012
18838,0,INDIA,Rural,30-34,Middle,4898327,3157748,8056075
18839,0,INDIA,Rural,35-39,Middle,4275069,2446963,6722032
18840,0,INDIA,Rural,40-44,Middle,3270323,1589668,4859991
18841,0,INDIA,Rural,45-49,Middle,2491622,1097355,3588977
18842,0,INDIA,Rural,50-54,Middle,1850724,701689,2552413
18843,0,INDIA,Rural,55-59,Middle,1323961,471430,1795391
18844,0,INDIA,Rural,60-64,Middle,1100696,306671,1407367
18845,0,INDIA,Rural,65-69,Middle,691905,175187,867092
18846,0,INDIA,Rural,70-74,Middle,418614,82801,501415
18847,0,INDIA,Rural,75-79,Middle,185216,38753,223969
18848,0,INDIA,Rural,80+,Middle,220728,75210,295938
18849,0,INDIA,Rural,Age not stated,Middle,144839,90259,235098
18850,0,INDIA,Urban,All ages,Middle,23765201,19794267,43559468
18851,0,INDIA,Urban,0-6,Middle,0,0,0
18852,0,INDIA,Urban,7,Middle,0,0,0
18853,0,INDIA,Urban,8,Middle,0,0,0
18854,0,INDIA,Urban,9,Middle,0,0,0
18855,0,INDIA,Urban,10,Middle,0,0,0
18856,0,INDIA,Urban,11,Middle,0,0,0
18857,0,INDIA,Urban,12,Middle,472602,463163,935765
18858,0,INDIA,Urban,13,Middle,1209216,1202798,2412014
18859,0,INDIA,Urban,14,Middle,2229626,2108817,4338443
18860,0,INDIA,Urban,15,Middle,1682210,1438735,3120945
18861,0,INDIA,Urban,16,Middle,1013704,810859,1824563
18862,0,INDIA,Urban,17,Middle,624135,476355,1100490
18863,0,INDIA,Urban,18,Middle,664388,496835,1161223
18864,0,INDIA,Urban,19,Middle,474912,377667,852579
18865,0,INDIA,Urban,20-24,Middle,2614373,2126539,4740912
18866,0,INDIA,Urban,25-29,Middle,2501392,2111218,4612610
18867,0,INDIA,Urban,30-34,Middle,2134524,1780333,3914857
18868,0,INDIA,Urban,35-39,Middle,1926064,1635653,3561717
18869,0,INDIA,Urban,40-44,Middle,1624795,1290491,2915286
18870,0,INDIA,Urban,45-49,Middle,1367092,1062960,2430052
18871,0,INDIA,Urban,50-54,Middle,1034711,763183,1797894
18872,0,INDIA,Urban,55-59,Middle,734166,559902,1294068
18873,0,INDIA,Urban,60-64,Middle,561385,428016,989401
18874,0,INDIA,Urban,65-69,Middle,349710,260553,610263
18875,0,INDIA,Urban,70-74,Middle,227988,157623,385611
18876,0,INDIA,Urban,75-79,Middle,115867,87632,203499
18877,0,INDIA,Urban,80+,Middle,133336,100676,234012
18878,0,INDIA,Urban,Age not stated,Middle,69005,54259,123264
18879,1,State - JAMMU & KASHMIR,Total,All ages,Middle,1015129,651252,1666381
18880,1,State - JAMMU & KASHMIR,Total,0-6,Middle,0,0,0
18881,1,State - JAMMU & KASHMIR,Total,7,Middle,0,0,0
18882,1,State - JAMMU & KASHMIR,Total,8,Middle,0,0,0
18883,1,State - JAMMU & KASHMIR,Total,9,Middle,0,0,0
18884,1,State - JAMMU & KASHMIR,Total,10,Middle,0,0,0
18885,1,State - JAMMU & KASHMIR,Total,11,Middle,0,0,0
18886,1,State - JAMMU & KASHMIR,Total,12,Middle,16845,13921,30766
18887,1,State - JAMMU & KASHMIR,Total,13,Middle,39019,33597,72616
18888,1,State - JAMMU & KASHMIR,Total,14,Middle,79052,67206,146258
18889,1,State - JAMMU & KASHMIR,Total,15,Middle,70604,59818,130422
18890,1,State - JAMMU & KASHMIR,Total,16,Middle,51073,42681,93754
18891,1,State - JAMMU & KASHMIR,Total,17,Middle,31379,26031,57410
18892,1,State - JAMMU & KASHMIR,Total,18,Middle,31782,26884,58666
18893,1,State - JAMMU & KASHMIR,Total,19,Middle,21167,17694,38861
18894,1,State - JAMMU & KASHMIR,Total,20-24,Middle,114635,91891,206526
18895,1,State - JAMMU & KASHMIR,Total,25-29,Middle,115669,78772,194441
18896,1,State - JAMMU & KASHMIR,Total,30-34,Middle,107496,60267,167763
18897,1,State - JAMMU & KASHMIR,Total,35-39,Middle,93308,47053,140361
18898,1,State - JAMMU & KASHMIR,Total,40-44,Middle,72814,30033,102847
18899,1,State - JAMMU & KASHMIR,Total,45-49,Middle,57034,20766,77800
18900,1,State - JAMMU & KASHMIR,Total,50-54,Middle,43160,13414,56574
18901,1,State - JAMMU & KASHMIR,Total,55-59,Middle,25583,8171,33754
18902,1,State - JAMMU & KASHMIR,Total,60-64,Middle,19086,5285,24371
18903,1,State - JAMMU & KASHMIR,Total,65-69,Middle,10303,3144,13447
18904,1,State - JAMMU & KASHMIR,Total,70-74,Middle,6903,1790,8693
18905,1,State - JAMMU & KASHMIR,Total,75-79,Middle,3208,956,4164
18906,1,State - JAMMU & KASHMIR,Total,80+,Middle,4336,1479,5815
18907,1,State - JAMMU & KASHMIR,Total,Age not stated,Middle,673,399,1072
18908,1,State - JAMMU & KASHMIR,Rural,All ages,Middle,770561,472548,1243109
18909,1,State - JAMMU & KASHMIR,Rural,0-6,Middle,0,0,0
18910,1,State - JAMMU & KASHMIR,Rural,7,Middle,0,0,0
18911,1,State - JAMMU & KASHMIR,Rural,8,Middle,0,0,0
18912,1,State - JAMMU & KASHMIR,Rural,9,Middle,0,0,0
18913,1,State - JAMMU & KASHMIR,Rural,10,Middle,0,0,0
18914,1,State - JAMMU & KASHMIR,Rural,11,Middle,0,0,0
18915,1,State - JAMMU & KASHMIR,Rural,12,Middle,12383,10091,22474
18916,1,State - JAMMU & KASHMIR,Rural,13,Middle,29014,24581,53595
18917,1,State - JAMMU & KASHMIR,Rural,14,Middle,58638,48948,107586
18918,1,State - JAMMU & KASHMIR,Rural,15,Middle,53783,45169,98952
18919,1,State - JAMMU & KASHMIR,Rural,16,Middle,40567,33741,74308
18920,1,State - JAMMU & KASHMIR,Rural,17,Middle,25683,21210,46893
18921,1,State - JAMMU & KASHMIR,Rural,18,Middle,26345,22015,48360
18922,1,State - JAMMU & KASHMIR,Rural,19,Middle,17347,14340,31687
18923,1,State - JAMMU & KASHMIR,Rural,20-24,Middle,91766,73365,165131
18924,1,State - JAMMU & KASHMIR,Rural,25-29,Middle,90631,59754,150385
18925,1,State - JAMMU & KASHMIR,Rural,30-34,Middle,83728,44126,127854
18926,1,State - JAMMU & KASHMIR,Rural,35-39,Middle,70913,31606,102519
18927,1,State - JAMMU & KASHMIR,Rural,40-44,Middle,52785,18342,71127
18928,1,State - JAMMU & KASHMIR,Rural,45-49,Middle,39234,11077,50311
18929,1,State - JAMMU & KASHMIR,Rural,50-54,Middle,30643,6532,37175
18930,1,State - JAMMU & KASHMIR,Rural,55-59,Middle,18154,3308,21462
18931,1,State - JAMMU & KASHMIR,Rural,60-64,Middle,13190,1877,15067
18932,1,State - JAMMU & KASHMIR,Rural,65-69,Middle,6633,931,7564
18933,1,State - JAMMU & KASHMIR,Rural,70-74,Middle,4252,404,4656
18934,1,State - JAMMU & KASHMIR,Rural,75-79,Middle,1733,165,1898
18935,1,State - JAMMU & KASHMIR,Rural,80+,Middle,2605,657,3262
18936,1,State - JAMMU & KASHMIR,Rural,Age not stated,Middle,534,309,843
18937,1,State - JAMMU & KASHMIR,Urban,All ages,Middle,244568,178704,423272
18938,1,State - JAMMU & KASHMIR,Urban,0-6,Middle,0,0,0
18939,1,State - JAMMU & KASHMIR,Urban,7,Middle,0,0,0
18940,1,State - JAMMU & KASHMIR,Urban,8,Middle,0,0,0
18941,1,State - JAMMU & KASHMIR,Urban,9,Middle,0,0,0
18942,1,State - JAMMU & KASHMIR,Urban,10,Middle,0,0,0
18943,1,State - JAMMU & KASHMIR,Urban,11,Middle,0,0,0
18944,1,State - JAMMU & KASHMIR,Urban,12,Middle,4462,3830,8292
18945,1,State - JAMMU & KASHMIR,Urban,13,Middle,10005,9016,19021
18946,1,State - JAMMU & KASHMIR,Urban,14,Middle,20414,18258,38672
18947,1,State - JAMMU & KASHMIR,Urban,15,Middle,16821,14649,31470
18948,1,State - JAMMU & KASHMIR,Urban,16,Middle,10506,8940,19446
18949,1,State - JAMMU & KASHMIR,Urban,17,Middle,5696,4821,10517
18950,1,State - JAMMU & KASHMIR,Urban,18,Middle,5437,4869,10306
18951,1,State - JAMMU & KASHMIR,Urban,19,Middle,3820,3354,7174
18952,1,State - JAMMU & KASHMIR,Urban,20-24,Middle,22869,18526,41395
18953,1,State - JAMMU & KASHMIR,Urban,25-29,Middle,25038,19018,44056
18954,1,State - JAMMU & KASHMIR,Urban,30-34,Middle,23768,16141,39909
18955,1,State - JAMMU & KASHMIR,Urban,35-39,Middle,22395,15447,37842
18956,1,State - JAMMU & KASHMIR,Urban,40-44,Middle,20029,11691,31720
18957,1,State - JAMMU & KASHMIR,Urban,45-49,Middle,17800,9689,27489
18958,1,State - JAMMU & KASHMIR,Urban,50-54,Middle,12517,6882,19399
18959,1,State - JAMMU & KASHMIR,Urban,55-59,Middle,7429,4863,12292
18960,1,State - JAMMU & KASHMIR,Urban,60-64,Middle,5896,3408,9304
18961,1,State - JAMMU & KASHMIR,Urban,65-69,Middle,3670,2213,5883
18962,1,State - JAMMU & KASHMIR,Urban,70-74,Middle,2651,1386,4037
18963,1,State - JAMMU & KASHMIR,Urban,75-79,Middle,1475,791,2266
18964,1,State - JAMMU & KASHMIR,Urban,80+,Middle,1731,822,2553
18965,1,State - JAMMU & KASHMIR,Urban,Age not stated,Middle,139,90,229
18966,2,State - HIMACHAL PRADESH,Total,All ages,Middle,452919,373692,826611
18967,2,State - HIMACHAL PRADESH,Total,0-6,Middle,0,0,0
18968,2,State - HIMACHAL PRADESH,Total,7,Middle,0,0,0
18969,2,State - HIMACHAL PRADESH,Total,8,Middle,0,0,0
18970,2,State - HIMACHAL PRADESH,Total,9,Middle,0,0,0
18971,2,State - HIMACHAL PRADESH,Total,10,Middle,0,0,0
18972,2,State - HIMACHAL PRADESH,Total,11,Middle,0,0,0
18973,2,State - HIMACHAL PRADESH,Total,12,Middle,5689,5247,10936
18974,2,State - HIMACHAL PRADESH,Total,13,Middle,21731,20470,42201
18975,2,State - HIMACHAL PRADESH,Total,14,Middle,43321,39860,83181
18976,2,State - HIMACHAL PRADESH,Total,15,Middle,38418,33872,72290
18977,2,State - HIMACHAL PRADESH,Total,16,Middle,23489,20121,43610
18978,2,State - HIMACHAL PRADESH,Total,17,Middle,13865,11280,25145
18979,2,State - HIMACHAL PRADESH,Total,18,Middle,10292,8200,18492
18980,2,State - HIMACHAL PRADESH,Total,19,Middle,7349,6073,13422
18981,2,State - HIMACHAL PRADESH,Total,20-24,Middle,34568,32078,66646
18982,2,State - HIMACHAL PRADESH,Total,25-29,Middle,35139,35784,70923
18983,2,State - HIMACHAL PRADESH,Total,30-34,Middle,34593,37174,71767
18984,2,State - HIMACHAL PRADESH,Total,35-39,Middle,38192,40679,78871
18985,2,State - HIMACHAL PRADESH,Total,40-44,Middle,34904,29711,64615
18986,2,State - HIMACHAL PRADESH,Total,45-49,Middle,30012,21227,51239
18987,2,State - HIMACHAL PRADESH,Total,50-54,Middle,25272,13789,39061
18988,2,State - HIMACHAL PRADESH,Total,55-59,Middle,19368,8410,27778
18989,2,State - HIMACHAL PRADESH,Total,60-64,Middle,14768,4375,19143
18990,2,State - HIMACHAL PRADESH,Total,65-69,Middle,9419,2388,11807
18991,2,State - HIMACHAL PRADESH,Total,70-74,Middle,6016,1239,7255
18992,2,State - HIMACHAL PRADESH,Total,75-79,Middle,3139,606,3745
18993,2,State - HIMACHAL PRADESH,Total,80+,Middle,2898,689,3587
18994,2,State - HIMACHAL PRADESH,Total,Age not stated,Middle,477,420,897
18995,2,State - HIMACHAL PRADESH,Rural,All ages,Middle,412688,342884,755572
18996,2,State - HIMACHAL PRADESH,Rural,0-6,Middle,0,0,0
18997,2,State - HIMACHAL PRADESH,Rural,7,Middle,0,0,0
18998,2,State - HIMACHAL PRADESH,Rural,8,Middle,0,0,0
18999,2,State - HIMACHAL PRADESH,Rural,9,Middle,0,0,0
19000,2,State - HIMACHAL PRADESH,Rural,10,Middle,0,0,0
19001,2,State - HIMACHAL PRADESH,Rural,11,Middle,0,0,0
19002,2,State - HIMACHAL PRADESH,Rural,12,Middle,5151,4810,9961
19003,2,State - HIMACHAL PRADESH,Rural,13,Middle,19810,18699,38509
19004,2,State - HIMACHAL PRADESH,Rural,14,Middle,39105,36202,75307
19005,2,State - HIMACHAL PRADESH,Rural,15,Middle,34490,30755,65245
19006,2,State - HIMACHAL PRADESH,Rural,16,Middle,21323,18577,39900
19007,2,State - HIMACHAL PRADESH,Rural,17,Middle,12827,10623,23450
19008,2,State - HIMACHAL PRADESH,Rural,18,Middle,9316,7705,17021
19009,2,State - HIMACHAL PRADESH,Rural,19,Middle,6629,5751,12380
19010,2,State - HIMACHAL PRADESH,Rural,20-24,Middle,30861,30217,61078
19011,2,State - HIMACHAL PRADESH,Rural,25-29,Middle,31465,33513,64978
19012,2,State - HIMACHAL PRADESH,Rural,30-34,Middle,31189,34924,66113
19013,2,State - HIMACHAL PRADESH,Rural,35-39,Middle,35091,37873,72964
19014,2,State - HIMACHAL PRADESH,Rural,40-44,Middle,32212,27251,59463
19015,2,State - HIMACHAL PRADESH,Rural,45-49,Middle,27613,19065,46678
19016,2,State - HIMACHAL PRADESH,Rural,50-54,Middle,23349,12269,35618
19017,2,State - HIMACHAL PRADESH,Rural,55-59,Middle,18032,7292,25324
19018,2,State - HIMACHAL PRADESH,Rural,60-64,Middle,13862,3585,17447
19019,2,State - HIMACHAL PRADESH,Rural,65-69,Middle,8878,1782,10660
19020,2,State - HIMACHAL PRADESH,Rural,70-74,Middle,5607,805,6412
19021,2,State - HIMACHAL PRADESH,Rural,75-79,Middle,2871,329,3200
19022,2,State - HIMACHAL PRADESH,Rural,80+,Middle,2577,460,3037
19023,2,State - HIMACHAL PRADESH,Rural,Age not stated,Middle,430,397,827
19024,2,State - HIMACHAL PRADESH,Urban,All ages,Middle,40231,30808,71039
19025,2,State - HIMACHAL PRADESH,Urban,0-6,Middle,0,0,0
19026,2,State - HIMACHAL PRADESH,Urban,7,Middle,0,0,0
19027,2,State - HIMACHAL PRADESH,Urban,8,Middle,0,0,0
19028,2,State - HIMACHAL PRADESH,Urban,9,Middle,0,0,0
19029,2,State - HIMACHAL PRADESH,Urban,10,Middle,0,0,0
19030,2,State - HIMACHAL PRADESH,Urban,11,Middle,0,0,0
19031,2,State - HIMACHAL PRADESH,Urban,12,Middle,538,437,975
19032,2,State - HIMACHAL PRADESH,Urban,13,Middle,1921,1771,3692
19033,2,State - HIMACHAL PRADESH,Urban,14,Middle,4216,3658,7874
19034,2,State - HIMACHAL PRADESH,Urban,15,Middle,3928,3117,7045
19035,2,State - HIMACHAL PRADESH,Urban,16,Middle,2166,1544,3710
19036,2,State - HIMACHAL PRADESH,Urban,17,Middle,1038,657,1695
19037,2,State - HIMACHAL PRADESH,Urban,18,Middle,976,495,1471
19038,2,State - HIMACHAL PRADESH,Urban,19,Middle,720,322,1042
19039,2,State - HIMACHAL PRADESH,Urban,20-24,Middle,3707,1861,5568
19040,2,State - HIMACHAL PRADESH,Urban,25-29,Middle,3674,2271,5945
19041,2,State - HIMACHAL PRADESH,Urban,30-34,Middle,3404,2250,5654
19042,2,State - HIMACHAL PRADESH,Urban,35-39,Middle,3101,2806,5907
19043,2,State - HIMACHAL PRADESH,Urban,40-44,Middle,2692,2460,5152
19044,2,State - HIMACHAL PRADESH,Urban,45-49,Middle,2399,2162,4561
19045,2,State - HIMACHAL PRADESH,Urban,50-54,Middle,1923,1520,3443
19046,2,State - HIMACHAL PRADESH,Urban,55-59,Middle,1336,1118,2454
19047,2,State - HIMACHAL PRADESH,Urban,60-64,Middle,906,790,1696
19048,2,State - HIMACHAL PRADESH,Urban,65-69,Middle,541,606,1147
19049,2,State - HIMACHAL PRADESH,Urban,70-74,Middle,409,434,843
19050,2,State - HIMACHAL PRADESH,Urban,75-79,Middle,268,277,545
19051,2,State - HIMACHAL PRADESH,Urban,80+,Middle,321,229,550
19052,2,State - HIMACHAL PRADESH,Urban,Age not stated,Middle,47,23,70
19053,3,State - PUNJAB,Total,All ages,Middle,1747063,1319242,3066305
19054,3,State - PUNJAB,Total,0-6,Middle,0,0,0
19055,3,State - PUNJAB,Total,7,Middle,0,0,0
19056,3,State - PUNJAB,Total,8,Middle,0,0,0
19057,3,State - PUNJAB,Total,9,Middle,0,0,0
19058,3,State - PUNJAB,Total,10,Middle,0,0,0
19059,3,State - PUNJAB,Total,11,Middle,0,0,0
19060,3,State - PUNJAB,Total,12,Middle,18147,17196,35343
19061,3,State - PUNJAB,Total,13,Middle,57072,55096,112168
19062,3,State - PUNJAB,Total,14,Middle,132488,119470,251958
19063,3,State - PUNJAB,Total,15,Middle,143150,112934,256084
19064,3,State - PUNJAB,Total,16,Middle,107535,75428,182963
19065,3,State - PUNJAB,Total,17,Middle,65455,42989,108444
19066,3,State - PUNJAB,Total,18,Middle,55278,36575,91853
19067,3,State - PUNJAB,Total,19,Middle,37321,27183,64504
19068,3,State - PUNJAB,Total,20-24,Middle,188453,150601,339054
19069,3,State - PUNJAB,Total,25-29,Middle,178540,138534,317074
19070,3,State - PUNJAB,Total,30-34,Middle,141419,114145,255564
19071,3,State - PUNJAB,Total,35-39,Middle,123489,108595,232084
19072,3,State - PUNJAB,Total,40-44,Middle,113121,96264,209385
19073,3,State - PUNJAB,Total,45-49,Middle,109935,77292,187227
19074,3,State - PUNJAB,Total,50-54,Middle,85698,52784,138482
19075,3,State - PUNJAB,Total,55-59,Middle,61956,35207,97163
19076,3,State - PUNJAB,Total,60-64,Middle,50497,27035,77532
19077,3,State - PUNJAB,Total,65-69,Middle,36185,14595,50780
19078,3,State - PUNJAB,Total,70-74,Middle,19859,7544,27403
19079,3,State - PUNJAB,Total,75-79,Middle,8871,3777,12648
19080,3,State - PUNJAB,Total,80+,Middle,10635,4407,15042
19081,3,State - PUNJAB,Total,Age not stated,Middle,1959,1591,3550
19082,3,State - PUNJAB,Rural,All ages,Middle,1117838,847405,1965243
19083,3,State - PUNJAB,Rural,0-6,Middle,0,0,0
19084,3,State - PUNJAB,Rural,7,Middle,0,0,0
19085,3,State - PUNJAB,Rural,8,Middle,0,0,0
19086,3,State - PUNJAB,Rural,9,Middle,0,0,0
19087,3,State - PUNJAB,Rural,10,Middle,0,0,0
19088,3,State - PUNJAB,Rural,11,Middle,0,0,0
19089,3,State - PUNJAB,Rural,12,Middle,10196,9829,20025
19090,3,State - PUNJAB,Rural,13,Middle,32490,32895,65385
19091,3,State - PUNJAB,Rural,14,Middle,78768,73575,152343
19092,3,State - PUNJAB,Rural,15,Middle,91533,73859,165392
19093,3,State - PUNJAB,Rural,16,Middle,73970,52112,126082
19094,3,State - PUNJAB,Rural,17,Middle,46244,30376,76620
19095,3,State - PUNJAB,Rural,18,Middle,37015,25789,62804
19096,3,State - PUNJAB,Rural,19,Middle,24433,19155,43588
19097,3,State - PUNJAB,Rural,20-24,Middle,122435,106108,228543
19098,3,State - PUNJAB,Rural,25-29,Middle,115706,96403,212109
19099,3,State - PUNJAB,Rural,30-34,Middle,91965,79219,171184
19100,3,State - PUNJAB,Rural,35-39,Middle,79143,72723,151866
19101,3,State - PUNJAB,Rural,40-44,Middle,71921,61813,133734
19102,3,State - PUNJAB,Rural,45-49,Middle,69173,45366,114539
19103,3,State - PUNJAB,Rural,50-54,Middle,52906,27842,80748
19104,3,State - PUNJAB,Rural,55-59,Middle,38147,16826,54973
19105,3,State - PUNJAB,Rural,60-64,Middle,32000,11547,43547
19106,3,State - PUNJAB,Rural,65-69,Middle,24058,5584,29642
19107,3,State - PUNJAB,Rural,70-74,Middle,12856,2413,15269
19108,3,State - PUNJAB,Rural,75-79,Middle,5150,1033,6183
19109,3,State - PUNJAB,Rural,80+,Middle,6312,1772,8084
19110,3,State - PUNJAB,Rural,Age not stated,Middle,1417,1166,2583
19111,3,State - PUNJAB,Urban,All ages,Middle,629225,471837,1101062
19112,3,State - PUNJAB,Urban,0-6,Middle,0,0,0
19113,3,State - PUNJAB,Urban,7,Middle,0,0,0
19114,3,State - PUNJAB,Urban,8,Middle,0,0,0
19115,3,State - PUNJAB,Urban,9,Middle,0,0,0
19116,3,State - PUNJAB,Urban,10,Middle,0,0,0
19117,3,State - PUNJAB,Urban,11,Middle,0,0,0
19118,3,State - PUNJAB,Urban,12,Middle,7951,7367,15318
19119,3,State - PUNJAB,Urban,13,Middle,24582,22201,46783
19120,3,State - PUNJAB,Urban,14,Middle,53720,45895,99615
19121,3,State - PUNJAB,Urban,15,Middle,51617,39075,90692
19122,3,State - PUNJAB,Urban,16,Middle,33565,23316,56881
19123,3,State - PUNJAB,Urban,17,Middle,19211,12613,31824
19124,3,State - PUNJAB,Urban,18,Middle,18263,10786,29049
19125,3,State - PUNJAB,Urban,19,Middle,12888,8028,20916
19126,3,State - PUNJAB,Urban,20-24,Middle,66018,44493,110511
19127,3,State - PUNJAB,Urban,25-29,Middle,62834,42131,104965
19128,3,State - PUNJAB,Urban,30-34,Middle,49454,34926,84380
19129,3,State - PUNJAB,Urban,35-39,Middle,44346,35872,80218
19130,3,State - PUNJAB,Urban,40-44,Middle,41200,34451,75651
19131,3,State - PUNJAB,Urban,45-49,Middle,40762,31926,72688
19132,3,State - PUNJAB,Urban,50-54,Middle,32792,24942,57734
19133,3,State - PUNJAB,Urban,55-59,Middle,23809,18381,42190
19134,3,State - PUNJAB,Urban,60-64,Middle,18497,15488,33985
19135,3,State - PUNJAB,Urban,65-69,Middle,12127,9011,21138
19136,3,State - PUNJAB,Urban,70-74,Middle,7003,5131,12134
19137,3,State - PUNJAB,Urban,75-79,Middle,3721,2744,6465
19138,3,State - PUNJAB,Urban,80+,Middle,4323,2635,6958
19139,3,State - PUNJAB,Urban,Age not stated,Middle,542,425,967
19140,4,State - CHANDIGARH,Total,All ages,Middle,67964,43915,111879
19141,4,State - CHANDIGARH,Total,0-6,Middle,0,0,0
19142,4,State - CHANDIGARH,Total,7,Middle,0,0,0
19143,4,State - CHANDIGARH,Total,8,Middle,0,0,0
19144,4,State - CHANDIGARH,Total,9,Middle,0,0,0
19145,4,State - CHANDIGARH,Total,10,Middle,0,0,0
19146,4,State - CHANDIGARH,Total,11,Middle,0,0,0
19147,4,State - CHANDIGARH,Total,12,Middle,526,389,915
19148,4,State - CHANDIGARH,Total,13,Middle,1916,1618,3534
19149,4,State - CHANDIGARH,Total,14,Middle,5010,4093,9103
19150,4,State - CHANDIGARH,Total,15,Middle,5294,4261,9555
19151,4,State - CHANDIGARH,Total,16,Middle,3840,2705,6545
19152,4,State - CHANDIGARH,Total,17,Middle,2338,1449,3787
19153,4,State - CHANDIGARH,Total,18,Middle,2607,1209,3816
19154,4,State - CHANDIGARH,Total,19,Middle,1763,868,2631
19155,4,State - CHANDIGARH,Total,20-24,Middle,8910,5143,14053
19156,4,State - CHANDIGARH,Total,25-29,Middle,8435,4858,13293
19157,4,State - CHANDIGARH,Total,30-34,Middle,6701,3749,10450
19158,4,State - CHANDIGARH,Total,35-39,Middle,5782,3417,9199
19159,4,State - CHANDIGARH,Total,40-44,Middle,4438,2724,7162
19160,4,State - CHANDIGARH,Total,45-49,Middle,3706,2288,5994
19161,4,State - CHANDIGARH,Total,50-54,Middle,2535,1588,4123
19162,4,State - CHANDIGARH,Total,55-59,Middle,1712,1018,2730
19163,4,State - CHANDIGARH,Total,60-64,Middle,1052,811,1863
19164,4,State - CHANDIGARH,Total,65-69,Middle,566,613,1179
19165,4,State - CHANDIGARH,Total,70-74,Middle,392,459,851
19166,4,State - CHANDIGARH,Total,75-79,Middle,189,323,512
19167,4,State - CHANDIGARH,Total,80+,Middle,241,319,560
19168,4,State - CHANDIGARH,Total,Age not stated,Middle,11,13,24
19169,4,State - CHANDIGARH,Rural,All ages,Middle,2269,1192,3461
19170,4,State - CHANDIGARH,Rural,0-6,Middle,0,0,0
19171,4,State - CHANDIGARH,Rural,7,Middle,0,0,0
19172,4,State - CHANDIGARH,Rural,8,Middle,0,0,0
19173,4,State - CHANDIGARH,Rural,9,Middle,0,0,0
19174,4,State - CHANDIGARH,Rural,10,Middle,0,0,0
19175,4,State - CHANDIGARH,Rural,11,Middle,0,0,0
19176,4,State - CHANDIGARH,Rural,12,Middle,12,6,18
19177,4,State - CHANDIGARH,Rural,13,Middle,28,25,53
19178,4,State - CHANDIGARH,Rural,14,Middle,88,78,166
19179,4,State - CHANDIGARH,Rural,15,Middle,133,108,241
19180,4,State - CHANDIGARH,Rural,16,Middle,99,57,156
19181,4,State - CHANDIGARH,Rural,17,Middle,79,40,119
19182,4,State - CHANDIGARH,Rural,18,Middle,113,24,137
19183,4,State - CHANDIGARH,Rural,19,Middle,75,33,108
19184,4,State - CHANDIGARH,Rural,20-24,Middle,372,192,564
19185,4,State - CHANDIGARH,Rural,25-29,Middle,370,196,566
19186,4,State - CHANDIGARH,Rural,30-34,Middle,283,127,410
19187,4,State - CHANDIGARH,Rural,35-39,Middle,208,111,319
19188,4,State - CHANDIGARH,Rural,40-44,Middle,146,79,225
19189,4,State - CHANDIGARH,Rural,45-49,Middle,98,48,146
19190,4,State - CHANDIGARH,Rural,50-54,Middle,63,31,94
19191,4,State - CHANDIGARH,Rural,55-59,Middle,43,14,57
19192,4,State - CHANDIGARH,Rural,60-64,Middle,33,9,42
19193,4,State - CHANDIGARH,Rural,65-69,Middle,13,7,20
19194,4,State - CHANDIGARH,Rural,70-74,Middle,8,4,12
19195,4,State - CHANDIGARH,Rural,75-79,Middle,2,1,3
19196,4,State - CHANDIGARH,Rural,80+,Middle,3,2,5
19197,4,State - CHANDIGARH,Rural,Age not stated,Middle,0,0,0
19198,4,State - CHANDIGARH,Urban,All ages,Middle,65695,42723,108418
19199,4,State - CHANDIGARH,Urban,0-6,Middle,0,0,0
19200,4,State - CHANDIGARH,Urban,7,Middle,0,0,0
19201,4,State - CHANDIGARH,Urban,8,Middle,0,0,0
19202,4,State - CHANDIGARH,Urban,9,Middle,0,0,0
19203,4,State - CHANDIGARH,Urban,10,Middle,0,0,0
19204,4,State - CHANDIGARH,Urban,11,Middle,0,0,0
19205,4,State - CHANDIGARH,Urban,12,Middle,514,383,897
19206,4,State - CHANDIGARH,Urban,13,Middle,1888,1593,3481
19207,4,State - CHANDIGARH,Urban,14,Middle,4922,4015,8937
19208,4,State - CHANDIGARH,Urban,15,Middle,5161,4153,9314
19209,4,State - CHANDIGARH,Urban,16,Middle,3741,2648,6389
19210,4,State - CHANDIGARH,Urban,17,Middle,2259,1409,3668
19211,4,State - CHANDIGARH,Urban,18,Middle,2494,1185,3679
19212,4,State - CHANDIGARH,Urban,19,Middle,1688,835,2523
19213,4,State - CHANDIGARH,Urban,20-24,Middle,8538,4951,13489
19214,4,State - CHANDIGARH,Urban,25-29,Middle,8065,4662,12727
19215,4,State - CHANDIGARH,Urban,30-34,Middle,6418,3622,10040
19216,4,State - CHANDIGARH,Urban,35-39,Middle,5574,3306,8880
19217,4,State - CHANDIGARH,Urban,40-44,Middle,4292,2645,6937
19218,4,State - CHANDIGARH,Urban,45-49,Middle,3608,2240,5848
19219,4,State - CHANDIGARH,Urban,50-54,Middle,2472,1557,4029
19220,4,State - CHANDIGARH,Urban,55-59,Middle,1669,1004,2673
19221,4,State - CHANDIGARH,Urban,60-64,Middle,1019,802,1821
19222,4,State - CHANDIGARH,Urban,65-69,Middle,553,606,1159
19223,4,State - CHANDIGARH,Urban,70-74,Middle,384,455,839
19224,4,State - CHANDIGARH,Urban,75-79,Middle,187,322,509
19225,4,State - CHANDIGARH,Urban,80+,Middle,238,317,555
19226,4,State - CHANDIGARH,Urban,Age not stated,Middle,11,13,24
19227,5,State - UTTARAKHAND,Total,All ages,Middle,806770,600101,1406871
19228,5,State - UTTARAKHAND,Total,0-6,Middle,0,0,0
19229,5,State - UTTARAKHAND,Total,7,Middle,0,0,0
19230,5,State - UTTARAKHAND,Total,8,Middle,0,0,0
19231,5,State - UTTARAKHAND,Total,9,Middle,0,0,0
19232,5,State - UTTARAKHAND,Total,10,Middle,0,0,0
19233,5,State - UTTARAKHAND,Total,11,Middle,0,0,0
19234,5,State - UTTARAKHAND,Total,12,Middle,12014,10505,22519
19235,5,State - UTTARAKHAND,Total,13,Middle,33004,29850,62854
19236,5,State - UTTARAKHAND,Total,14,Middle,64028,58660,122688
19237,5,State - UTTARAKHAND,Total,15,Middle,57645,50920,108565
19238,5,State - UTTARAKHAND,Total,16,Middle,43845,37852,81697
19239,5,State - UTTARAKHAND,Total,17,Middle,28922,24214,53136
19240,5,State - UTTARAKHAND,Total,18,Middle,30649,24610,55259
19241,5,State - UTTARAKHAND,Total,19,Middle,20314,17848,38162
19242,5,State - UTTARAKHAND,Total,20-24,Middle,95459,90651,186110
19243,5,State - UTTARAKHAND,Total,25-29,Middle,84564,70690,155254
19244,5,State - UTTARAKHAND,Total,30-34,Middle,69340,51010,120350
19245,5,State - UTTARAKHAND,Total,35-39,Middle,63759,41823,105582
19246,5,State - UTTARAKHAND,Total,40-44,Middle,52281,29636,81917
19247,5,State - UTTARAKHAND,Total,45-49,Middle,42029,21308,63337
19248,5,State - UTTARAKHAND,Total,50-54,Middle,30880,14021,44901
19249,5,State - UTTARAKHAND,Total,55-59,Middle,22866,9954,32820
19250,5,State - UTTARAKHAND,Total,60-64,Middle,22050,6720,28770
19251,5,State - UTTARAKHAND,Total,65-69,Middle,13795,4047,17842
19252,5,State - UTTARAKHAND,Total,70-74,Middle,9492,2262,11754
19253,5,State - UTTARAKHAND,Total,75-79,Middle,4372,1136,5508
19254,5,State - UTTARAKHAND,Total,80+,Middle,4377,1675,6052
19255,5,State - UTTARAKHAND,Total,Age not stated,Middle,1085,709,1794
19256,5,State - UTTARAKHAND,Rural,All ages,Middle,607483,448255,1055738
19257,5,State - UTTARAKHAND,Rural,0-6,Middle,0,0,0
19258,5,State - UTTARAKHAND,Rural,7,Middle,0,0,0
19259,5,State - UTTARAKHAND,Rural,8,Middle,0,0,0
19260,5,State - UTTARAKHAND,Rural,9,Middle,0,0,0
19261,5,State - UTTARAKHAND,Rural,10,Middle,0,0,0
19262,5,State - UTTARAKHAND,Rural,11,Middle,0,0,0
19263,5,State - UTTARAKHAND,Rural,12,Middle,8356,7327,15683
19264,5,State - UTTARAKHAND,Rural,13,Middle,23378,21195,44573
19265,5,State - UTTARAKHAND,Rural,14,Middle,45658,41792,87450
19266,5,State - UTTARAKHAND,Rural,15,Middle,42623,38497,81120
19267,5,State - UTTARAKHAND,Rural,16,Middle,33653,29959,63612
19268,5,State - UTTARAKHAND,Rural,17,Middle,22218,19548,41766
19269,5,State - UTTARAKHAND,Rural,18,Middle,23268,19960,43228
19270,5,State - UTTARAKHAND,Rural,19,Middle,15289,14685,29974
19271,5,State - UTTARAKHAND,Rural,20-24,Middle,71077,73974,145051
19272,5,State - UTTARAKHAND,Rural,25-29,Middle,63843,56464,120307
19273,5,State - UTTARAKHAND,Rural,30-34,Middle,53184,39618,92802
19274,5,State - UTTARAKHAND,Rural,35-39,Middle,49000,30373,79373
19275,5,State - UTTARAKHAND,Rural,40-44,Middle,40385,20109,60494
19276,5,State - UTTARAKHAND,Rural,45-49,Middle,31882,13313,45195
19277,5,State - UTTARAKHAND,Rural,50-54,Middle,23366,8381,31747
19278,5,State - UTTARAKHAND,Rural,55-59,Middle,17407,5521,22928
19279,5,State - UTTARAKHAND,Rural,60-64,Middle,17526,3225,20751
19280,5,State - UTTARAKHAND,Rural,65-69,Middle,10782,1788,12570
19281,5,State - UTTARAKHAND,Rural,70-74,Middle,7387,888,8275
19282,5,State - UTTARAKHAND,Rural,75-79,Middle,3412,370,3782
19283,5,State - UTTARAKHAND,Rural,80+,Middle,3060,784,3844
19284,5,State - UTTARAKHAND,Rural,Age not stated,Middle,729,484,1213
19285,5,State - UTTARAKHAND,Urban,All ages,Middle,199287,151846,351133
19286,5,State - UTTARAKHAND,Urban,0-6,Middle,0,0,0
19287,5,State - UTTARAKHAND,Urban,7,Middle,0,0,0
19288,5,State - UTTARAKHAND,Urban,8,Middle,0,0,0
19289,5,State - UTTARAKHAND,Urban,9,Middle,0,0,0
19290,5,State - UTTARAKHAND,Urban,10,Middle,0,0,0
19291,5,State - UTTARAKHAND,Urban,11,Middle,0,0,0
19292,5,State - UTTARAKHAND,Urban,12,Middle,3658,3178,6836
19293,5,State - UTTARAKHAND,Urban,13,Middle,9626,8655,18281
19294,5,State - UTTARAKHAND,Urban,14,Middle,18370,16868,35238
19295,5,State - UTTARAKHAND,Urban,15,Middle,15022,12423,27445
19296,5,State - UTTARAKHAND,Urban,16,Middle,10192,7893,18085
19297,5,State - UTTARAKHAND,Urban,17,Middle,6704,4666,11370
19298,5,State - UTTARAKHAND,Urban,18,Middle,7381,4650,12031
19299,5,State - UTTARAKHAND,Urban,19,Middle,5025,3163,8188
19300,5,State - UTTARAKHAND,Urban,20-24,Middle,24382,16677,41059
19301,5,State - UTTARAKHAND,Urban,25-29,Middle,20721,14226,34947
19302,5,State - UTTARAKHAND,Urban,30-34,Middle,16156,11392,27548
19303,5,State - UTTARAKHAND,Urban,35-39,Middle,14759,11450,26209
19304,5,State - UTTARAKHAND,Urban,40-44,Middle,11896,9527,21423
19305,5,State - UTTARAKHAND,Urban,45-49,Middle,10147,7995,18142
19306,5,State - UTTARAKHAND,Urban,50-54,Middle,7514,5640,13154
19307,5,State - UTTARAKHAND,Urban,55-59,Middle,5459,4433,9892
19308,5,State - UTTARAKHAND,Urban,60-64,Middle,4524,3495,8019
19309,5,State - UTTARAKHAND,Urban,65-69,Middle,3013,2259,5272
19310,5,State - UTTARAKHAND,Urban,70-74,Middle,2105,1374,3479
19311,5,State - UTTARAKHAND,Urban,75-79,Middle,960,766,1726
19312,5,State - UTTARAKHAND,Urban,80+,Middle,1317,891,2208
19313,5,State - UTTARAKHAND,Urban,Age not stated,Middle,356,225,581
19314,6,State - HARYANA,Total,All ages,Middle,1557670,1147612,2705282
19315,6,State - HARYANA,Total,0-6,Middle,0,0,0
19316,6,State - HARYANA,Total,7,Middle,0,0,0
19317,6,State - HARYANA,Total,8,Middle,0,0,0
19318,6,State - HARYANA,Total,9,Middle,0,0,0
19319,6,State - HARYANA,Total,10,Middle,0,0,0
19320,6,State - HARYANA,Total,11,Middle,0,0,0
19321,6,State - HARYANA,Total,12,Middle,23326,19640,42966
19322,6,State - HARYANA,Total,13,Middle,67947,59081,127028
19323,6,State - HARYANA,Total,14,Middle,149106,123514,272620
19324,6,State - HARYANA,Total,15,Middle,140129,108968,249097
19325,6,State - HARYANA,Total,16,Middle,90104,65557,155661
19326,6,State - HARYANA,Total,17,Middle,47407,34005,81412
19327,6,State - HARYANA,Total,18,Middle,43296,33396,76692
19328,6,State - HARYANA,Total,19,Middle,28399,25161,53560
19329,6,State - HARYANA,Total,20-24,Middle,161973,156601,318574
19330,6,State - HARYANA,Total,25-29,Middle,145101,139752,284853
19331,6,State - HARYANA,Total,30-34,Middle,138083,118035,256118
19332,6,State - HARYANA,Total,35-39,Middle,118248,85645,203893
19333,6,State - HARYANA,Total,40-44,Middle,100766,57880,158646
19334,6,State - HARYANA,Total,45-49,Middle,88831,41166,129997
19335,6,State - HARYANA,Total,50-54,Middle,69566,27345,96911
19336,6,State - HARYANA,Total,55-59,Middle,44743,18478,63221
19337,6,State - HARYANA,Total,60-64,Middle,45142,15526,60668
19338,6,State - HARYANA,Total,65-69,Middle,25150,7660,32810
19339,6,State - HARYANA,Total,70-74,Middle,14677,4166,18843
19340,6,State - HARYANA,Total,75-79,Middle,6569,2015,8584
19341,6,State - HARYANA,Total,80+,Middle,7521,2775,10296
19342,6,State - HARYANA,Total,Age not stated,Middle,1586,1246,2832
19343,6,State - HARYANA,Rural,All ages,Middle,1044222,746546,1790768
19344,6,State - HARYANA,Rural,0-6,Middle,0,0,0
19345,6,State - HARYANA,Rural,7,Middle,0,0,0
19346,6,State - HARYANA,Rural,8,Middle,0,0,0
19347,6,State - HARYANA,Rural,9,Middle,0,0,0
19348,6,State - HARYANA,Rural,10,Middle,0,0,0
19349,6,State - HARYANA,Rural,11,Middle,0,0,0
19350,6,State - HARYANA,Rural,12,Middle,14738,11971,26709
19351,6,State - HARYANA,Rural,13,Middle,43267,37116,80383
19352,6,State - HARYANA,Rural,14,Middle,96473,79928,176401
19353,6,State - HARYANA,Rural,15,Middle,95500,75040,170540
19354,6,State - HARYANA,Rural,16,Middle,63912,47198,111110
19355,6,State - HARYANA,Rural,17,Middle,33552,24537,58089
19356,6,State - HARYANA,Rural,18,Middle,29719,24375,54094
19357,6,State - HARYANA,Rural,19,Middle,19045,18478,37523
19358,6,State - HARYANA,Rural,20-24,Middle,109029,113341,222370
19359,6,State - HARYANA,Rural,25-29,Middle,95899,98227,194126
19360,6,State - HARYANA,Rural,30-34,Middle,94600,82368,176968
19361,6,State - HARYANA,Rural,35-39,Middle,79372,54506,133878
19362,6,State - HARYANA,Rural,40-44,Middle,66686,32098,98784
19363,6,State - HARYANA,Rural,45-49,Middle,58388,18809,77197
19364,6,State - HARYANA,Rural,50-54,Middle,46887,11378,58265
19365,6,State - HARYANA,Rural,55-59,Middle,30008,6742,36750
19366,6,State - HARYANA,Rural,60-64,Middle,30980,4995,35975
19367,6,State - HARYANA,Rural,65-69,Middle,16949,2181,19130
19368,6,State - HARYANA,Rural,70-74,Middle,9801,1038,10839
19369,6,State - HARYANA,Rural,75-79,Middle,4014,398,4412
19370,6,State - HARYANA,Rural,80+,Middle,4352,963,5315
19371,6,State - HARYANA,Rural,Age not stated,Middle,1051,859,1910
19372,6,State - HARYANA,Urban,All ages,Middle,513448,401066,914514
19373,6,State - HARYANA,Urban,0-6,Middle,0,0,0
19374,6,State - HARYANA,Urban,7,Middle,0,0,0
19375,6,State - HARYANA,Urban,8,Middle,0,0,0
19376,6,State - HARYANA,Urban,9,Middle,0,0,0
19377,6,State - HARYANA,Urban,10,Middle,0,0,0
19378,6,State - HARYANA,Urban,11,Middle,0,0,0
19379,6,State - HARYANA,Urban,12,Middle,8588,7669,16257
19380,6,State - HARYANA,Urban,13,Middle,24680,21965,46645
19381,6,State - HARYANA,Urban,14,Middle,52633,43586,96219
19382,6,State - HARYANA,Urban,15,Middle,44629,33928,78557
19383,6,State - HARYANA,Urban,16,Middle,26192,18359,44551
19384,6,State - HARYANA,Urban,17,Middle,13855,9468,23323
19385,6,State - HARYANA,Urban,18,Middle,13577,9021,22598
19386,6,State - HARYANA,Urban,19,Middle,9354,6683,16037
19387,6,State - HARYANA,Urban,20-24,Middle,52944,43260,96204
19388,6,State - HARYANA,Urban,25-29,Middle,49202,41525,90727
19389,6,State - HARYANA,Urban,30-34,Middle,43483,35667,79150
19390,6,State - HARYANA,Urban,35-39,Middle,38876,31139,70015
19391,6,State - HARYANA,Urban,40-44,Middle,34080,25782,59862
19392,6,State - HARYANA,Urban,45-49,Middle,30443,22357,52800
19393,6,State - HARYANA,Urban,50-54,Middle,22679,15967,38646
19394,6,State - HARYANA,Urban,55-59,Middle,14735,11736,26471
19395,6,State - HARYANA,Urban,60-64,Middle,14162,10531,24693
19396,6,State - HARYANA,Urban,65-69,Middle,8201,5479,13680
19397,6,State - HARYANA,Urban,70-74,Middle,4876,3128,8004
19398,6,State - HARYANA,Urban,75-79,Middle,2555,1617,4172
19399,6,State - HARYANA,Urban,80+,Middle,3169,1812,4981
19400,6,State - HARYANA,Urban,Age not stated,Middle,535,387,922
19401,7,State - NCT OF DELHI,Total,All ages,Middle,1099958,831453,1931411
19402,7,State - NCT OF DELHI,Total,0-6,Middle,0,0,0
19403,7,State - NCT OF DELHI,Total,7,Middle,0,0,0
19404,7,State - NCT OF DELHI,Total,8,Middle,0,0,0
19405,7,State - NCT OF DELHI,Total,9,Middle,0,0,0
19406,7,State - NCT OF DELHI,Total,10,Middle,0,0,0
19407,7,State - NCT OF DELHI,Total,11,Middle,0,0,0
19408,7,State - NCT OF DELHI,Total,12,Middle,13641,12696,26337
19409,7,State - NCT OF DELHI,Total,13,Middle,41399,39294,80693
19410,7,State - NCT OF DELHI,Total,14,Middle,95177,85624,180801
19411,7,State - NCT OF DELHI,Total,15,Middle,94616,78361,172977
19412,7,State - NCT OF DELHI,Total,16,Middle,64223,49671,113894
19413,7,State - NCT OF DELHI,Total,17,Middle,38443,27734,66177
19414,7,State - NCT OF DELHI,Total,18,Middle,36285,23827,60112
19415,7,State - NCT OF DELHI,Total,19,Middle,22951,15975,38926
19416,7,State - NCT OF DELHI,Total,20-24,Middle,128483,97148,225631
19417,7,State - NCT OF DELHI,Total,25-29,Middle,125761,93209,218970
19418,7,State - NCT OF DELHI,Total,30-34,Middle,105684,75795,181479
19419,7,State - NCT OF DELHI,Total,35-39,Middle,90960,63563,154523
19420,7,State - NCT OF DELHI,Total,40-44,Middle,69752,47027,116779
19421,7,State - NCT OF DELHI,Total,45-49,Middle,55674,36065,91739
19422,7,State - NCT OF DELHI,Total,50-54,Middle,37606,24614,62220
19423,7,State - NCT OF DELHI,Total,55-59,Middle,25013,18129,43142
19424,7,State - NCT OF DELHI,Total,60-64,Middle,23974,17221,41195
19425,7,State - NCT OF DELHI,Total,65-69,Middle,13208,9927,23135
19426,7,State - NCT OF DELHI,Total,70-74,Middle,7735,6693,14428
19427,7,State - NCT OF DELHI,Total,75-79,Middle,3981,4135,8116
19428,7,State - NCT OF DELHI,Total,80+,Middle,4506,4115,8621
19429,7,State - NCT OF DELHI,Total,Age not stated,Middle,886,630,1516
19430,7,State - NCT OF DELHI,Rural,All ages,Middle,30035,22704,52739
19431,7,State - NCT OF DELHI,Rural,0-6,Middle,0,0,0
19432,7,State - NCT OF DELHI,Rural,7,Middle,0,0,0
19433,7,State - NCT OF DELHI,Rural,8,Middle,0,0,0
19434,7,State - NCT OF DELHI,Rural,9,Middle,0,0,0
19435,7,State - NCT OF DELHI,Rural,10,Middle,0,0,0
19436,7,State - NCT OF DELHI,Rural,11,Middle,0,0,0
19437,7,State - NCT OF DELHI,Rural,12,Middle,405,349,754
19438,7,State - NCT OF DELHI,Rural,13,Middle,1240,1110,2350
19439,7,State - NCT OF DELHI,Rural,14,Middle,2589,2280,4869
19440,7,State - NCT OF DELHI,Rural,15,Middle,2518,2026,4544
19441,7,State - NCT OF DELHI,Rural,16,Middle,1932,1356,3288
19442,7,State - NCT OF DELHI,Rural,17,Middle,1113,764,1877
19443,7,State - NCT OF DELHI,Rural,18,Middle,941,627,1568
19444,7,State - NCT OF DELHI,Rural,19,Middle,609,406,1015
19445,7,State - NCT OF DELHI,Rural,20-24,Middle,3443,2763,6206
19446,7,State - NCT OF DELHI,Rural,25-29,Middle,3164,2677,5841
19447,7,State - NCT OF DELHI,Rural,30-34,Middle,2820,2520,5340
19448,7,State - NCT OF DELHI,Rural,35-39,Middle,2476,1946,4422
19449,7,State - NCT OF DELHI,Rural,40-44,Middle,1915,1425,3340
19450,7,State - NCT OF DELHI,Rural,45-49,Middle,1479,995,2474
19451,7,State - NCT OF DELHI,Rural,50-54,Middle,963,560,1523
19452,7,State - NCT OF DELHI,Rural,55-59,Middle,672,374,1046
19453,7,State - NCT OF DELHI,Rural,60-64,Middle,760,314,1074
19454,7,State - NCT OF DELHI,Rural,65-69,Middle,469,99,568
19455,7,State - NCT OF DELHI,Rural,70-74,Middle,287,43,330
19456,7,State - NCT OF DELHI,Rural,75-79,Middle,101,17,118
19457,7,State - NCT OF DELHI,Rural,80+,Middle,115,36,151
19458,7,State - NCT OF DELHI,Rural,Age not stated,Middle,24,17,41
19459,7,State - NCT OF DELHI,Urban,All ages,Middle,1069923,808749,1878672
19460,7,State - NCT OF DELHI,Urban,0-6,Middle,0,0,0
19461,7,State - NCT OF DELHI,Urban,7,Middle,0,0,0
19462,7,State - NCT OF DELHI,Urban,8,Middle,0,0,0
19463,7,State - NCT OF DELHI,Urban,9,Middle,0,0,0
19464,7,State - NCT OF DELHI,Urban,10,Middle,0,0,0
19465,7,State - NCT OF DELHI,Urban,11,Middle,0,0,0
19466,7,State - NCT OF DELHI,Urban,12,Middle,13236,12347,25583
19467,7,State - NCT OF DELHI,Urban,13,Middle,40159,38184,78343
19468,7,State - NCT OF DELHI,Urban,14,Middle,92588,83344,175932
19469,7,State - NCT OF DELHI,Urban,15,Middle,92098,76335,168433
19470,7,State - NCT OF DELHI,Urban,16,Middle,62291,48315,110606
19471,7,State - NCT OF DELHI,Urban,17,Middle,37330,26970,64300
19472,7,State - NCT OF DELHI,Urban,18,Middle,35344,23200,58544
19473,7,State - NCT OF DELHI,Urban,19,Middle,22342,15569,37911
19474,7,State - NCT OF DELHI,Urban,20-24,Middle,125040,94385,219425
19475,7,State - NCT OF DELHI,Urban,25-29,Middle,122597,90532,213129
19476,7,State - NCT OF DELHI,Urban,30-34,Middle,102864,73275,176139
19477,7,State - NCT OF DELHI,Urban,35-39,Middle,88484,61617,150101
19478,7,State - NCT OF DELHI,Urban,40-44,Middle,67837,45602,113439
19479,7,State - NCT OF DELHI,Urban,45-49,Middle,54195,35070,89265
19480,7,State - NCT OF DELHI,Urban,50-54,Middle,36643,24054,60697
19481,7,State - NCT OF DELHI,Urban,55-59,Middle,24341,17755,42096
19482,7,State - NCT OF DELHI,Urban,60-64,Middle,23214,16907,40121
19483,7,State - NCT OF DELHI,Urban,65-69,Middle,12739,9828,22567
19484,7,State - NCT OF DELHI,Urban,70-74,Middle,7448,6650,14098
19485,7,State - NCT OF DELHI,Urban,75-79,Middle,3880,4118,7998
19486,7,State - NCT OF DELHI,Urban,80+,Middle,4391,4079,8470
19487,7,State - NCT OF DELHI,Urban,Age not stated,Middle,862,613,1475
19488,8,State - RAJASTHAN,Total,All ages,Middle,4788350,2530873,7319223
19489,8,State - RAJASTHAN,Total,0-6,Middle,0,0,0
19490,8,State - RAJASTHAN,Total,7,Middle,0,0,0
19491,8,State - RAJASTHAN,Total,8,Middle,0,0,0
19492,8,State - RAJASTHAN,Total,9,Middle,0,0,0
19493,8,State - RAJASTHAN,Total,10,Middle,0,0,0
19494,8,State - RAJASTHAN,Total,11,Middle,0,0,0
19495,8,State - RAJASTHAN,Total,12,Middle,111591,79139,190730
19496,8,State - RAJASTHAN,Total,13,Middle,227062,169729,396791
19497,8,State - RAJASTHAN,Total,14,Middle,401723,287173,688896
19498,8,State - RAJASTHAN,Total,15,Middle,334622,229468,564090
19499,8,State - RAJASTHAN,Total,16,Middle,254178,175942,430120
19500,8,State - RAJASTHAN,Total,17,Middle,151881,109059,260940
19501,8,State - RAJASTHAN,Total,18,Middle,185006,129246,314252
19502,8,State - RAJASTHAN,Total,19,Middle,109342,82276,191618
19503,8,State - RAJASTHAN,Total,20-24,Middle,666009,392690,1058699
19504,8,State - RAJASTHAN,Total,25-29,Middle,548568,261303,809871
19505,8,State - RAJASTHAN,Total,30-34,Middle,465422,185706,651128
19506,8,State - RAJASTHAN,Total,35-39,Middle,405827,134585,540412
19507,8,State - RAJASTHAN,Total,40-44,Middle,299676,93284,392960
19508,8,State - RAJASTHAN,Total,45-49,Middle,209233,66322,275555
19509,8,State - RAJASTHAN,Total,50-54,Middle,152854,45403,198257
19510,8,State - RAJASTHAN,Total,55-59,Middle,97489,30496,127985
19511,8,State - RAJASTHAN,Total,60-64,Middle,68746,21900,90646
19512,8,State - RAJASTHAN,Total,65-69,Middle,38376,13415,51791
19513,8,State - RAJASTHAN,Total,70-74,Middle,22780,7167,29947
19514,8,State - RAJASTHAN,Total,75-79,Middle,10114,3330,13444
19515,8,State - RAJASTHAN,Total,80+,Middle,11819,4352,16171
19516,8,State - RAJASTHAN,Total,Age not stated,Middle,16032,8888,24920
19517,8,State - RAJASTHAN,Rural,All ages,Middle,3592691,1645783,5238474
19518,8,State - RAJASTHAN,Rural,0-6,Middle,0,0,0
19519,8,State - RAJASTHAN,Rural,7,Middle,0,0,0
19520,8,State - RAJASTHAN,Rural,8,Middle,0,0,0
19521,8,State - RAJASTHAN,Rural,9,Middle,0,0,0
19522,8,State - RAJASTHAN,Rural,10,Middle,0,0,0
19523,8,State - RAJASTHAN,Rural,11,Middle,0,0,0
19524,8,State - RAJASTHAN,Rural,12,Middle,82446,54262,136708
19525,8,State - RAJASTHAN,Rural,13,Middle,166926,116005,282931
19526,8,State - RAJASTHAN,Rural,14,Middle,298141,198997,497138
19527,8,State - RAJASTHAN,Rural,15,Middle,256820,168491,425311
19528,8,State - RAJASTHAN,Rural,16,Middle,202455,135441,337896
19529,8,State - RAJASTHAN,Rural,17,Middle,119724,83475,203199
19530,8,State - RAJASTHAN,Rural,18,Middle,147504,99432,246936
19531,8,State - RAJASTHAN,Rural,19,Middle,85031,61654,146685
19532,8,State - RAJASTHAN,Rural,20-24,Middle,520539,278239,798778
19533,8,State - RAJASTHAN,Rural,25-29,Middle,419039,167187,586226
19534,8,State - RAJASTHAN,Rural,30-34,Middle,354223,109650,463873
19535,8,State - RAJASTHAN,Rural,35-39,Middle,303323,68090,371413
19536,8,State - RAJASTHAN,Rural,40-44,Middle,217660,40476,258136
19537,8,State - RAJASTHAN,Rural,45-49,Middle,144395,23425,167820
19538,8,State - RAJASTHAN,Rural,50-54,Middle,102813,13613,116426
19539,8,State - RAJASTHAN,Rural,55-59,Middle,64102,8107,72209
19540,8,State - RAJASTHAN,Rural,60-64,Middle,45152,5335,50487
19541,8,State - RAJASTHAN,Rural,65-69,Middle,24339,3634,27973
19542,8,State - RAJASTHAN,Rural,70-74,Middle,13519,1530,15049
19543,8,State - RAJASTHAN,Rural,75-79,Middle,5344,580,5924
19544,8,State - RAJASTHAN,Rural,80+,Middle,6385,1607,7992
19545,8,State - RAJASTHAN,Rural,Age not stated,Middle,12811,6553,19364
19546,8,State - RAJASTHAN,Urban,All ages,Middle,1195659,885090,2080749
19547,8,State - RAJASTHAN,Urban,0-6,Middle,0,0,0
19548,8,State - RAJASTHAN,Urban,7,Middle,0,0,0
19549,8,State - RAJASTHAN,Urban,8,Middle,0,0,0
19550,8,State - RAJASTHAN,Urban,9,Middle,0,0,0
19551,8,State - RAJASTHAN,Urban,10,Middle,0,0,0
19552,8,State - RAJASTHAN,Urban,11,Middle,0,0,0
19553,8,State - RAJASTHAN,Urban,12,Middle,29145,24877,54022
19554,8,State - RAJASTHAN,Urban,13,Middle,60136,53724,113860
19555,8,State - RAJASTHAN,Urban,14,Middle,103582,88176,191758
19556,8,State - RAJASTHAN,Urban,15,Middle,77802,60977,138779
19557,8,State - RAJASTHAN,Urban,16,Middle,51723,40501,92224
19558,8,State - RAJASTHAN,Urban,17,Middle,32157,25584,57741
19559,8,State - RAJASTHAN,Urban,18,Middle,37502,29814,67316
19560,8,State - RAJASTHAN,Urban,19,Middle,24311,20622,44933
19561,8,State - RAJASTHAN,Urban,20-24,Middle,145470,114451,259921
19562,8,State - RAJASTHAN,Urban,25-29,Middle,129529,94116,223645
19563,8,State - RAJASTHAN,Urban,30-34,Middle,111199,76056,187255
19564,8,State - RAJASTHAN,Urban,35-39,Middle,102504,66495,168999
19565,8,State - RAJASTHAN,Urban,40-44,Middle,82016,52808,134824
19566,8,State - RAJASTHAN,Urban,45-49,Middle,64838,42897,107735
19567,8,State - RAJASTHAN,Urban,50-54,Middle,50041,31790,81831
19568,8,State - RAJASTHAN,Urban,55-59,Middle,33387,22389,55776
19569,8,State - RAJASTHAN,Urban,60-64,Middle,23594,16565,40159
19570,8,State - RAJASTHAN,Urban,65-69,Middle,14037,9781,23818
19571,8,State - RAJASTHAN,Urban,70-74,Middle,9261,5637,14898
19572,8,State - RAJASTHAN,Urban,75-79,Middle,4770,2750,7520
19573,8,State - RAJASTHAN,Urban,80+,Middle,5434,2745,8179
19574,8,State - RAJASTHAN,Urban,Age not stated,Middle,3221,2335,5556
19575,9,State - UTTAR PRADESH,Total,All ages,Middle,14276668,8846060,23122728
19576,9,State - UTTAR PRADESH,Total,0-6,Middle,0,0,0
19577,9,State - UTTAR PRADESH,Total,7,Middle,0,0,0
19578,9,State - UTTAR PRADESH,Total,8,Middle,0,0,0
19579,9,State - UTTAR PRADESH,Total,9,Middle,0,0,0
19580,9,State - UTTAR PRADESH,Total,10,Middle,0,0,0
19581,9,State - UTTAR PRADESH,Total,11,Middle,0,0,0
19582,9,State - UTTAR PRADESH,Total,12,Middle,319792,272415,592207
19583,9,State - UTTAR PRADESH,Total,13,Middle,577387,521826,1099213
19584,9,State - UTTAR PRADESH,Total,14,Middle,1148296,1009802,2158098
19585,9,State - UTTAR PRADESH,Total,15,Middle,987391,813076,1800467
19586,9,State - UTTAR PRADESH,Total,16,Middle,783588,641343,1424931
19587,9,State - UTTAR PRADESH,Total,17,Middle,493226,374584,867810
19588,9,State - UTTAR PRADESH,Total,18,Middle,671985,440731,1112716
19589,9,State - UTTAR PRADESH,Total,19,Middle,355764,239384,595148
19590,9,State - UTTAR PRADESH,Total,20-24,Middle,1798258,1119685,2917943
19591,9,State - UTTAR PRADESH,Total,25-29,Middle,1515683,877715,2393398
19592,9,State - UTTAR PRADESH,Total,30-34,Middle,1242240,699959,1942199
19593,9,State - UTTAR PRADESH,Total,35-39,Middle,1148303,565782,1714085
19594,9,State - UTTAR PRADESH,Total,40-44,Middle,867832,386550,1254382
19595,9,State - UTTAR PRADESH,Total,45-49,Middle,655766,275212,930978
19596,9,State - UTTAR PRADESH,Total,50-54,Middle,480879,182446,663325
19597,9,State - UTTAR PRADESH,Total,55-59,Middle,340722,132465,473187
19598,9,State - UTTAR PRADESH,Total,60-64,Middle,327773,96616,424389
19599,9,State - UTTAR PRADESH,Total,65-69,Middle,196585,59752,256337
19600,9,State - UTTAR PRADESH,Total,70-74,Middle,131212,31358,162570
19601,9,State - UTTAR PRADESH,Total,75-79,Middle,56145,16024,72169
19602,9,State - UTTAR PRADESH,Total,80+,Middle,86582,33584,120166
19603,9,State - UTTAR PRADESH,Total,Age not stated,Middle,91259,55751,147010
19604,9,State - UTTAR PRADESH,Rural,All ages,Middle,11539043,6760959,18300002
19605,9,State - UTTAR PRADESH,Rural,0-6,Middle,0,0,0
19606,9,State - UTTAR PRADESH,Rural,7,Middle,0,0,0
19607,9,State - UTTAR PRADESH,Rural,8,Middle,0,0,0
19608,9,State - UTTAR PRADESH,Rural,9,Middle,0,0,0
19609,9,State - UTTAR PRADESH,Rural,10,Middle,0,0,0
19610,9,State - UTTAR PRADESH,Rural,11,Middle,0,0,0
19611,9,State - UTTAR PRADESH,Rural,12,Middle,237703,195382,433085
19612,9,State - UTTAR PRADESH,Rural,13,Middle,435969,383706,819675
19613,9,State - UTTAR PRADESH,Rural,14,Middle,894240,771745,1665985
19614,9,State - UTTAR PRADESH,Rural,15,Middle,810998,663690,1474688
19615,9,State - UTTAR PRADESH,Rural,16,Middle,650310,531476,1181786
19616,9,State - UTTAR PRADESH,Rural,17,Middle,404660,306685,711345
19617,9,State - UTTAR PRADESH,Rural,18,Middle,558900,364235,923135
19618,9,State - UTTAR PRADESH,Rural,19,Middle,286662,192620,479282
19619,9,State - UTTAR PRADESH,Rural,20-24,Middle,1452243,892729,2344972
19620,9,State - UTTAR PRADESH,Rural,25-29,Middle,1239148,687940,1927088
19621,9,State - UTTAR PRADESH,Rural,30-34,Middle,1022305,539905,1562210
19622,9,State - UTTAR PRADESH,Rural,35-39,Middle,946001,415554,1361555
19623,9,State - UTTAR PRADESH,Rural,40-44,Middle,705212,268925,974137
19624,9,State - UTTAR PRADESH,Rural,45-49,Middle,523601,179175,702776
19625,9,State - UTTAR PRADESH,Rural,50-54,Middle,383062,114404,497466
19626,9,State - UTTAR PRADESH,Rural,55-59,Middle,271455,79639,351094
19627,9,State - UTTAR PRADESH,Rural,60-64,Middle,268560,55180,323740
19628,9,State - UTTAR PRADESH,Rural,65-69,Middle,160260,33688,193948
19629,9,State - UTTAR PRADESH,Rural,70-74,Middle,106491,15799,122290
19630,9,State - UTTAR PRADESH,Rural,75-79,Middle,44465,7920,52385
19631,9,State - UTTAR PRADESH,Rural,80+,Middle,67112,20959,88071
19632,9,State - UTTAR PRADESH,Rural,Age not stated,Middle,69686,39603,109289
19633,9,State - UTTAR PRADESH,Urban,All ages,Middle,2737625,2085101,4822726
19634,9,State - UTTAR PRADESH,Urban,0-6,Middle,0,0,0
19635,9,State - UTTAR PRADESH,Urban,7,Middle,0,0,0
19636,9,State - UTTAR PRADESH,Urban,8,Middle,0,0,0
19637,9,State - UTTAR PRADESH,Urban,9,Middle,0,0,0
19638,9,State - UTTAR PRADESH,Urban,10,Middle,0,0,0
19639,9,State - UTTAR PRADESH,Urban,11,Middle,0,0,0
19640,9,State - UTTAR PRADESH,Urban,12,Middle,82089,77033,159122
19641,9,State - UTTAR PRADESH,Urban,13,Middle,141418,138120,279538
19642,9,State - UTTAR PRADESH,Urban,14,Middle,254056,238057,492113
19643,9,State - UTTAR PRADESH,Urban,15,Middle,176393,149386,325779
19644,9,State - UTTAR PRADESH,Urban,16,Middle,133278,109867,243145
19645,9,State - UTTAR PRADESH,Urban,17,Middle,88566,67899,156465
19646,9,State - UTTAR PRADESH,Urban,18,Middle,113085,76496,189581
19647,9,State - UTTAR PRADESH,Urban,19,Middle,69102,46764,115866
19648,9,State - UTTAR PRADESH,Urban,20-24,Middle,346015,226956,572971
19649,9,State - UTTAR PRADESH,Urban,25-29,Middle,276535,189775,466310
19650,9,State - UTTAR PRADESH,Urban,30-34,Middle,219935,160054,379989
19651,9,State - UTTAR PRADESH,Urban,35-39,Middle,202302,150228,352530
19652,9,State - UTTAR PRADESH,Urban,40-44,Middle,162620,117625,280245
19653,9,State - UTTAR PRADESH,Urban,45-49,Middle,132165,96037,228202
19654,9,State - UTTAR PRADESH,Urban,50-54,Middle,97817,68042,165859
19655,9,State - UTTAR PRADESH,Urban,55-59,Middle,69267,52826,122093
19656,9,State - UTTAR PRADESH,Urban,60-64,Middle,59213,41436,100649
19657,9,State - UTTAR PRADESH,Urban,65-69,Middle,36325,26064,62389
19658,9,State - UTTAR PRADESH,Urban,70-74,Middle,24721,15559,40280
19659,9,State - UTTAR PRADESH,Urban,75-79,Middle,11680,8104,19784
19660,9,State - UTTAR PRADESH,Urban,80+,Middle,19470,12625,32095
19661,9,State - UTTAR PRADESH,Urban,Age not stated,Middle,21573,16148,37721
19662,10,State - BIHAR,Total,All ages,Middle,4930890,3038709,7969599
19663,10,State - BIHAR,Total,0-6,Middle,0,0,0
19664,10,State - BIHAR,Total,7,Middle,0,0,0
19665,10,State - BIHAR,Total,8,Middle,0,0,0
19666,10,State - BIHAR,Total,9,Middle,0,0,0
19667,10,State - BIHAR,Total,10,Middle,0,0,0
19668,10,State - BIHAR,Total,11,Middle,0,0,0
19669,10,State - BIHAR,Total,12,Middle,144722,112188,256910
19670,10,State - BIHAR,Total,13,Middle,247085,204597,451682
19671,10,State - BIHAR,Total,14,Middle,492465,393069,885534
19672,10,State - BIHAR,Total,15,Middle,386872,287996,674868
19673,10,State - BIHAR,Total,16,Middle,275064,202904,477968
19674,10,State - BIHAR,Total,17,Middle,144686,101304,245990
19675,10,State - BIHAR,Total,18,Middle,203350,121604,324954
19676,10,State - BIHAR,Total,19,Middle,99934,68500,168434
19677,10,State - BIHAR,Total,20-24,Middle,532195,329815,862010
19678,10,State - BIHAR,Total,25-29,Middle,483340,299313,782653
19679,10,State - BIHAR,Total,30-34,Middle,408661,247494,656155
19680,10,State - BIHAR,Total,35-39,Middle,343273,192876,536149
19681,10,State - BIHAR,Total,40-44,Middle,266433,134377,400810
19682,10,State - BIHAR,Total,45-49,Middle,216746,102109,318855
19683,10,State - BIHAR,Total,50-54,Middle,179379,70543,249922
19684,10,State - BIHAR,Total,55-59,Middle,130140,56288,186428
19685,10,State - BIHAR,Total,60-64,Middle,140585,46998,187583
19686,10,State - BIHAR,Total,65-69,Middle,101616,28836,130452
19687,10,State - BIHAR,Total,70-74,Middle,62977,13366,76343
19688,10,State - BIHAR,Total,75-79,Middle,26533,5896,32429
19689,10,State - BIHAR,Total,80+,Middle,30698,9303,40001
19690,10,State - BIHAR,Total,Age not stated,Middle,14136,9333,23469
19691,10,State - BIHAR,Rural,All ages,Middle,4333233,2540650,6873883
19692,10,State - BIHAR,Rural,0-6,Middle,0,0,0
19693,10,State - BIHAR,Rural,7,Middle,0,0,0
19694,10,State - BIHAR,Rural,8,Middle,0,0,0
19695,10,State - BIHAR,Rural,9,Middle,0,0,0
19696,10,State - BIHAR,Rural,10,Middle,0,0,0
19697,10,State - BIHAR,Rural,11,Middle,0,0,0
19698,10,State - BIHAR,Rural,12,Middle,121346,91058,212404
19699,10,State - BIHAR,Rural,13,Middle,207798,167427,375225
19700,10,State - BIHAR,Rural,14,Middle,420152,326794,746946
19701,10,State - BIHAR,Rural,15,Middle,341415,248600,590015
19702,10,State - BIHAR,Rural,16,Middle,243432,175751,419183
19703,10,State - BIHAR,Rural,17,Middle,127723,87638,215361
19704,10,State - BIHAR,Rural,18,Middle,181827,106491,288318
19705,10,State - BIHAR,Rural,19,Middle,89094,60296,149390
19706,10,State - BIHAR,Rural,20-24,Middle,475124,287376,762500
19707,10,State - BIHAR,Rural,25-29,Middle,432344,256808,689152
19708,10,State - BIHAR,Rural,30-34,Middle,365936,209823,575759
19709,10,State - BIHAR,Rural,35-39,Middle,305122,159227,464349
19710,10,State - BIHAR,Rural,40-44,Middle,233727,107180,340907
19711,10,State - BIHAR,Rural,45-49,Middle,188023,78514,266537
19712,10,State - BIHAR,Rural,50-54,Middle,155558,52740,208298
19713,10,State - BIHAR,Rural,55-59,Middle,112846,41690,154536
19714,10,State - BIHAR,Rural,60-64,Middle,124018,34450,158468
19715,10,State - BIHAR,Rural,65-69,Middle,90118,20962,111080
19716,10,State - BIHAR,Rural,70-74,Middle,55398,9330,64728
19717,10,State - BIHAR,Rural,75-79,Middle,23198,3976,27174
19718,10,State - BIHAR,Rural,80+,Middle,26790,7000,33790
19719,10,State - BIHAR,Rural,Age not stated,Middle,12244,7519,19763
19720,10,State - BIHAR,Urban,All ages,Middle,597657,498059,1095716
19721,10,State - BIHAR,Urban,0-6,Middle,0,0,0
19722,10,State - BIHAR,Urban,7,Middle,0,0,0
19723,10,State - BIHAR,Urban,8,Middle,0,0,0
19724,10,State - BIHAR,Urban,9,Middle,0,0,0
19725,10,State - BIHAR,Urban,10,Middle,0,0,0
19726,10,State - BIHAR,Urban,11,Middle,0,0,0
19727,10,State - BIHAR,Urban,12,Middle,23376,21130,44506
19728,10,State - BIHAR,Urban,13,Middle,39287,37170,76457
19729,10,State - BIHAR,Urban,14,Middle,72313,66275,138588
19730,10,State - BIHAR,Urban,15,Middle,45457,39396,84853
19731,10,State - BIHAR,Urban,16,Middle,31632,27153,58785
19732,10,State - BIHAR,Urban,17,Middle,16963,13666,30629
19733,10,State - BIHAR,Urban,18,Middle,21523,15113,36636
19734,10,State - BIHAR,Urban,19,Middle,10840,8204,19044
19735,10,State - BIHAR,Urban,20-24,Middle,57071,42439,99510
19736,10,State - BIHAR,Urban,25-29,Middle,50996,42505,93501
19737,10,State - BIHAR,Urban,30-34,Middle,42725,37671,80396
19738,10,State - BIHAR,Urban,35-39,Middle,38151,33649,71800
19739,10,State - BIHAR,Urban,40-44,Middle,32706,27197,59903
19740,10,State - BIHAR,Urban,45-49,Middle,28723,23595,52318
19741,10,State - BIHAR,Urban,50-54,Middle,23821,17803,41624
19742,10,State - BIHAR,Urban,55-59,Middle,17294,14598,31892
19743,10,State - BIHAR,Urban,60-64,Middle,16567,12548,29115
19744,10,State - BIHAR,Urban,65-69,Middle,11498,7874,19372
19745,10,State - BIHAR,Urban,70-74,Middle,7579,4036,11615
19746,10,State - BIHAR,Urban,75-79,Middle,3335,1920,5255
19747,10,State - BIHAR,Urban,80+,Middle,3908,2303,6211
19748,10,State - BIHAR,Urban,Age not stated,Middle,1892,1814,3706
19749,11,State - SIKKIM,Total,All ages,Middle,37520,32025,69545
19750,11,State - SIKKIM,Total,0-6,Middle,0,0,0
19751,11,State - SIKKIM,Total,7,Middle,0,0,0
19752,11,State - SIKKIM,Total,8,Middle,0,0,0
19753,11,State - SIKKIM,Total,9,Middle,0,0,0
19754,11,State - SIKKIM,Total,10,Middle,0,0,0
19755,11,State - SIKKIM,Total,11,Middle,0,0,0
19756,11,State - SIKKIM,Total,12,Middle,407,487,894
19757,11,State - SIKKIM,Total,13,Middle,1054,1197,2251
19758,11,State - SIKKIM,Total,14,Middle,1901,2145,4046
19759,11,State - SIKKIM,Total,15,Middle,1953,2238,4191
19760,11,State - SIKKIM,Total,16,Middle,1994,2375,4369
19761,11,State - SIKKIM,Total,17,Middle,1751,1997,3748
19762,11,State - SIKKIM,Total,18,Middle,1617,1779,3396
19763,11,State - SIKKIM,Total,19,Middle,1166,1390,2556
19764,11,State - SIKKIM,Total,20-24,Middle,4958,5035,9993
19765,11,State - SIKKIM,Total,25-29,Middle,4916,4251,9167
19766,11,State - SIKKIM,Total,30-34,Middle,4525,3147,7672
19767,11,State - SIKKIM,Total,35-39,Middle,3568,2439,6007
19768,11,State - SIKKIM,Total,40-44,Middle,2902,1560,4462
19769,11,State - SIKKIM,Total,45-49,Middle,1847,826,2673
19770,11,State - SIKKIM,Total,50-54,Middle,1174,504,1678
19771,11,State - SIKKIM,Total,55-59,Middle,703,232,935
19772,11,State - SIKKIM,Total,60-64,Middle,417,143,560
19773,11,State - SIKKIM,Total,65-69,Middle,296,134,430
19774,11,State - SIKKIM,Total,70-74,Middle,142,41,183
19775,11,State - SIKKIM,Total,75-79,Middle,57,20,77
19776,11,State - SIKKIM,Total,80+,Middle,99,43,142
19777,11,State - SIKKIM,Total,Age not stated,Middle,73,42,115
19778,11,State - SIKKIM,Rural,All ages,Middle,26434,22517,48951
19779,11,State - SIKKIM,Rural,0-6,Middle,0,0,0
19780,11,State - SIKKIM,Rural,7,Middle,0,0,0
19781,11,State - SIKKIM,Rural,8,Middle,0,0,0
19782,11,State - SIKKIM,Rural,9,Middle,0,0,0
19783,11,State - SIKKIM,Rural,10,Middle,0,0,0
19784,11,State - SIKKIM,Rural,11,Middle,0,0,0
19785,11,State - SIKKIM,Rural,12,Middle,273,301,574
19786,11,State - SIKKIM,Rural,13,Middle,668,795,1463
19787,11,State - SIKKIM,Rural,14,Middle,1235,1456,2691
19788,11,State - SIKKIM,Rural,15,Middle,1340,1574,2914
19789,11,State - SIKKIM,Rural,16,Middle,1419,1798,3217
19790,11,State - SIKKIM,Rural,17,Middle,1322,1568,2890
19791,11,State - SIKKIM,Rural,18,Middle,1241,1427,2668
19792,11,State - SIKKIM,Rural,19,Middle,895,1119,2014
19793,11,State - SIKKIM,Rural,20-24,Middle,3639,3722,7361
19794,11,State - SIKKIM,Rural,25-29,Middle,3524,2989,6513
19795,11,State - SIKKIM,Rural,30-34,Middle,3251,2192,5443
19796,11,State - SIKKIM,Rural,35-39,Middle,2563,1641,4204
19797,11,State - SIKKIM,Rural,40-44,Middle,2062,938,3000
19798,11,State - SIKKIM,Rural,45-49,Middle,1175,448,1623
19799,11,State - SIKKIM,Rural,50-54,Middle,729,227,956
19800,11,State - SIKKIM,Rural,55-59,Middle,408,104,512
19801,11,State - SIKKIM,Rural,60-64,Middle,251,66,317
19802,11,State - SIKKIM,Rural,65-69,Middle,186,67,253
19803,11,State - SIKKIM,Rural,70-74,Middle,87,13,100
19804,11,State - SIKKIM,Rural,75-79,Middle,34,14,48
19805,11,State - SIKKIM,Rural,80+,Middle,70,24,94
19806,11,State - SIKKIM,Rural,Age not stated,Middle,62,34,96
19807,11,State - SIKKIM,Urban,All ages,Middle,11086,9508,20594
19808,11,State - SIKKIM,Urban,0-6,Middle,0,0,0
19809,11,State - SIKKIM,Urban,7,Middle,0,0,0
19810,11,State - SIKKIM,Urban,8,Middle,0,0,0
19811,11,State - SIKKIM,Urban,9,Middle,0,0,0
19812,11,State - SIKKIM,Urban,10,Middle,0,0,0
19813,11,State - SIKKIM,Urban,11,Middle,0,0,0
19814,11,State - SIKKIM,Urban,12,Middle,134,186,320
19815,11,State - SIKKIM,Urban,13,Middle,386,402,788
19816,11,State - SIKKIM,Urban,14,Middle,666,689,1355
19817,11,State - SIKKIM,Urban,15,Middle,613,664,1277
19818,11,State - SIKKIM,Urban,16,Middle,575,577,1152
19819,11,State - SIKKIM,Urban,17,Middle,429,429,858
19820,11,State - SIKKIM,Urban,18,Middle,376,352,728
19821,11,State - SIKKIM,Urban,19,Middle,271,271,542
19822,11,State - SIKKIM,Urban,20-24,Middle,1319,1313,2632
19823,11,State - SIKKIM,Urban,25-29,Middle,1392,1262,2654
19824,11,State - SIKKIM,Urban,30-34,Middle,1274,955,2229
19825,11,State - SIKKIM,Urban,35-39,Middle,1005,798,1803
19826,11,State - SIKKIM,Urban,40-44,Middle,840,622,1462
19827,11,State - SIKKIM,Urban,45-49,Middle,672,378,1050
19828,11,State - SIKKIM,Urban,50-54,Middle,445,277,722
19829,11,State - SIKKIM,Urban,55-59,Middle,295,128,423
19830,11,State - SIKKIM,Urban,60-64,Middle,166,77,243
19831,11,State - SIKKIM,Urban,65-69,Middle,110,67,177
19832,11,State - SIKKIM,Urban,70-74,Middle,55,28,83
19833,11,State - SIKKIM,Urban,75-79,Middle,23,6,29
19834,11,State - SIKKIM,Urban,80+,Middle,29,19,48
19835,11,State - SIKKIM,Urban,Age not stated,Middle,11,8,19
19836,12,State - ARUNACHAL PRADESH,Total,All ages,Middle,82535,63313,145848
19837,12,State - ARUNACHAL PRADESH,Total,0-6,Middle,0,0,0
19838,12,State - ARUNACHAL PRADESH,Total,7,Middle,0,0,0
19839,12,State - ARUNACHAL PRADESH,Total,8,Middle,0,0,0
19840,12,State - ARUNACHAL PRADESH,Total,9,Middle,0,0,0
19841,12,State - ARUNACHAL PRADESH,Total,10,Middle,0,0,0
19842,12,State - ARUNACHAL PRADESH,Total,11,Middle,0,0,0
19843,12,State - ARUNACHAL PRADESH,Total,12,Middle,1389,1263,2652
19844,12,State - ARUNACHAL PRADESH,Total,13,Middle,2956,2973,5929
19845,12,State - ARUNACHAL PRADESH,Total,14,Middle,6014,5796,11810
19846,12,State - ARUNACHAL PRADESH,Total,15,Middle,5841,5550,11391
19847,12,State - ARUNACHAL PRADESH,Total,16,Middle,4936,4674,9610
19848,12,State - ARUNACHAL PRADESH,Total,17,Middle,3784,3218,7002
19849,12,State - ARUNACHAL PRADESH,Total,18,Middle,3836,3414,7250
19850,12,State - ARUNACHAL PRADESH,Total,19,Middle,2560,2331,4891
19851,12,State - ARUNACHAL PRADESH,Total,20-24,Middle,10524,9990,20514
19852,12,State - ARUNACHAL PRADESH,Total,25-29,Middle,9798,8345,18143
19853,12,State - ARUNACHAL PRADESH,Total,30-34,Middle,8382,5893,14275
19854,12,State - ARUNACHAL PRADESH,Total,35-39,Middle,7437,4628,12065
19855,12,State - ARUNACHAL PRADESH,Total,40-44,Middle,5974,2588,8562
19856,12,State - ARUNACHAL PRADESH,Total,45-49,Middle,4194,1370,5564
19857,12,State - ARUNACHAL PRADESH,Total,50-54,Middle,2341,553,2894
19858,12,State - ARUNACHAL PRADESH,Total,55-59,Middle,1073,217,1290
19859,12,State - ARUNACHAL PRADESH,Total,60-64,Middle,646,148,794
19860,12,State - ARUNACHAL PRADESH,Total,65-69,Middle,330,122,452
19861,12,State - ARUNACHAL PRADESH,Total,70-74,Middle,174,47,221
19862,12,State - ARUNACHAL PRADESH,Total,75-79,Middle,88,23,111
19863,12,State - ARUNACHAL PRADESH,Total,80+,Middle,197,121,318
19864,12,State - ARUNACHAL PRADESH,Total,Age not stated,Middle,61,49,110
19865,12,State - ARUNACHAL PRADESH,Rural,All ages,Middle,58908,44158,103066
19866,12,State - ARUNACHAL PRADESH,Rural,0-6,Middle,0,0,0
19867,12,State - ARUNACHAL PRADESH,Rural,7,Middle,0,0,0
19868,12,State - ARUNACHAL PRADESH,Rural,8,Middle,0,0,0
19869,12,State - ARUNACHAL PRADESH,Rural,9,Middle,0,0,0
19870,12,State - ARUNACHAL PRADESH,Rural,10,Middle,0,0,0
19871,12,State - ARUNACHAL PRADESH,Rural,11,Middle,0,0,0
19872,12,State - ARUNACHAL PRADESH,Rural,12,Middle,985,853,1838
19873,12,State - ARUNACHAL PRADESH,Rural,13,Middle,1981,1959,3940
19874,12,State - ARUNACHAL PRADESH,Rural,14,Middle,4061,3841,7902
19875,12,State - ARUNACHAL PRADESH,Rural,15,Middle,4059,3772,7831
19876,12,State - ARUNACHAL PRADESH,Rural,16,Middle,3533,3311,6844
19877,12,State - ARUNACHAL PRADESH,Rural,17,Middle,2815,2416,5231
19878,12,State - ARUNACHAL PRADESH,Rural,18,Middle,2986,2713,5699
19879,12,State - ARUNACHAL PRADESH,Rural,19,Middle,1995,1795,3790
19880,12,State - ARUNACHAL PRADESH,Rural,20-24,Middle,8151,7484,15635
19881,12,State - ARUNACHAL PRADESH,Rural,25-29,Middle,7225,5894,13119
19882,12,State - ARUNACHAL PRADESH,Rural,30-34,Middle,6073,4078,10151
19883,12,State - ARUNACHAL PRADESH,Rural,35-39,Middle,5221,2978,8199
19884,12,State - ARUNACHAL PRADESH,Rural,40-44,Middle,3883,1572,5455
19885,12,State - ARUNACHAL PRADESH,Rural,45-49,Middle,2681,767,3448
19886,12,State - ARUNACHAL PRADESH,Rural,50-54,Middle,1489,289,1778
19887,12,State - ARUNACHAL PRADESH,Rural,55-59,Middle,697,118,815
19888,12,State - ARUNACHAL PRADESH,Rural,60-64,Middle,453,80,533
19889,12,State - ARUNACHAL PRADESH,Rural,65-69,Middle,246,75,321
19890,12,State - ARUNACHAL PRADESH,Rural,70-74,Middle,124,30,154
19891,12,State - ARUNACHAL PRADESH,Rural,75-79,Middle,62,11,73
19892,12,State - ARUNACHAL PRADESH,Rural,80+,Middle,146,80,226
19893,12,State - ARUNACHAL PRADESH,Rural,Age not stated,Middle,42,42,84
19894,12,State - ARUNACHAL PRADESH,Urban,All ages,Middle,23627,19155,42782
19895,12,State - ARUNACHAL PRADESH,Urban,0-6,Middle,0,0,0
19896,12,State - ARUNACHAL PRADESH,Urban,7,Middle,0,0,0
19897,12,State - ARUNACHAL PRADESH,Urban,8,Middle,0,0,0
19898,12,State - ARUNACHAL PRADESH,Urban,9,Middle,0,0,0
19899,12,State - ARUNACHAL PRADESH,Urban,10,Middle,0,0,0
19900,12,State - ARUNACHAL PRADESH,Urban,11,Middle,0,0,0
19901,12,State - ARUNACHAL PRADESH,Urban,12,Middle,404,410,814
19902,12,State - ARUNACHAL PRADESH,Urban,13,Middle,975,1014,1989
19903,12,State - ARUNACHAL PRADESH,Urban,14,Middle,1953,1955,3908
19904,12,State - ARUNACHAL PRADESH,Urban,15,Middle,1782,1778,3560
19905,12,State - ARUNACHAL PRADESH,Urban,16,Middle,1403,1363,2766
19906,12,State - ARUNACHAL PRADESH,Urban,17,Middle,969,802,1771
19907,12,State - ARUNACHAL PRADESH,Urban,18,Middle,850,701,1551
19908,12,State - ARUNACHAL PRADESH,Urban,19,Middle,565,536,1101
19909,12,State - ARUNACHAL PRADESH,Urban,20-24,Middle,2373,2506,4879
19910,12,State - ARUNACHAL PRADESH,Urban,25-29,Middle,2573,2451,5024
19911,12,State - ARUNACHAL PRADESH,Urban,30-34,Middle,2309,1815,4124
19912,12,State - ARUNACHAL PRADESH,Urban,35-39,Middle,2216,1650,3866
19913,12,State - ARUNACHAL PRADESH,Urban,40-44,Middle,2091,1016,3107
19914,12,State - ARUNACHAL PRADESH,Urban,45-49,Middle,1513,603,2116
19915,12,State - ARUNACHAL PRADESH,Urban,50-54,Middle,852,264,1116
19916,12,State - ARUNACHAL PRADESH,Urban,55-59,Middle,376,99,475
19917,12,State - ARUNACHAL PRADESH,Urban,60-64,Middle,193,68,261
19918,12,State - ARUNACHAL PRADESH,Urban,65-69,Middle,84,47,131
19919,12,State - ARUNACHAL PRADESH,Urban,70-74,Middle,50,17,67
19920,12,State - ARUNACHAL PRADESH,Urban,75-79,Middle,26,12,38
19921,12,State - ARUNACHAL PRADESH,Urban,80+,Middle,51,41,92
19922,12,State - ARUNACHAL PRADESH,Urban,Age not stated,Middle,19,7,26
19923,13,State - NAGALAND,Total,All ages,Middle,164734,139877,304611
19924,13,State - NAGALAND,Total,0-6,Middle,0,0,0
19925,13,State - NAGALAND,Total,7,Middle,0,0,0
19926,13,State - NAGALAND,Total,8,Middle,0,0,0
19927,13,State - NAGALAND,Total,9,Middle,0,0,0
19928,13,State - NAGALAND,Total,10,Middle,0,0,0
19929,13,State - NAGALAND,Total,11,Middle,0,0,0
19930,13,State - NAGALAND,Total,12,Middle,1774,1884,3658
19931,13,State - NAGALAND,Total,13,Middle,4772,4891,9663
19932,13,State - NAGALAND,Total,14,Middle,9754,9668,19422
19933,13,State - NAGALAND,Total,15,Middle,10964,10208,21172
19934,13,State - NAGALAND,Total,16,Middle,9806,9208,19014
19935,13,State - NAGALAND,Total,17,Middle,6956,6469,13425
19936,13,State - NAGALAND,Total,18,Middle,6587,6075,12662
19937,13,State - NAGALAND,Total,19,Middle,4656,4185,8841
19938,13,State - NAGALAND,Total,20-24,Middle,21516,19827,41343
19939,13,State - NAGALAND,Total,25-29,Middle,18837,17412,36249
19940,13,State - NAGALAND,Total,30-34,Middle,16312,14471,30783
19941,13,State - NAGALAND,Total,35-39,Middle,13743,12258,26001
19942,13,State - NAGALAND,Total,40-44,Middle,12702,9303,22005
19943,13,State - NAGALAND,Total,45-49,Middle,9855,5929,15784
19944,13,State - NAGALAND,Total,50-54,Middle,6307,3552,9859
19945,13,State - NAGALAND,Total,55-59,Middle,3769,1917,5686
19946,13,State - NAGALAND,Total,60-64,Middle,2813,1222,4035
19947,13,State - NAGALAND,Total,65-69,Middle,1647,729,2376
19948,13,State - NAGALAND,Total,70-74,Middle,906,290,1196
19949,13,State - NAGALAND,Total,75-79,Middle,473,132,605
19950,13,State - NAGALAND,Total,80+,Middle,498,192,690
19951,13,State - NAGALAND,Total,Age not stated,Middle,87,55,142
19952,13,State - NAGALAND,Rural,All ages,Middle,111718,92703,204421
19953,13,State - NAGALAND,Rural,0-6,Middle,0,0,0
19954,13,State - NAGALAND,Rural,7,Middle,0,0,0
19955,13,State - NAGALAND,Rural,8,Middle,0,0,0
19956,13,State - NAGALAND,Rural,9,Middle,0,0,0
19957,13,State - NAGALAND,Rural,10,Middle,0,0,0
19958,13,State - NAGALAND,Rural,11,Middle,0,0,0
19959,13,State - NAGALAND,Rural,12,Middle,1147,1205,2352
19960,13,State - NAGALAND,Rural,13,Middle,2856,2825,5681
19961,13,State - NAGALAND,Rural,14,Middle,6129,5869,11998
19962,13,State - NAGALAND,Rural,15,Middle,7248,6653,13901
19963,13,State - NAGALAND,Rural,16,Middle,6524,6198,12722
19964,13,State - NAGALAND,Rural,17,Middle,4862,4453,9315
19965,13,State - NAGALAND,Rural,18,Middle,4823,4385,9208
19966,13,State - NAGALAND,Rural,19,Middle,3325,3060,6385
19967,13,State - NAGALAND,Rural,20-24,Middle,15213,13930,29143
19968,13,State - NAGALAND,Rural,25-29,Middle,12648,11666,24314
19969,13,State - NAGALAND,Rural,30-34,Middle,11342,9694,21036
19970,13,State - NAGALAND,Rural,35-39,Middle,9325,8164,17489
19971,13,State - NAGALAND,Rural,40-44,Middle,8434,6107,14541
19972,13,State - NAGALAND,Rural,45-49,Middle,6555,3704,10259
19973,13,State - NAGALAND,Rural,50-54,Middle,4243,2149,6392
19974,13,State - NAGALAND,Rural,55-59,Middle,2539,1124,3663
19975,13,State - NAGALAND,Rural,60-64,Middle,1968,704,2672
19976,13,State - NAGALAND,Rural,65-69,Middle,1152,435,1587
19977,13,State - NAGALAND,Rural,70-74,Middle,636,150,786
19978,13,State - NAGALAND,Rural,75-79,Middle,323,66,389
19979,13,State - NAGALAND,Rural,80+,Middle,361,113,474
19980,13,State - NAGALAND,Rural,Age not stated,Middle,65,49,114
19981,13,State - NAGALAND,Urban,All ages,Middle,53016,47174,100190
19982,13,State - NAGALAND,Urban,0-6,Middle,0,0,0
19983,13,State - NAGALAND,Urban,7,Middle,0,0,0
19984,13,State - NAGALAND,Urban,8,Middle,0,0,0
19985,13,State - NAGALAND,Urban,9,Middle,0,0,0
19986,13,State - NAGALAND,Urban,10,Middle,0,0,0
19987,13,State - NAGALAND,Urban,11,Middle,0,0,0
19988,13,State - NAGALAND,Urban,12,Middle,627,679,1306
19989,13,State - NAGALAND,Urban,13,Middle,1916,2066,3982
19990,13,State - NAGALAND,Urban,14,Middle,3625,3799,7424
19991,13,State - NAGALAND,Urban,15,Middle,3716,3555,7271
19992,13,State - NAGALAND,Urban,16,Middle,3282,3010,6292
19993,13,State - NAGALAND,Urban,17,Middle,2094,2016,4110
19994,13,State - NAGALAND,Urban,18,Middle,1764,1690,3454
19995,13,State - NAGALAND,Urban,19,Middle,1331,1125,2456
19996,13,State - NAGALAND,Urban,20-24,Middle,6303,5897,12200
19997,13,State - NAGALAND,Urban,25-29,Middle,6189,5746,11935
19998,13,State - NAGALAND,Urban,30-34,Middle,4970,4777,9747
19999,13,State - NAGALAND,Urban,35-39,Middle,4418,4094,8512
20000,13,State - NAGALAND,Urban,40-44,Middle,4268,3196,7464
20001,13,State - NAGALAND,Urban,45-49,Middle,3300,2225,5525
20002,13,State - NAGALAND,Urban,50-54,Middle,2064,1403,3467
20003,13,State - NAGALAND,Urban,55-59,Middle,1230,793,2023
20004,13,State - NAGALAND,Urban,60-64,Middle,845,518,1363
20005,13,State - NAGALAND,Urban,65-69,Middle,495,294,789
20006,13,State - NAGALAND,Urban,70-74,Middle,270,140,410
20007,13,State - NAGALAND,Urban,75-79,Middle,150,66,216
20008,13,State - NAGALAND,Urban,80+,Middle,137,79,216
20009,13,State - NAGALAND,Urban,Age not stated,Middle,22,6,28
20010,14,State - MANIPUR,Total,All ages,Middle,251129,205903,457032
20011,14,State - MANIPUR,Total,0-6,Middle,0,0,0
20012,14,State - MANIPUR,Total,7,Middle,0,0,0
20013,14,State - MANIPUR,Total,8,Middle,0,0,0
20014,14,State - MANIPUR,Total,9,Middle,0,0,0
20015,14,State - MANIPUR,Total,10,Middle,0,0,0
20016,14,State - MANIPUR,Total,11,Middle,0,0,0
20017,14,State - MANIPUR,Total,12,Middle,4706,4486,9192
20018,14,State - MANIPUR,Total,13,Middle,9768,9427,19195
20019,14,State - MANIPUR,Total,14,Middle,16473,15724,32197
20020,14,State - MANIPUR,Total,15,Middle,14185,13517,27702
20021,14,State - MANIPUR,Total,16,Middle,10535,10024,20559
20022,14,State - MANIPUR,Total,17,Middle,7821,7648,15469
20023,14,State - MANIPUR,Total,18,Middle,8694,8366,17060
20024,14,State - MANIPUR,Total,19,Middle,5731,5712,11443
20025,14,State - MANIPUR,Total,20-24,Middle,29922,30146,60068
20026,14,State - MANIPUR,Total,25-29,Middle,27692,26402,54094
20027,14,State - MANIPUR,Total,30-34,Middle,22207,19442,41649
20028,14,State - MANIPUR,Total,35-39,Middle,20552,16406,36958
20029,14,State - MANIPUR,Total,40-44,Middle,17824,11961,29785
20030,14,State - MANIPUR,Total,45-49,Middle,15287,9086,24373
20031,14,State - MANIPUR,Total,50-54,Middle,12523,7083,19606
20032,14,State - MANIPUR,Total,55-59,Middle,9791,4641,14432
20033,14,State - MANIPUR,Total,60-64,Middle,7235,2825,10060
20034,14,State - MANIPUR,Total,65-69,Middle,4389,1346,5735
20035,14,State - MANIPUR,Total,70-74,Middle,2496,580,3076
20036,14,State - MANIPUR,Total,75-79,Middle,1447,287,1734
20037,14,State - MANIPUR,Total,80+,Middle,1365,391,1756
20038,14,State - MANIPUR,Total,Age not stated,Middle,486,403,889
20039,14,State - MANIPUR,Rural,All ages,Middle,180386,141537,321923
20040,14,State - MANIPUR,Rural,0-6,Middle,0,0,0
20041,14,State - MANIPUR,Rural,7,Middle,0,0,0
20042,14,State - MANIPUR,Rural,8,Middle,0,0,0
20043,14,State - MANIPUR,Rural,9,Middle,0,0,0
20044,14,State - MANIPUR,Rural,10,Middle,0,0,0
20045,14,State - MANIPUR,Rural,11,Middle,0,0,0
20046,14,State - MANIPUR,Rural,12,Middle,3292,3039,6331
20047,14,State - MANIPUR,Rural,13,Middle,6541,6200,12741
20048,14,State - MANIPUR,Rural,14,Middle,11190,10506,21696
20049,14,State - MANIPUR,Rural,15,Middle,9928,9343,19271
20050,14,State - MANIPUR,Rural,16,Middle,7791,7346,15137
20051,14,State - MANIPUR,Rural,17,Middle,5908,5691,11599
20052,14,State - MANIPUR,Rural,18,Middle,6789,6342,13131
20053,14,State - MANIPUR,Rural,19,Middle,4445,4271,8716
20054,14,State - MANIPUR,Rural,20-24,Middle,22344,21778,44122
20055,14,State - MANIPUR,Rural,25-29,Middle,20395,18701,39096
20056,14,State - MANIPUR,Rural,30-34,Middle,16252,13529,29781
20057,14,State - MANIPUR,Rural,35-39,Middle,15040,11170,26210
20058,14,State - MANIPUR,Rural,40-44,Middle,12974,7975,20949
20059,14,State - MANIPUR,Rural,45-49,Middle,10927,5792,16719
20060,14,State - MANIPUR,Rural,50-54,Middle,8644,4180,12824
20061,14,State - MANIPUR,Rural,55-59,Middle,6637,2588,9225
20062,14,State - MANIPUR,Rural,60-64,Middle,4805,1496,6301
20063,14,State - MANIPUR,Rural,65-69,Middle,2892,695,3587
20064,14,State - MANIPUR,Rural,70-74,Middle,1605,272,1877
20065,14,State - MANIPUR,Rural,75-79,Middle,857,124,981
20066,14,State - MANIPUR,Rural,80+,Middle,755,227,982
20067,14,State - MANIPUR,Rural,Age not stated,Middle,375,272,647
20068,14,State - MANIPUR,Urban,All ages,Middle,70743,64366,135109
20069,14,State - MANIPUR,Urban,0-6,Middle,0,0,0
20070,14,State - MANIPUR,Urban,7,Middle,0,0,0
20071,14,State - MANIPUR,Urban,8,Middle,0,0,0
20072,14,State - MANIPUR,Urban,9,Middle,0,0,0
20073,14,State - MANIPUR,Urban,10,Middle,0,0,0
20074,14,State - MANIPUR,Urban,11,Middle,0,0,0
20075,14,State - MANIPUR,Urban,12,Middle,1414,1447,2861
20076,14,State - MANIPUR,Urban,13,Middle,3227,3227,6454
20077,14,State - MANIPUR,Urban,14,Middle,5283,5218,10501
20078,14,State - MANIPUR,Urban,15,Middle,4257,4174,8431
20079,14,State - MANIPUR,Urban,16,Middle,2744,2678,5422
20080,14,State - MANIPUR,Urban,17,Middle,1913,1957,3870
20081,14,State - MANIPUR,Urban,18,Middle,1905,2024,3929
20082,14,State - MANIPUR,Urban,19,Middle,1286,1441,2727
20083,14,State - MANIPUR,Urban,20-24,Middle,7578,8368,15946
20084,14,State - MANIPUR,Urban,25-29,Middle,7297,7701,14998
20085,14,State - MANIPUR,Urban,30-34,Middle,5955,5913,11868
20086,14,State - MANIPUR,Urban,35-39,Middle,5512,5236,10748
20087,14,State - MANIPUR,Urban,40-44,Middle,4850,3986,8836
20088,14,State - MANIPUR,Urban,45-49,Middle,4360,3294,7654
20089,14,State - MANIPUR,Urban,50-54,Middle,3879,2903,6782
20090,14,State - MANIPUR,Urban,55-59,Middle,3154,2053,5207
20091,14,State - MANIPUR,Urban,60-64,Middle,2430,1329,3759
20092,14,State - MANIPUR,Urban,65-69,Middle,1497,651,2148
20093,14,State - MANIPUR,Urban,70-74,Middle,891,308,1199
20094,14,State - MANIPUR,Urban,75-79,Middle,590,163,753
20095,14,State - MANIPUR,Urban,80+,Middle,610,164,774
20096,14,State - MANIPUR,Urban,Age not stated,Middle,111,131,242
20097,15,State - MIZORAM,Total,All ages,Middle,104978,96504,201482
20098,15,State - MIZORAM,Total,0-6,Middle,0,0,0
20099,15,State - MIZORAM,Total,7,Middle,0,0,0
20100,15,State - MIZORAM,Total,8,Middle,0,0,0
20101,15,State - MIZORAM,Total,9,Middle,0,0,0
20102,15,State - MIZORAM,Total,10,Middle,0,0,0
20103,15,State - MIZORAM,Total,11,Middle,0,0,0
20104,15,State - MIZORAM,Total,12,Middle,1088,1275,2363
20105,15,State - MIZORAM,Total,13,Middle,3104,3585,6689
20106,15,State - MIZORAM,Total,14,Middle,5514,6160,11674
20107,15,State - MIZORAM,Total,15,Middle,6031,5880,11911
20108,15,State - MIZORAM,Total,16,Middle,5454,5026,10480
20109,15,State - MIZORAM,Total,17,Middle,3912,3303,7215
20110,15,State - MIZORAM,Total,18,Middle,3225,2762,5987
20111,15,State - MIZORAM,Total,19,Middle,2694,2429,5123
20112,15,State - MIZORAM,Total,20-24,Middle,14613,14059,28672
20113,15,State - MIZORAM,Total,25-29,Middle,13317,12882,26199
20114,15,State - MIZORAM,Total,30-34,Middle,11649,12046,23695
20115,15,State - MIZORAM,Total,35-39,Middle,9587,8886,18473
20116,15,State - MIZORAM,Total,40-44,Middle,7480,6418,13898
20117,15,State - MIZORAM,Total,45-49,Middle,6437,5267,11704
20118,15,State - MIZORAM,Total,50-54,Middle,4464,3272,7736
20119,15,State - MIZORAM,Total,55-59,Middle,2615,1436,4051
20120,15,State - MIZORAM,Total,60-64,Middle,1855,1023,2878
20121,15,State - MIZORAM,Total,65-69,Middle,908,440,1348
20122,15,State - MIZORAM,Total,70-74,Middle,488,160,648
20123,15,State - MIZORAM,Total,75-79,Middle,280,80,360
20124,15,State - MIZORAM,Total,80+,Middle,218,92,310
20125,15,State - MIZORAM,Total,Age not stated,Middle,45,23,68
20126,15,State - MIZORAM,Rural,All ages,Middle,40653,34591,75244
20127,15,State - MIZORAM,Rural,0-6,Middle,0,0,0
20128,15,State - MIZORAM,Rural,7,Middle,0,0,0
20129,15,State - MIZORAM,Rural,8,Middle,0,0,0
20130,15,State - MIZORAM,Rural,9,Middle,0,0,0
20131,15,State - MIZORAM,Rural,10,Middle,0,0,0
20132,15,State - MIZORAM,Rural,11,Middle,0,0,0
20133,15,State - MIZORAM,Rural,12,Middle,410,523,933
20134,15,State - MIZORAM,Rural,13,Middle,1105,1263,2368
20135,15,State - MIZORAM,Rural,14,Middle,1920,2077,3997
20136,15,State - MIZORAM,Rural,15,Middle,2312,2104,4416
20137,15,State - MIZORAM,Rural,16,Middle,2223,1999,4222
20138,15,State - MIZORAM,Rural,17,Middle,1816,1439,3255
20139,15,State - MIZORAM,Rural,18,Middle,1583,1263,2846
20140,15,State - MIZORAM,Rural,19,Middle,1218,1125,2343
20141,15,State - MIZORAM,Rural,20-24,Middle,6455,6039,12494
20142,15,State - MIZORAM,Rural,25-29,Middle,5304,5073,10377
20143,15,State - MIZORAM,Rural,30-34,Middle,4399,4273,8672
20144,15,State - MIZORAM,Rural,35-39,Middle,3534,2870,6404
20145,15,State - MIZORAM,Rural,40-44,Middle,2532,1772,4304
20146,15,State - MIZORAM,Rural,45-49,Middle,2165,1283,3448
20147,15,State - MIZORAM,Rural,50-54,Middle,1522,836,2358
20148,15,State - MIZORAM,Rural,55-59,Middle,849,303,1152
20149,15,State - MIZORAM,Rural,60-64,Middle,636,190,826
20150,15,State - MIZORAM,Rural,65-69,Middle,336,77,413
20151,15,State - MIZORAM,Rural,70-74,Middle,156,30,186
20152,15,State - MIZORAM,Rural,75-79,Middle,97,12,109
20153,15,State - MIZORAM,Rural,80+,Middle,63,31,94
20154,15,State - MIZORAM,Rural,Age not stated,Middle,18,9,27
20155,15,State - MIZORAM,Urban,All ages,Middle,64325,61913,126238
20156,15,State - MIZORAM,Urban,0-6,Middle,0,0,0
20157,15,State - MIZORAM,Urban,7,Middle,0,0,0
20158,15,State - MIZORAM,Urban,8,Middle,0,0,0
20159,15,State - MIZORAM,Urban,9,Middle,0,0,0
20160,15,State - MIZORAM,Urban,10,Middle,0,0,0
20161,15,State - MIZORAM,Urban,11,Middle,0,0,0
20162,15,State - MIZORAM,Urban,12,Middle,678,752,1430
20163,15,State - MIZORAM,Urban,13,Middle,1999,2322,4321
20164,15,State - MIZORAM,Urban,14,Middle,3594,4083,7677
20165,15,State - MIZORAM,Urban,15,Middle,3719,3776,7495
20166,15,State - MIZORAM,Urban,16,Middle,3231,3027,6258
20167,15,State - MIZORAM,Urban,17,Middle,2096,1864,3960
20168,15,State - MIZORAM,Urban,18,Middle,1642,1499,3141
20169,15,State - MIZORAM,Urban,19,Middle,1476,1304,2780
20170,15,State - MIZORAM,Urban,20-24,Middle,8158,8020,16178
20171,15,State - MIZORAM,Urban,25-29,Middle,8013,7809,15822
20172,15,State - MIZORAM,Urban,30-34,Middle,7250,7773,15023
20173,15,State - MIZORAM,Urban,35-39,Middle,6053,6016,12069
20174,15,State - MIZORAM,Urban,40-44,Middle,4948,4646,9594
20175,15,State - MIZORAM,Urban,45-49,Middle,4272,3984,8256
20176,15,State - MIZORAM,Urban,50-54,Middle,2942,2436,5378
20177,15,State - MIZORAM,Urban,55-59,Middle,1766,1133,2899
20178,15,State - MIZORAM,Urban,60-64,Middle,1219,833,2052
20179,15,State - MIZORAM,Urban,65-69,Middle,572,363,935
20180,15,State - MIZORAM,Urban,70-74,Middle,332,130,462
20181,15,State - MIZORAM,Urban,75-79,Middle,183,68,251
20182,15,State - MIZORAM,Urban,80+,Middle,155,61,216
20183,15,State - MIZORAM,Urban,Age not stated,Middle,27,14,41
20184,16,State - TRIPURA,Total,All ages,Middle,320040,272356,592396
20185,16,State - TRIPURA,Total,0-6,Middle,0,0,0
20186,16,State - TRIPURA,Total,7,Middle,0,0,0
20187,16,State - TRIPURA,Total,8,Middle,0,0,0
20188,16,State - TRIPURA,Total,9,Middle,0,0,0
20189,16,State - TRIPURA,Total,10,Middle,0,0,0
20190,16,State - TRIPURA,Total,11,Middle,0,0,0
20191,16,State - TRIPURA,Total,12,Middle,1641,1581,3222
20192,16,State - TRIPURA,Total,13,Middle,5605,5633,11238
20193,16,State - TRIPURA,Total,14,Middle,15106,14917,30023
20194,16,State - TRIPURA,Total,15,Middle,18554,18193,36747
20195,16,State - TRIPURA,Total,16,Middle,17204,16283,33487
20196,16,State - TRIPURA,Total,17,Middle,12622,11647,24269
20197,16,State - TRIPURA,Total,18,Middle,10878,11536,22414
20198,16,State - TRIPURA,Total,19,Middle,8330,9708,18038
20199,16,State - TRIPURA,Total,20-24,Middle,40362,43423,83785
20200,16,State - TRIPURA,Total,25-29,Middle,40599,36284,76883
20201,16,State - TRIPURA,Total,30-34,Middle,34768,28922,63690
20202,16,State - TRIPURA,Total,35-39,Middle,31618,25570,57188
20203,16,State - TRIPURA,Total,40-44,Middle,25219,17098,42317
20204,16,State - TRIPURA,Total,45-49,Middle,18726,12229,30955
20205,16,State - TRIPURA,Total,50-54,Middle,14371,8076,22447
20206,16,State - TRIPURA,Total,55-59,Middle,9187,4714,13901
20207,16,State - TRIPURA,Total,60-64,Middle,6080,2771,8851
20208,16,State - TRIPURA,Total,65-69,Middle,3844,1617,5461
20209,16,State - TRIPURA,Total,70-74,Middle,2359,905,3264
20210,16,State - TRIPURA,Total,75-79,Middle,1296,491,1787
20211,16,State - TRIPURA,Total,80+,Middle,1565,666,2231
20212,16,State - TRIPURA,Total,Age not stated,Middle,106,92,198
20213,16,State - TRIPURA,Rural,All ages,Middle,228022,185597,413619
20214,16,State - TRIPURA,Rural,0-6,Middle,0,0,0
20215,16,State - TRIPURA,Rural,7,Middle,0,0,0
20216,16,State - TRIPURA,Rural,8,Middle,0,0,0
20217,16,State - TRIPURA,Rural,9,Middle,0,0,0
20218,16,State - TRIPURA,Rural,10,Middle,0,0,0
20219,16,State - TRIPURA,Rural,11,Middle,0,0,0
20220,16,State - TRIPURA,Rural,12,Middle,1340,1259,2599
20221,16,State - TRIPURA,Rural,13,Middle,4195,4171,8366
20222,16,State - TRIPURA,Rural,14,Middle,10978,10680,21658
20223,16,State - TRIPURA,Rural,15,Middle,13890,13446,27336
20224,16,State - TRIPURA,Rural,16,Middle,13295,12299,25594
20225,16,State - TRIPURA,Rural,17,Middle,10108,9059,19167
20226,16,State - TRIPURA,Rural,18,Middle,8797,9154,17951
20227,16,State - TRIPURA,Rural,19,Middle,6620,7554,14174
20228,16,State - TRIPURA,Rural,20-24,Middle,31601,33202,64803
20229,16,State - TRIPURA,Rural,25-29,Middle,30215,25866,56081
20230,16,State - TRIPURA,Rural,30-34,Middle,24930,19343,44273
20231,16,State - TRIPURA,Rural,35-39,Middle,21766,15674,37440
20232,16,State - TRIPURA,Rural,40-44,Middle,16129,9563,25692
20233,16,State - TRIPURA,Rural,45-49,Middle,11283,6052,17335
20234,16,State - TRIPURA,Rural,50-54,Middle,8513,3775,12288
20235,16,State - TRIPURA,Rural,55-59,Middle,5248,2063,7311
20236,16,State - TRIPURA,Rural,60-64,Middle,3569,1105,4674
20237,16,State - TRIPURA,Rural,65-69,Middle,2337,568,2905
20238,16,State - TRIPURA,Rural,70-74,Middle,1402,283,1685
20239,16,State - TRIPURA,Rural,75-79,Middle,747,138,885
20240,16,State - TRIPURA,Rural,80+,Middle,995,298,1293
20241,16,State - TRIPURA,Rural,Age not stated,Middle,64,45,109
20242,16,State - TRIPURA,Urban,All ages,Middle,92018,86759,178777
20243,16,State - TRIPURA,Urban,0-6,Middle,0,0,0
20244,16,State - TRIPURA,Urban,7,Middle,0,0,0
20245,16,State - TRIPURA,Urban,8,Middle,0,0,0
20246,16,State - TRIPURA,Urban,9,Middle,0,0,0
20247,16,State - TRIPURA,Urban,10,Middle,0,0,0
20248,16,State - TRIPURA,Urban,11,Middle,0,0,0
20249,16,State - TRIPURA,Urban,12,Middle,301,322,623
20250,16,State - TRIPURA,Urban,13,Middle,1410,1462,2872
20251,16,State - TRIPURA,Urban,14,Middle,4128,4237,8365
20252,16,State - TRIPURA,Urban,15,Middle,4664,4747,9411
20253,16,State - TRIPURA,Urban,16,Middle,3909,3984,7893
20254,16,State - TRIPURA,Urban,17,Middle,2514,2588,5102
20255,16,State - TRIPURA,Urban,18,Middle,2081,2382,4463
20256,16,State - TRIPURA,Urban,19,Middle,1710,2154,3864
20257,16,State - TRIPURA,Urban,20-24,Middle,8761,10221,18982
20258,16,State - TRIPURA,Urban,25-29,Middle,10384,10418,20802
20259,16,State - TRIPURA,Urban,30-34,Middle,9838,9579,19417
20260,16,State - TRIPURA,Urban,35-39,Middle,9852,9896,19748
20261,16,State - TRIPURA,Urban,40-44,Middle,9090,7535,16625
20262,16,State - TRIPURA,Urban,45-49,Middle,7443,6177,13620
20263,16,State - TRIPURA,Urban,50-54,Middle,5858,4301,10159
20264,16,State - TRIPURA,Urban,55-59,Middle,3939,2651,6590
20265,16,State - TRIPURA,Urban,60-64,Middle,2511,1666,4177
20266,16,State - TRIPURA,Urban,65-69,Middle,1507,1049,2556
20267,16,State - TRIPURA,Urban,70-74,Middle,957,622,1579
20268,16,State - TRIPURA,Urban,75-79,Middle,549,353,902
20269,16,State - TRIPURA,Urban,80+,Middle,570,368,938
20270,16,State - TRIPURA,Urban,Age not stated,Middle,42,47,89
20271,17,State - MEGHALAYA,Total,All ages,Middle,151272,146625,297897
20272,17,State - MEGHALAYA,Total,0-6,Middle,0,0,0
20273,17,State - MEGHALAYA,Total,7,Middle,0,0,0
20274,17,State - MEGHALAYA,Total,8,Middle,0,0,0
20275,17,State - MEGHALAYA,Total,9,Middle,0,0,0
20276,17,State - MEGHALAYA,Total,10,Middle,0,0,0
20277,17,State - MEGHALAYA,Total,11,Middle,0,0,0
20278,17,State - MEGHALAYA,Total,12,Middle,2134,2521,4655
20279,17,State - MEGHALAYA,Total,13,Middle,4541,5559,10100
20280,17,State - MEGHALAYA,Total,14,Middle,8564,10414,18978
20281,17,State - MEGHALAYA,Total,15,Middle,9389,10880,20269
20282,17,State - MEGHALAYA,Total,16,Middle,9562,11211,20773
20283,17,State - MEGHALAYA,Total,17,Middle,7590,8766,16356
20284,17,State - MEGHALAYA,Total,18,Middle,7528,7932,15460
20285,17,State - MEGHALAYA,Total,19,Middle,5547,5693,11240
20286,17,State - MEGHALAYA,Total,20-24,Middle,22781,23155,45936
20287,17,State - MEGHALAYA,Total,25-29,Middle,18096,17785,35881
20288,17,State - MEGHALAYA,Total,30-34,Middle,13467,12635,26102
20289,17,State - MEGHALAYA,Total,35-39,Middle,11389,9987,21376
20290,17,State - MEGHALAYA,Total,40-44,Middle,9094,6984,16078
20291,17,State - MEGHALAYA,Total,45-49,Middle,7523,4786,12309
20292,17,State - MEGHALAYA,Total,50-54,Middle,4967,2979,7946
20293,17,State - MEGHALAYA,Total,55-59,Middle,3304,1780,5084
20294,17,State - MEGHALAYA,Total,60-64,Middle,2262,1384,3646
20295,17,State - MEGHALAYA,Total,65-69,Middle,1535,855,2390
20296,17,State - MEGHALAYA,Total,70-74,Middle,754,463,1217
20297,17,State - MEGHALAYA,Total,75-79,Middle,385,261,646
20298,17,State - MEGHALAYA,Total,80+,Middle,502,396,898
20299,17,State - MEGHALAYA,Total,Age not stated,Middle,358,199,557
20300,17,State - MEGHALAYA,Rural,All ages,Middle,101714,99249,200963
20301,17,State - MEGHALAYA,Rural,0-6,Middle,0,0,0
20302,17,State - MEGHALAYA,Rural,7,Middle,0,0,0
20303,17,State - MEGHALAYA,Rural,8,Middle,0,0,0
20304,17,State - MEGHALAYA,Rural,9,Middle,0,0,0
20305,17,State - MEGHALAYA,Rural,10,Middle,0,0,0
20306,17,State - MEGHALAYA,Rural,11,Middle,0,0,0
20307,17,State - MEGHALAYA,Rural,12,Middle,1510,1806,3316
20308,17,State - MEGHALAYA,Rural,13,Middle,2913,3805,6718
20309,17,State - MEGHALAYA,Rural,14,Middle,5322,6775,12097
20310,17,State - MEGHALAYA,Rural,15,Middle,6079,7080,13159
20311,17,State - MEGHALAYA,Rural,16,Middle,6370,7703,14073
20312,17,State - MEGHALAYA,Rural,17,Middle,5510,6365,11875
20313,17,State - MEGHALAYA,Rural,18,Middle,5493,5976,11469
20314,17,State - MEGHALAYA,Rural,19,Middle,3932,4381,8313
20315,17,State - MEGHALAYA,Rural,20-24,Middle,16215,17614,33829
20316,17,State - MEGHALAYA,Rural,25-29,Middle,12467,12542,25009
20317,17,State - MEGHALAYA,Rural,30-34,Middle,8752,8311,17063
20318,17,State - MEGHALAYA,Rural,35-39,Middle,7553,6148,13701
20319,17,State - MEGHALAYA,Rural,40-44,Middle,5815,4049,9864
20320,17,State - MEGHALAYA,Rural,45-49,Middle,4738,2645,7383
20321,17,State - MEGHALAYA,Rural,50-54,Middle,3110,1493,4603
20322,17,State - MEGHALAYA,Rural,55-59,Middle,2123,846,2969
20323,17,State - MEGHALAYA,Rural,60-64,Middle,1497,648,2145
20324,17,State - MEGHALAYA,Rural,65-69,Middle,1085,450,1535
20325,17,State - MEGHALAYA,Rural,70-74,Middle,497,210,707
20326,17,State - MEGHALAYA,Rural,75-79,Middle,244,73,317
20327,17,State - MEGHALAYA,Rural,80+,Middle,334,162,496
20328,17,State - MEGHALAYA,Rural,Age not stated,Middle,155,167,322
20329,17,State - MEGHALAYA,Urban,All ages,Middle,49558,47376,96934
20330,17,State - MEGHALAYA,Urban,0-6,Middle,0,0,0
20331,17,State - MEGHALAYA,Urban,7,Middle,0,0,0
20332,17,State - MEGHALAYA,Urban,8,Middle,0,0,0
20333,17,State - MEGHALAYA,Urban,9,Middle,0,0,0
20334,17,State - MEGHALAYA,Urban,10,Middle,0,0,0
20335,17,State - MEGHALAYA,Urban,11,Middle,0,0,0
20336,17,State - MEGHALAYA,Urban,12,Middle,624,715,1339
20337,17,State - MEGHALAYA,Urban,13,Middle,1628,1754,3382
20338,17,State - MEGHALAYA,Urban,14,Middle,3242,3639,6881
20339,17,State - MEGHALAYA,Urban,15,Middle,3310,3800,7110
20340,17,State - MEGHALAYA,Urban,16,Middle,3192,3508,6700
20341,17,State - MEGHALAYA,Urban,17,Middle,2080,2401,4481
20342,17,State - MEGHALAYA,Urban,18,Middle,2035,1956,3991
20343,17,State - MEGHALAYA,Urban,19,Middle,1615,1312,2927
20344,17,State - MEGHALAYA,Urban,20-24,Middle,6566,5541,12107
20345,17,State - MEGHALAYA,Urban,25-29,Middle,5629,5243,10872
20346,17,State - MEGHALAYA,Urban,30-34,Middle,4715,4324,9039
20347,17,State - MEGHALAYA,Urban,35-39,Middle,3836,3839,7675
20348,17,State - MEGHALAYA,Urban,40-44,Middle,3279,2935,6214
20349,17,State - MEGHALAYA,Urban,45-49,Middle,2785,2141,4926
20350,17,State - MEGHALAYA,Urban,50-54,Middle,1857,1486,3343
20351,17,State - MEGHALAYA,Urban,55-59,Middle,1181,934,2115
20352,17,State - MEGHALAYA,Urban,60-64,Middle,765,736,1501
20353,17,State - MEGHALAYA,Urban,65-69,Middle,450,405,855
20354,17,State - MEGHALAYA,Urban,70-74,Middle,257,253,510
20355,17,State - MEGHALAYA,Urban,75-79,Middle,141,188,329
20356,17,State - MEGHALAYA,Urban,80+,Middle,168,234,402
20357,17,State - MEGHALAYA,Urban,Age not stated,Middle,203,32,235
20358,18,State - ASSAM,Total,All ages,Middle,2248173,2036838,4285011
20359,18,State - ASSAM,Total,0-6,Middle,0,0,0
20360,18,State - ASSAM,Total,7,Middle,0,0,0
20361,18,State - ASSAM,Total,8,Middle,0,0,0
20362,18,State - ASSAM,Total,9,Middle,0,0,0
20363,18,State - ASSAM,Total,10,Middle,0,0,0
20364,18,State - ASSAM,Total,11,Middle,0,0,0
20365,18,State - ASSAM,Total,12,Middle,36781,39073,75854
20366,18,State - ASSAM,Total,13,Middle,83165,90652,173817
20367,18,State - ASSAM,Total,14,Middle,152342,160508,312850
20368,18,State - ASSAM,Total,15,Middle,153924,157003,310927
20369,18,State - ASSAM,Total,16,Middle,124443,120879,245322
20370,18,State - ASSAM,Total,17,Middle,79846,73285,153131
20371,18,State - ASSAM,Total,18,Middle,81273,78342,159615
20372,18,State - ASSAM,Total,19,Middle,54960,60368,115328
20373,18,State - ASSAM,Total,20-24,Middle,272849,292031,564880
20374,18,State - ASSAM,Total,25-29,Middle,272205,272354,544559
20375,18,State - ASSAM,Total,30-34,Middle,214155,202508,416663
20376,18,State - ASSAM,Total,35-39,Middle,190195,168468,358663
20377,18,State - ASSAM,Total,40-44,Middle,137546,106265,243811
20378,18,State - ASSAM,Total,45-49,Middle,119731,83307,203038
20379,18,State - ASSAM,Total,50-54,Middle,87176,51574,138750
20380,18,State - ASSAM,Total,55-59,Middle,64035,32900,96935
20381,18,State - ASSAM,Total,60-64,Middle,50745,21994,72739
20382,18,State - ASSAM,Total,65-69,Middle,32811,12196,45007
20383,18,State - ASSAM,Total,70-74,Middle,19887,5600,25487
20384,18,State - ASSAM,Total,75-79,Middle,9635,2741,12376
20385,18,State - ASSAM,Total,80+,Middle,9520,4035,13555
20386,18,State - ASSAM,Total,Age not stated,Middle,949,755,1704
20387,18,State - ASSAM,Rural,All ages,Middle,1885166,1686885,3572051
20388,18,State - ASSAM,Rural,0-6,Middle,0,0,0
20389,18,State - ASSAM,Rural,7,Middle,0,0,0
20390,18,State - ASSAM,Rural,8,Middle,0,0,0
20391,18,State - ASSAM,Rural,9,Middle,0,0,0
20392,18,State - ASSAM,Rural,10,Middle,0,0,0
20393,18,State - ASSAM,Rural,11,Middle,0,0,0
20394,18,State - ASSAM,Rural,12,Middle,31107,33075,64182
20395,18,State - ASSAM,Rural,13,Middle,69469,76129,145598
20396,18,State - ASSAM,Rural,14,Middle,128246,136001,264247
20397,18,State - ASSAM,Rural,15,Middle,131586,135165,266751
20398,18,State - ASSAM,Rural,16,Middle,107507,104600,212107
20399,18,State - ASSAM,Rural,17,Middle,69233,63329,132562
20400,18,State - ASSAM,Rural,18,Middle,71265,68869,140134
20401,18,State - ASSAM,Rural,19,Middle,47890,52624,100514
20402,18,State - ASSAM,Rural,20-24,Middle,234757,250996,485753
20403,18,State - ASSAM,Rural,25-29,Middle,231880,229270,461150
20404,18,State - ASSAM,Rural,30-34,Middle,179336,166664,346000
20405,18,State - ASSAM,Rural,35-39,Middle,156926,134929,291855
20406,18,State - ASSAM,Rural,40-44,Middle,110781,81880,192661
20407,18,State - ASSAM,Rural,45-49,Middle,95431,61921,157352
20408,18,State - ASSAM,Rural,50-54,Middle,68426,37452,105878
20409,18,State - ASSAM,Rural,55-59,Middle,50961,23196,74157
20410,18,State - ASSAM,Rural,60-64,Middle,41407,14966,56373
20411,18,State - ASSAM,Rural,65-69,Middle,27004,7808,34812
20412,18,State - ASSAM,Rural,70-74,Middle,16176,3309,19485
20413,18,State - ASSAM,Rural,75-79,Middle,7503,1412,8915
20414,18,State - ASSAM,Rural,80+,Middle,7539,2733,10272
20415,18,State - ASSAM,Rural,Age not stated,Middle,736,557,1293
20416,18,State - ASSAM,Urban,All ages,Middle,363007,349953,712960
20417,18,State - ASSAM,Urban,0-6,Middle,0,0,0
20418,18,State - ASSAM,Urban,7,Middle,0,0,0
20419,18,State - ASSAM,Urban,8,Middle,0,0,0
20420,18,State - ASSAM,Urban,9,Middle,0,0,0
20421,18,State - ASSAM,Urban,10,Middle,0,0,0
20422,18,State - ASSAM,Urban,11,Middle,0,0,0
20423,18,State - ASSAM,Urban,12,Middle,5674,5998,11672
20424,18,State - ASSAM,Urban,13,Middle,13696,14523,28219
20425,18,State - ASSAM,Urban,14,Middle,24096,24507,48603
20426,18,State - ASSAM,Urban,15,Middle,22338,21838,44176
20427,18,State - ASSAM,Urban,16,Middle,16936,16279,33215
20428,18,State - ASSAM,Urban,17,Middle,10613,9956,20569
20429,18,State - ASSAM,Urban,18,Middle,10008,9473,19481
20430,18,State - ASSAM,Urban,19,Middle,7070,7744,14814
20431,18,State - ASSAM,Urban,20-24,Middle,38092,41035,79127
20432,18,State - ASSAM,Urban,25-29,Middle,40325,43084,83409
20433,18,State - ASSAM,Urban,30-34,Middle,34819,35844,70663
20434,18,State - ASSAM,Urban,35-39,Middle,33269,33539,66808
20435,18,State - ASSAM,Urban,40-44,Middle,26765,24385,51150
20436,18,State - ASSAM,Urban,45-49,Middle,24300,21386,45686
20437,18,State - ASSAM,Urban,50-54,Middle,18750,14122,32872
20438,18,State - ASSAM,Urban,55-59,Middle,13074,9704,22778
20439,18,State - ASSAM,Urban,60-64,Middle,9338,7028,16366
20440,18,State - ASSAM,Urban,65-69,Middle,5807,4388,10195
20441,18,State - ASSAM,Urban,70-74,Middle,3711,2291,6002
20442,18,State - ASSAM,Urban,75-79,Middle,2132,1329,3461
20443,18,State - ASSAM,Urban,80+,Middle,1981,1302,3283
20444,18,State - ASSAM,Urban,Age not stated,Middle,213,198,411
20445,19,State - WEST BENGAL,Total,All ages,Middle,6684464,5789837,12474301
20446,19,State - WEST BENGAL,Total,0-6,Middle,0,0,0
20447,19,State - WEST BENGAL,Total,7,Middle,0,0,0
20448,19,State - WEST BENGAL,Total,8,Middle,0,0,0
20449,19,State - WEST BENGAL,Total,9,Middle,0,0,0
20450,19,State - WEST BENGAL,Total,10,Middle,0,0,0
20451,19,State - WEST BENGAL,Total,11,Middle,0,0,0
20452,19,State - WEST BENGAL,Total,12,Middle,98691,103082,201773
20453,19,State - WEST BENGAL,Total,13,Middle,246301,264993,511294
20454,19,State - WEST BENGAL,Total,14,Middle,435309,457821,893130
20455,19,State - WEST BENGAL,Total,15,Middle,405669,417495,823164
20456,19,State - WEST BENGAL,Total,16,Middle,301095,307014,608109
20457,19,State - WEST BENGAL,Total,17,Middle,197196,193372,390568
20458,19,State - WEST BENGAL,Total,18,Middle,196077,213321,409398
20459,19,State - WEST BENGAL,Total,19,Middle,136124,165310,301434
20460,19,State - WEST BENGAL,Total,20-24,Middle,742035,776609,1518644
20461,19,State - WEST BENGAL,Total,25-29,Middle,705889,658078,1363967
20462,19,State - WEST BENGAL,Total,30-34,Middle,594991,524057,1119048
20463,19,State - WEST BENGAL,Total,35-39,Middle,606011,493828,1099839
20464,19,State - WEST BENGAL,Total,40-44,Middle,516871,363897,880768
20465,19,State - WEST BENGAL,Total,45-49,Middle,437398,294192,731590
20466,19,State - WEST BENGAL,Total,50-54,Middle,344660,198207,542867
20467,19,State - WEST BENGAL,Total,55-59,Middle,247119,133391,380510
20468,19,State - WEST BENGAL,Total,60-64,Middle,175482,87676,263158
20469,19,State - WEST BENGAL,Total,65-69,Middle,121236,54919,176155
20470,19,State - WEST BENGAL,Total,70-74,Middle,79697,32639,112336
20471,19,State - WEST BENGAL,Total,75-79,Middle,43846,18591,62437
20472,19,State - WEST BENGAL,Total,80+,Middle,47467,26912,74379
20473,19,State - WEST BENGAL,Total,Age not stated,Middle,5300,4433,9733
20474,19,State - WEST BENGAL,Rural,All ages,Middle,4449851,3717634,8167485
20475,19,State - WEST BENGAL,Rural,0-6,Middle,0,0,0
20476,19,State - WEST BENGAL,Rural,7,Middle,0,0,0
20477,19,State - WEST BENGAL,Rural,8,Middle,0,0,0
20478,19,State - WEST BENGAL,Rural,9,Middle,0,0,0
20479,19,State - WEST BENGAL,Rural,10,Middle,0,0,0
20480,19,State - WEST BENGAL,Rural,11,Middle,0,0,0
20481,19,State - WEST BENGAL,Rural,12,Middle,62534,65425,127959
20482,19,State - WEST BENGAL,Rural,13,Middle,162930,177019,339949
20483,19,State - WEST BENGAL,Rural,14,Middle,296987,317495,614482
20484,19,State - WEST BENGAL,Rural,15,Middle,287025,301088,588113
20485,19,State - WEST BENGAL,Rural,16,Middle,218385,224956,443341
20486,19,State - WEST BENGAL,Rural,17,Middle,145272,141727,286999
20487,19,State - WEST BENGAL,Rural,18,Middle,145854,159136,304990
20488,19,State - WEST BENGAL,Rural,19,Middle,99780,123025,222805
20489,19,State - WEST BENGAL,Rural,20-24,Middle,534727,556102,1090829
20490,19,State - WEST BENGAL,Rural,25-29,Middle,481719,439157,920876
20491,19,State - WEST BENGAL,Rural,30-34,Middle,386496,328400,714896
20492,19,State - WEST BENGAL,Rural,35-39,Middle,391075,295626,686701
20493,19,State - WEST BENGAL,Rural,40-44,Middle,326711,207065,533776
20494,19,State - WEST BENGAL,Rural,45-49,Middle,267924,154930,422854
20495,19,State - WEST BENGAL,Rural,50-54,Middle,211608,97679,309287
20496,19,State - WEST BENGAL,Rural,55-59,Middle,152742,58988,211730
20497,19,State - WEST BENGAL,Rural,60-64,Middle,106473,30856,137329
20498,19,State - WEST BENGAL,Rural,65-69,Middle,73016,16469,89485
20499,19,State - WEST BENGAL,Rural,70-74,Middle,45590,7793,53383
20500,19,State - WEST BENGAL,Rural,75-79,Middle,24624,4001,28625
20501,19,State - WEST BENGAL,Rural,80+,Middle,25717,8762,34479
20502,19,State - WEST BENGAL,Rural,Age not stated,Middle,2662,1935,4597
20503,19,State - WEST BENGAL,Urban,All ages,Middle,2234613,2072203,4306816
20504,19,State - WEST BENGAL,Urban,0-6,Middle,0,0,0
20505,19,State - WEST BENGAL,Urban,7,Middle,0,0,0
20506,19,State - WEST BENGAL,Urban,8,Middle,0,0,0
20507,19,State - WEST BENGAL,Urban,9,Middle,0,0,0
20508,19,State - WEST BENGAL,Urban,10,Middle,0,0,0
20509,19,State - WEST BENGAL,Urban,11,Middle,0,0,0
20510,19,State - WEST BENGAL,Urban,12,Middle,36157,37657,73814
20511,19,State - WEST BENGAL,Urban,13,Middle,83371,87974,171345
20512,19,State - WEST BENGAL,Urban,14,Middle,138322,140326,278648
20513,19,State - WEST BENGAL,Urban,15,Middle,118644,116407,235051
20514,19,State - WEST BENGAL,Urban,16,Middle,82710,82058,164768
20515,19,State - WEST BENGAL,Urban,17,Middle,51924,51645,103569
20516,19,State - WEST BENGAL,Urban,18,Middle,50223,54185,104408
20517,19,State - WEST BENGAL,Urban,19,Middle,36344,42285,78629
20518,19,State - WEST BENGAL,Urban,20-24,Middle,207308,220507,427815
20519,19,State - WEST BENGAL,Urban,25-29,Middle,224170,218921,443091
20520,19,State - WEST BENGAL,Urban,30-34,Middle,208495,195657,404152
20521,19,State - WEST BENGAL,Urban,35-39,Middle,214936,198202,413138
20522,19,State - WEST BENGAL,Urban,40-44,Middle,190160,156832,346992
20523,19,State - WEST BENGAL,Urban,45-49,Middle,169474,139262,308736
20524,19,State - WEST BENGAL,Urban,50-54,Middle,133052,100528,233580
20525,19,State - WEST BENGAL,Urban,55-59,Middle,94377,74403,168780
20526,19,State - WEST BENGAL,Urban,60-64,Middle,69009,56820,125829
20527,19,State - WEST BENGAL,Urban,65-69,Middle,48220,38450,86670
20528,19,State - WEST BENGAL,Urban,70-74,Middle,34107,24846,58953
20529,19,State - WEST BENGAL,Urban,75-79,Middle,19222,14590,33812
20530,19,State - WEST BENGAL,Urban,80+,Middle,21750,18150,39900
20531,19,State - WEST BENGAL,Urban,Age not stated,Middle,2638,2498,5136
20532,20,State - JHARKHAND,Total,All ages,Middle,1895039,1196068,3091107
20533,20,State - JHARKHAND,Total,0-6,Middle,0,0,0
20534,20,State - JHARKHAND,Total,7,Middle,0,0,0
20535,20,State - JHARKHAND,Total,8,Middle,0,0,0
20536,20,State - JHARKHAND,Total,9,Middle,0,0,0
20537,20,State - JHARKHAND,Total,10,Middle,0,0,0
20538,20,State - JHARKHAND,Total,11,Middle,0,0,0
20539,20,State - JHARKHAND,Total,12,Middle,34096,29859,63955
20540,20,State - JHARKHAND,Total,13,Middle,75046,68956,144002
20541,20,State - JHARKHAND,Total,14,Middle,160649,141429,302078
20542,20,State - JHARKHAND,Total,15,Middle,155626,126757,282383
20543,20,State - JHARKHAND,Total,16,Middle,111581,87199,198780
20544,20,State - JHARKHAND,Total,17,Middle,60364,45027,105391
20545,20,State - JHARKHAND,Total,18,Middle,72378,49140,121518
20546,20,State - JHARKHAND,Total,19,Middle,36233,29756,65989
20547,20,State - JHARKHAND,Total,20-24,Middle,206584,145947,352531
20548,20,State - JHARKHAND,Total,25-29,Middle,224108,132684,356792
20549,20,State - JHARKHAND,Total,30-34,Middle,180488,97244,277732
20550,20,State - JHARKHAND,Total,35-39,Middle,150577,74166,224743
20551,20,State - JHARKHAND,Total,40-44,Middle,115260,50502,165762
20552,20,State - JHARKHAND,Total,45-49,Middle,92882,37336,130218
20553,20,State - JHARKHAND,Total,50-54,Middle,66233,25889,92122
20554,20,State - JHARKHAND,Total,55-59,Middle,49295,18747,68042
20555,20,State - JHARKHAND,Total,60-64,Middle,41735,14514,56249
20556,20,State - JHARKHAND,Total,65-69,Middle,27313,8328,35641
20557,20,State - JHARKHAND,Total,70-74,Middle,15244,3947,19191
20558,20,State - JHARKHAND,Total,75-79,Middle,6418,1944,8362
20559,20,State - JHARKHAND,Total,80+,Middle,6944,2620,9564
20560,20,State - JHARKHAND,Total,Age not stated,Middle,5985,4077,10062
20561,20,State - JHARKHAND,Rural,All ages,Middle,1409430,793087,2202517
20562,20,State - JHARKHAND,Rural,0-6,Middle,0,0,0
20563,20,State - JHARKHAND,Rural,7,Middle,0,0,0
20564,20,State - JHARKHAND,Rural,8,Middle,0,0,0
20565,20,State - JHARKHAND,Rural,9,Middle,0,0,0
20566,20,State - JHARKHAND,Rural,10,Middle,0,0,0
20567,20,State - JHARKHAND,Rural,11,Middle,0,0,0
20568,20,State - JHARKHAND,Rural,12,Middle,23258,19484,42742
20569,20,State - JHARKHAND,Rural,13,Middle,51439,45181,96620
20570,20,State - JHARKHAND,Rural,14,Middle,113535,96299,209834
20571,20,State - JHARKHAND,Rural,15,Middle,116715,91390,208105
20572,20,State - JHARKHAND,Rural,16,Middle,84897,64067,148964
20573,20,State - JHARKHAND,Rural,17,Middle,46172,33563,79735
20574,20,State - JHARKHAND,Rural,18,Middle,57468,37818,95286
20575,20,State - JHARKHAND,Rural,19,Middle,28093,22544,50637
20576,20,State - JHARKHAND,Rural,20-24,Middle,159979,105479,265458
20577,20,State - JHARKHAND,Rural,25-29,Middle,173217,90709,263926
20578,20,State - JHARKHAND,Rural,30-34,Middle,139491,63475,202966
20579,20,State - JHARKHAND,Rural,35-39,Middle,113627,44442,158069
20580,20,State - JHARKHAND,Rural,40-44,Middle,84547,27487,112034
20581,20,State - JHARKHAND,Rural,45-49,Middle,66335,17988,84323
20582,20,State - JHARKHAND,Rural,50-54,Middle,45992,11317,57309
20583,20,State - JHARKHAND,Rural,55-59,Middle,33731,7993,41724
20584,20,State - JHARKHAND,Rural,60-64,Middle,29316,5751,35067
20585,20,State - JHARKHAND,Rural,65-69,Middle,19649,3366,23015
20586,20,State - JHARKHAND,Rural,70-74,Middle,10392,1363,11755
20587,20,State - JHARKHAND,Rural,75-79,Middle,4151,603,4754
20588,20,State - JHARKHAND,Rural,80+,Middle,4533,1176,5709
20589,20,State - JHARKHAND,Rural,Age not stated,Middle,2893,1592,4485
20590,20,State - JHARKHAND,Urban,All ages,Middle,485609,402981,888590
20591,20,State - JHARKHAND,Urban,0-6,Middle,0,0,0
20592,20,State - JHARKHAND,Urban,7,Middle,0,0,0
20593,20,State - JHARKHAND,Urban,8,Middle,0,0,0
20594,20,State - JHARKHAND,Urban,9,Middle,0,0,0
20595,20,State - JHARKHAND,Urban,10,Middle,0,0,0
20596,20,State - JHARKHAND,Urban,11,Middle,0,0,0
20597,20,State - JHARKHAND,Urban,12,Middle,10838,10375,21213
20598,20,State - JHARKHAND,Urban,13,Middle,23607,23775,47382
20599,20,State - JHARKHAND,Urban,14,Middle,47114,45130,92244
20600,20,State - JHARKHAND,Urban,15,Middle,38911,35367,74278
20601,20,State - JHARKHAND,Urban,16,Middle,26684,23132,49816
20602,20,State - JHARKHAND,Urban,17,Middle,14192,11464,25656
20603,20,State - JHARKHAND,Urban,18,Middle,14910,11322,26232
20604,20,State - JHARKHAND,Urban,19,Middle,8140,7212,15352
20605,20,State - JHARKHAND,Urban,20-24,Middle,46605,40468,87073
20606,20,State - JHARKHAND,Urban,25-29,Middle,50891,41975,92866
20607,20,State - JHARKHAND,Urban,30-34,Middle,40997,33769,74766
20608,20,State - JHARKHAND,Urban,35-39,Middle,36950,29724,66674
20609,20,State - JHARKHAND,Urban,40-44,Middle,30713,23015,53728
20610,20,State - JHARKHAND,Urban,45-49,Middle,26547,19348,45895
20611,20,State - JHARKHAND,Urban,50-54,Middle,20241,14572,34813
20612,20,State - JHARKHAND,Urban,55-59,Middle,15564,10754,26318
20613,20,State - JHARKHAND,Urban,60-64,Middle,12419,8763,21182
20614,20,State - JHARKHAND,Urban,65-69,Middle,7664,4962,12626
20615,20,State - JHARKHAND,Urban,70-74,Middle,4852,2584,7436
20616,20,State - JHARKHAND,Urban,75-79,Middle,2267,1341,3608
20617,20,State - JHARKHAND,Urban,80+,Middle,2411,1444,3855
20618,20,State - JHARKHAND,Urban,Age not stated,Middle,3092,2485,5577
20619,21,State - ODISHA,Total,All ages,Middle,3035765,2249478,5285243
20620,21,State - ODISHA,Total,0-6,Middle,0,0,0
20621,21,State - ODISHA,Total,7,Middle,0,0,0
20622,21,State - ODISHA,Total,8,Middle,0,0,0
20623,21,State - ODISHA,Total,9,Middle,0,0,0
20624,21,State - ODISHA,Total,10,Middle,0,0,0
20625,21,State - ODISHA,Total,11,Middle,0,0,0
20626,21,State - ODISHA,Total,12,Middle,43266,41348,84614
20627,21,State - ODISHA,Total,13,Middle,142608,140859,283467
20628,21,State - ODISHA,Total,14,Middle,245027,238968,483995
20629,21,State - ODISHA,Total,15,Middle,195191,181496,376687
20630,21,State - ODISHA,Total,16,Middle,125233,115509,240742
20631,21,State - ODISHA,Total,17,Middle,89521,84511,174032
20632,21,State - ODISHA,Total,18,Middle,113369,97648,211017
20633,21,State - ODISHA,Total,19,Middle,83199,75031,158230
20634,21,State - ODISHA,Total,20-24,Middle,479164,406297,885461
20635,21,State - ODISHA,Total,25-29,Middle,401561,303639,705200
20636,21,State - ODISHA,Total,30-34,Middle,271052,189790,460842
20637,21,State - ODISHA,Total,35-39,Middle,241230,147095,388325
20638,21,State - ODISHA,Total,40-44,Middle,199446,90764,290210
20639,21,State - ODISHA,Total,45-49,Middle,137520,54817,192337
20640,21,State - ODISHA,Total,50-54,Middle,93196,32940,126136
20641,21,State - ODISHA,Total,55-59,Middle,67255,20061,87316
20642,21,State - ODISHA,Total,60-64,Middle,48415,11225,59640
20643,21,State - ODISHA,Total,65-69,Middle,24825,5637,30462
20644,21,State - ODISHA,Total,70-74,Middle,14367,3099,17466
20645,21,State - ODISHA,Total,75-79,Middle,6776,1424,8200
20646,21,State - ODISHA,Total,80+,Middle,7228,2600,9828
20647,21,State - ODISHA,Total,Age not stated,Middle,6316,4720,11036
20648,21,State - ODISHA,Rural,All ages,Middle,2554590,1856626,4411216
20649,21,State - ODISHA,Rural,0-6,Middle,0,0,0
20650,21,State - ODISHA,Rural,7,Middle,0,0,0
20651,21,State - ODISHA,Rural,8,Middle,0,0,0
20652,21,State - ODISHA,Rural,9,Middle,0,0,0
20653,21,State - ODISHA,Rural,10,Middle,0,0,0
20654,21,State - ODISHA,Rural,11,Middle,0,0,0
20655,21,State - ODISHA,Rural,12,Middle,34993,33058,68051
20656,21,State - ODISHA,Rural,13,Middle,117173,115129,232302
20657,21,State - ODISHA,Rural,14,Middle,201759,197129,398888
20658,21,State - ODISHA,Rural,15,Middle,163514,153083,316597
20659,21,State - ODISHA,Rural,16,Middle,107171,99520,206691
20660,21,State - ODISHA,Rural,17,Middle,77452,73622,151074
20661,21,State - ODISHA,Rural,18,Middle,98574,85571,184145
20662,21,State - ODISHA,Rural,19,Middle,72171,65098,137269
20663,21,State - ODISHA,Rural,20-24,Middle,414403,349696,764099
20664,21,State - ODISHA,Rural,25-29,Middle,345515,256484,601999
20665,21,State - ODISHA,Rural,30-34,Middle,229185,155650,384835
20666,21,State - ODISHA,Rural,35-39,Middle,202424,115613,318037
20667,21,State - ODISHA,Rural,40-44,Middle,165572,67491,233063
20668,21,State - ODISHA,Rural,45-49,Middle,110592,37818,148410
20669,21,State - ODISHA,Rural,50-54,Middle,74222,21592,95814
20670,21,State - ODISHA,Rural,55-59,Middle,53950,12743,66693
20671,21,State - ODISHA,Rural,60-64,Middle,39861,6518,46379
20672,21,State - ODISHA,Rural,65-69,Middle,19865,3153,23018
20673,21,State - ODISHA,Rural,70-74,Middle,10857,1597,12454
20674,21,State - ODISHA,Rural,75-79,Middle,4959,693,5652
20675,21,State - ODISHA,Rural,80+,Middle,5326,1691,7017
20676,21,State - ODISHA,Rural,Age not stated,Middle,5052,3677,8729
20677,21,State - ODISHA,Urban,All ages,Middle,481175,392852,874027
20678,21,State - ODISHA,Urban,0-6,Middle,0,0,0
20679,21,State - ODISHA,Urban,7,Middle,0,0,0
20680,21,State - ODISHA,Urban,8,Middle,0,0,0
20681,21,State - ODISHA,Urban,9,Middle,0,0,0
20682,21,State - ODISHA,Urban,10,Middle,0,0,0
20683,21,State - ODISHA,Urban,11,Middle,0,0,0
20684,21,State - ODISHA,Urban,12,Middle,8273,8290,16563
20685,21,State - ODISHA,Urban,13,Middle,25435,25730,51165
20686,21,State - ODISHA,Urban,14,Middle,43268,41839,85107
20687,21,State - ODISHA,Urban,15,Middle,31677,28413,60090
20688,21,State - ODISHA,Urban,16,Middle,18062,15989,34051
20689,21,State - ODISHA,Urban,17,Middle,12069,10889,22958
20690,21,State - ODISHA,Urban,18,Middle,14795,12077,26872
20691,21,State - ODISHA,Urban,19,Middle,11028,9933,20961
20692,21,State - ODISHA,Urban,20-24,Middle,64761,56601,121362
20693,21,State - ODISHA,Urban,25-29,Middle,56046,47155,103201
20694,21,State - ODISHA,Urban,30-34,Middle,41867,34140,76007
20695,21,State - ODISHA,Urban,35-39,Middle,38806,31482,70288
20696,21,State - ODISHA,Urban,40-44,Middle,33874,23273,57147
20697,21,State - ODISHA,Urban,45-49,Middle,26928,16999,43927
20698,21,State - ODISHA,Urban,50-54,Middle,18974,11348,30322
20699,21,State - ODISHA,Urban,55-59,Middle,13305,7318,20623
20700,21,State - ODISHA,Urban,60-64,Middle,8554,4707,13261
20701,21,State - ODISHA,Urban,65-69,Middle,4960,2484,7444
20702,21,State - ODISHA,Urban,70-74,Middle,3510,1502,5012
20703,21,State - ODISHA,Urban,75-79,Middle,1817,731,2548
20704,21,State - ODISHA,Urban,80+,Middle,1902,909,2811
20705,21,State - ODISHA,Urban,Age not stated,Middle,1264,1043,2307
20706,22,State - CHHATTISGARH,Total,All ages,Middle,1825488,1376916,3202404
20707,22,State - CHHATTISGARH,Total,0-6,Middle,0,0,0
20708,22,State - CHHATTISGARH,Total,7,Middle,0,0,0
20709,22,State - CHHATTISGARH,Total,8,Middle,0,0,0
20710,22,State - CHHATTISGARH,Total,9,Middle,0,0,0
20711,22,State - CHHATTISGARH,Total,10,Middle,0,0,0
20712,22,State - CHHATTISGARH,Total,11,Middle,0,0,0
20713,22,State - CHHATTISGARH,Total,12,Middle,10306,9586,19892
20714,22,State - CHHATTISGARH,Total,13,Middle,35235,35729,70964
20715,22,State - CHHATTISGARH,Total,14,Middle,104756,104470,209226
20716,22,State - CHHATTISGARH,Total,15,Middle,134843,128627,263470
20717,22,State - CHHATTISGARH,Total,16,Middle,118656,110868,229524
20718,22,State - CHHATTISGARH,Total,17,Middle,84338,76241,160579
20719,22,State - CHHATTISGARH,Total,18,Middle,88620,75580,164200
20720,22,State - CHHATTISGARH,Total,19,Middle,60870,56496,117366
20721,22,State - CHHATTISGARH,Total,20-24,Middle,305665,256460,562125
20722,22,State - CHHATTISGARH,Total,25-29,Middle,246166,181215,427381
20723,22,State - CHHATTISGARH,Total,30-34,Middle,183606,125086,308692
20724,22,State - CHHATTISGARH,Total,35-39,Middle,150205,85964,236169
20725,22,State - CHHATTISGARH,Total,40-44,Middle,102301,49929,152230
20726,22,State - CHHATTISGARH,Total,45-49,Middle,64765,29467,94232
20727,22,State - CHHATTISGARH,Total,50-54,Middle,44863,18637,63500
20728,22,State - CHHATTISGARH,Total,55-59,Middle,36266,12599,48865
20729,22,State - CHHATTISGARH,Total,60-64,Middle,24098,8165,32263
20730,22,State - CHHATTISGARH,Total,65-69,Middle,14354,5030,19384
20731,22,State - CHHATTISGARH,Total,70-74,Middle,7378,2302,9680
20732,22,State - CHHATTISGARH,Total,75-79,Middle,2902,1110,4012
20733,22,State - CHHATTISGARH,Total,80+,Middle,4067,2429,6496
20734,22,State - CHHATTISGARH,Total,Age not stated,Middle,1228,926,2154
20735,22,State - CHHATTISGARH,Rural,All ages,Middle,1421517,1021593,2443110
20736,22,State - CHHATTISGARH,Rural,0-6,Middle,0,0,0
20737,22,State - CHHATTISGARH,Rural,7,Middle,0,0,0
20738,22,State - CHHATTISGARH,Rural,8,Middle,0,0,0
20739,22,State - CHHATTISGARH,Rural,9,Middle,0,0,0
20740,22,State - CHHATTISGARH,Rural,10,Middle,0,0,0
20741,22,State - CHHATTISGARH,Rural,11,Middle,0,0,0
20742,22,State - CHHATTISGARH,Rural,12,Middle,6475,5671,12146
20743,22,State - CHHATTISGARH,Rural,13,Middle,22380,22085,44465
20744,22,State - CHHATTISGARH,Rural,14,Middle,74070,72690,146760
20745,22,State - CHHATTISGARH,Rural,15,Middle,103307,98706,202013
20746,22,State - CHHATTISGARH,Rural,16,Middle,96164,90359,186523
20747,22,State - CHHATTISGARH,Rural,17,Middle,68996,63231,132227
20748,22,State - CHHATTISGARH,Rural,18,Middle,73212,62934,136146
20749,22,State - CHHATTISGARH,Rural,19,Middle,50010,46806,96816
20750,22,State - CHHATTISGARH,Rural,20-24,Middle,248877,203791,452668
20751,22,State - CHHATTISGARH,Rural,25-29,Middle,196669,137395,334064
20752,22,State - CHHATTISGARH,Rural,30-34,Middle,145925,92615,238540
20753,22,State - CHHATTISGARH,Rural,35-39,Middle,119120,58540,177660
20754,22,State - CHHATTISGARH,Rural,40-44,Middle,77665,29910,107575
20755,22,State - CHHATTISGARH,Rural,45-49,Middle,46246,14660,60906
20756,22,State - CHHATTISGARH,Rural,50-54,Middle,30648,8542,39190
20757,22,State - CHHATTISGARH,Rural,55-59,Middle,25473,5684,31157
20758,22,State - CHHATTISGARH,Rural,60-64,Middle,16999,3093,20092
20759,22,State - CHHATTISGARH,Rural,65-69,Middle,9822,1993,11815
20760,22,State - CHHATTISGARH,Rural,70-74,Middle,4580,650,5230
20761,22,State - CHHATTISGARH,Rural,75-79,Middle,1584,295,1879
20762,22,State - CHHATTISGARH,Rural,80+,Middle,2569,1414,3983
20763,22,State - CHHATTISGARH,Rural,Age not stated,Middle,726,529,1255
20764,22,State - CHHATTISGARH,Urban,All ages,Middle,403971,355323,759294
20765,22,State - CHHATTISGARH,Urban,0-6,Middle,0,0,0
20766,22,State - CHHATTISGARH,Urban,7,Middle,0,0,0
20767,22,State - CHHATTISGARH,Urban,8,Middle,0,0,0
20768,22,State - CHHATTISGARH,Urban,9,Middle,0,0,0
20769,22,State - CHHATTISGARH,Urban,10,Middle,0,0,0
20770,22,State - CHHATTISGARH,Urban,11,Middle,0,0,0
20771,22,State - CHHATTISGARH,Urban,12,Middle,3831,3915,7746
20772,22,State - CHHATTISGARH,Urban,13,Middle,12855,13644,26499
20773,22,State - CHHATTISGARH,Urban,14,Middle,30686,31780,62466
20774,22,State - CHHATTISGARH,Urban,15,Middle,31536,29921,61457
20775,22,State - CHHATTISGARH,Urban,16,Middle,22492,20509,43001
20776,22,State - CHHATTISGARH,Urban,17,Middle,15342,13010,28352
20777,22,State - CHHATTISGARH,Urban,18,Middle,15408,12646,28054
20778,22,State - CHHATTISGARH,Urban,19,Middle,10860,9690,20550
20779,22,State - CHHATTISGARH,Urban,20-24,Middle,56788,52669,109457
20780,22,State - CHHATTISGARH,Urban,25-29,Middle,49497,43820,93317
20781,22,State - CHHATTISGARH,Urban,30-34,Middle,37681,32471,70152
20782,22,State - CHHATTISGARH,Urban,35-39,Middle,31085,27424,58509
20783,22,State - CHHATTISGARH,Urban,40-44,Middle,24636,20019,44655
20784,22,State - CHHATTISGARH,Urban,45-49,Middle,18519,14807,33326
20785,22,State - CHHATTISGARH,Urban,50-54,Middle,14215,10095,24310
20786,22,State - CHHATTISGARH,Urban,55-59,Middle,10793,6915,17708
20787,22,State - CHHATTISGARH,Urban,60-64,Middle,7099,5072,12171
20788,22,State - CHHATTISGARH,Urban,65-69,Middle,4532,3037,7569
20789,22,State - CHHATTISGARH,Urban,70-74,Middle,2798,1652,4450
20790,22,State - CHHATTISGARH,Urban,75-79,Middle,1318,815,2133
20791,22,State - CHHATTISGARH,Urban,80+,Middle,1498,1015,2513
20792,22,State - CHHATTISGARH,Urban,Age not stated,Middle,502,397,899
20793,23,State - MADHYA PRADESH,Total,All ages,Middle,5094579,3336421,8431000
20794,23,State - MADHYA PRADESH,Total,0-6,Middle,0,0,0
20795,23,State - MADHYA PRADESH,Total,7,Middle,0,0,0
20796,23,State - MADHYA PRADESH,Total,8,Middle,0,0,0
20797,23,State - MADHYA PRADESH,Total,9,Middle,0,0,0
20798,23,State - MADHYA PRADESH,Total,10,Middle,0,0,0
20799,23,State - MADHYA PRADESH,Total,11,Middle,0,0,0
20800,23,State - MADHYA PRADESH,Total,12,Middle,58043,48805,106848
20801,23,State - MADHYA PRADESH,Total,13,Middle,147721,134854,282575
20802,23,State - MADHYA PRADESH,Total,14,Middle,337912,305861,643773
20803,23,State - MADHYA PRADESH,Total,15,Middle,375578,314441,690019
20804,23,State - MADHYA PRADESH,Total,16,Middle,306641,255816,562457
20805,23,State - MADHYA PRADESH,Total,17,Middle,219034,176968,396002
20806,23,State - MADHYA PRADESH,Total,18,Middle,247242,193225,440467
20807,23,State - MADHYA PRADESH,Total,19,Middle,160965,128207,289172
20808,23,State - MADHYA PRADESH,Total,20-24,Middle,807857,546281,1354138
20809,23,State - MADHYA PRADESH,Total,25-29,Middle,598345,371157,969502
20810,23,State - MADHYA PRADESH,Total,30-34,Middle,481262,270329,751591
20811,23,State - MADHYA PRADESH,Total,35-39,Middle,402437,199110,601547
20812,23,State - MADHYA PRADESH,Total,40-44,Middle,294714,128349,423063
20813,23,State - MADHYA PRADESH,Total,45-49,Middle,204366,87486,291852
20814,23,State - MADHYA PRADESH,Total,50-54,Middle,151884,58691,210575
20815,23,State - MADHYA PRADESH,Total,55-59,Middle,105489,40116,145605
20816,23,State - MADHYA PRADESH,Total,60-64,Middle,79618,30288,109906
20817,23,State - MADHYA PRADESH,Total,65-69,Middle,48036,19610,67646
20818,23,State - MADHYA PRADESH,Total,70-74,Middle,30435,9831,40266
20819,23,State - MADHYA PRADESH,Total,75-79,Middle,14071,5090,19161
20820,23,State - MADHYA PRADESH,Total,80+,Middle,18661,8710,27371
20821,23,State - MADHYA PRADESH,Total,Age not stated,Middle,4268,3196,7464
20822,23,State - MADHYA PRADESH,Rural,All ages,Middle,3683782,2170959,5854741
20823,23,State - MADHYA PRADESH,Rural,0-6,Middle,0,0,0
20824,23,State - MADHYA PRADESH,Rural,7,Middle,0,0,0
20825,23,State - MADHYA PRADESH,Rural,8,Middle,0,0,0
20826,23,State - MADHYA PRADESH,Rural,9,Middle,0,0,0
20827,23,State - MADHYA PRADESH,Rural,10,Middle,0,0,0
20828,23,State - MADHYA PRADESH,Rural,11,Middle,0,0,0
20829,23,State - MADHYA PRADESH,Rural,12,Middle,36425,28636,65061
20830,23,State - MADHYA PRADESH,Rural,13,Middle,92158,79570,171728
20831,23,State - MADHYA PRADESH,Rural,14,Middle,224521,196340,420861
20832,23,State - MADHYA PRADESH,Rural,15,Middle,271791,223185,494976
20833,23,State - MADHYA PRADESH,Rural,16,Middle,236207,195726,431933
20834,23,State - MADHYA PRADESH,Rural,17,Middle,171660,137960,309620
20835,23,State - MADHYA PRADESH,Rural,18,Middle,197017,150737,347754
20836,23,State - MADHYA PRADESH,Rural,19,Middle,126744,98521,225265
20837,23,State - MADHYA PRADESH,Rural,20-24,Middle,626840,389155,1015995
20838,23,State - MADHYA PRADESH,Rural,25-29,Middle,444342,238717,683059
20839,23,State - MADHYA PRADESH,Rural,30-34,Middle,352525,165365,517890
20840,23,State - MADHYA PRADESH,Rural,35-39,Middle,290025,109424,399449
20841,23,State - MADHYA PRADESH,Rural,40-44,Middle,203063,61805,264868
20842,23,State - MADHYA PRADESH,Rural,45-49,Middle,131013,35365,166378
20843,23,State - MADHYA PRADESH,Rural,50-54,Middle,95104,21586,116690
20844,23,State - MADHYA PRADESH,Rural,55-59,Middle,67045,13888,80933
20845,23,State - MADHYA PRADESH,Rural,60-64,Middle,49840,9236,59076
20846,23,State - MADHYA PRADESH,Rural,65-69,Middle,29291,6432,35723
20847,23,State - MADHYA PRADESH,Rural,70-74,Middle,17560,2620,20180
20848,23,State - MADHYA PRADESH,Rural,75-79,Middle,7621,1249,8870
20849,23,State - MADHYA PRADESH,Rural,80+,Middle,10706,3912,14618
20850,23,State - MADHYA PRADESH,Rural,Age not stated,Middle,2284,1530,3814
20851,23,State - MADHYA PRADESH,Urban,All ages,Middle,1410797,1165462,2576259
20852,23,State - MADHYA PRADESH,Urban,0-6,Middle,0,0,0
20853,23,State - MADHYA PRADESH,Urban,7,Middle,0,0,0
20854,23,State - MADHYA PRADESH,Urban,8,Middle,0,0,0
20855,23,State - MADHYA PRADESH,Urban,9,Middle,0,0,0
20856,23,State - MADHYA PRADESH,Urban,10,Middle,0,0,0
20857,23,State - MADHYA PRADESH,Urban,11,Middle,0,0,0
20858,23,State - MADHYA PRADESH,Urban,12,Middle,21618,20169,41787
20859,23,State - MADHYA PRADESH,Urban,13,Middle,55563,55284,110847
20860,23,State - MADHYA PRADESH,Urban,14,Middle,113391,109521,222912
20861,23,State - MADHYA PRADESH,Urban,15,Middle,103787,91256,195043
20862,23,State - MADHYA PRADESH,Urban,16,Middle,70434,60090,130524
20863,23,State - MADHYA PRADESH,Urban,17,Middle,47374,39008,86382
20864,23,State - MADHYA PRADESH,Urban,18,Middle,50225,42488,92713
20865,23,State - MADHYA PRADESH,Urban,19,Middle,34221,29686,63907
20866,23,State - MADHYA PRADESH,Urban,20-24,Middle,181017,157126,338143
20867,23,State - MADHYA PRADESH,Urban,25-29,Middle,154003,132440,286443
20868,23,State - MADHYA PRADESH,Urban,30-34,Middle,128737,104964,233701
20869,23,State - MADHYA PRADESH,Urban,35-39,Middle,112412,89686,202098
20870,23,State - MADHYA PRADESH,Urban,40-44,Middle,91651,66544,158195
20871,23,State - MADHYA PRADESH,Urban,45-49,Middle,73353,52121,125474
20872,23,State - MADHYA PRADESH,Urban,50-54,Middle,56780,37105,93885
20873,23,State - MADHYA PRADESH,Urban,55-59,Middle,38444,26228,64672
20874,23,State - MADHYA PRADESH,Urban,60-64,Middle,29778,21052,50830
20875,23,State - MADHYA PRADESH,Urban,65-69,Middle,18745,13178,31923
20876,23,State - MADHYA PRADESH,Urban,70-74,Middle,12875,7211,20086
20877,23,State - MADHYA PRADESH,Urban,75-79,Middle,6450,3841,10291
20878,23,State - MADHYA PRADESH,Urban,80+,Middle,7955,4798,12753
20879,23,State - MADHYA PRADESH,Urban,Age not stated,Middle,1984,1666,3650
20880,24,State - GUJARAT,Total,All ages,Middle,4031450,2422485,6453935
20881,24,State - GUJARAT,Total,0-6,Middle,0,0,0
20882,24,State - GUJARAT,Total,7,Middle,0,0,0
20883,24,State - GUJARAT,Total,8,Middle,0,0,0
20884,24,State - GUJARAT,Total,9,Middle,0,0,0
20885,24,State - GUJARAT,Total,10,Middle,0,0,0
20886,24,State - GUJARAT,Total,11,Middle,0,0,0
20887,24,State - GUJARAT,Total,12,Middle,68993,54354,123347
20888,24,State - GUJARAT,Total,13,Middle,214631,169177,383808
20889,24,State - GUJARAT,Total,14,Middle,372564,279620,652184
20890,24,State - GUJARAT,Total,15,Middle,285648,194221,479869
20891,24,State - GUJARAT,Total,16,Middle,178782,115253,294035
20892,24,State - GUJARAT,Total,17,Middle,129561,82334,211895
20893,24,State - GUJARAT,Total,18,Middle,136844,82123,218967
20894,24,State - GUJARAT,Total,19,Middle,109496,69249,178745
20895,24,State - GUJARAT,Total,20-24,Middle,586934,342358,929292
20896,24,State - GUJARAT,Total,25-29,Middle,476950,270269,747219
20897,24,State - GUJARAT,Total,30-34,Middle,396604,216713,613317
20898,24,State - GUJARAT,Total,35-39,Middle,293362,161881,455243
20899,24,State - GUJARAT,Total,40-44,Middle,240672,130161,370833
20900,24,State - GUJARAT,Total,45-49,Middle,185514,94061,279575
20901,24,State - GUJARAT,Total,50-54,Middle,129874,58129,188003
20902,24,State - GUJARAT,Total,55-59,Middle,86730,39079,125809
20903,24,State - GUJARAT,Total,60-64,Middle,59707,25932,85639
20904,24,State - GUJARAT,Total,65-69,Middle,31482,13505,44987
20905,24,State - GUJARAT,Total,70-74,Middle,16619,6818,23437
20906,24,State - GUJARAT,Total,75-79,Middle,7104,3201,10305
20907,24,State - GUJARAT,Total,80+,Middle,9182,5033,14215
20908,24,State - GUJARAT,Total,Age not stated,Middle,14197,9014,23211
20909,24,State - GUJARAT,Rural,All ages,Middle,2165852,1204519,3370371
20910,24,State - GUJARAT,Rural,0-6,Middle,0,0,0
20911,24,State - GUJARAT,Rural,7,Middle,0,0,0
20912,24,State - GUJARAT,Rural,8,Middle,0,0,0
20913,24,State - GUJARAT,Rural,9,Middle,0,0,0
20914,24,State - GUJARAT,Rural,10,Middle,0,0,0
20915,24,State - GUJARAT,Rural,11,Middle,0,0,0
20916,24,State - GUJARAT,Rural,12,Middle,35096,27293,62389
20917,24,State - GUJARAT,Rural,13,Middle,120339,92259,212598
20918,24,State - GUJARAT,Rural,14,Middle,207749,150092,357841
20919,24,State - GUJARAT,Rural,15,Middle,168048,111676,279724
20920,24,State - GUJARAT,Rural,16,Middle,110168,69662,179830
20921,24,State - GUJARAT,Rural,17,Middle,78616,50245,128861
20922,24,State - GUJARAT,Rural,18,Middle,79318,48624,127942
20923,24,State - GUJARAT,Rural,19,Middle,61223,39894,101117
20924,24,State - GUJARAT,Rural,20-24,Middle,325799,182778,508577
20925,24,State - GUJARAT,Rural,25-29,Middle,248272,126344,374616
20926,24,State - GUJARAT,Rural,30-34,Middle,210077,100882,310959
20927,24,State - GUJARAT,Rural,35-39,Middle,151415,70392,221807
20928,24,State - GUJARAT,Rural,40-44,Middle,120860,52700,173560
20929,24,State - GUJARAT,Rural,45-49,Middle,89721,33406,123127
20930,24,State - GUJARAT,Rural,50-54,Middle,60450,18884,79334
20931,24,State - GUJARAT,Rural,55-59,Middle,39848,11889,51737
20932,24,State - GUJARAT,Rural,60-64,Middle,27050,7163,34213
20933,24,State - GUJARAT,Rural,65-69,Middle,13466,3282,16748
20934,24,State - GUJARAT,Rural,70-74,Middle,6454,1283,7737
20935,24,State - GUJARAT,Rural,75-79,Middle,2286,557,2843
20936,24,State - GUJARAT,Rural,80+,Middle,3314,1458,4772
20937,24,State - GUJARAT,Rural,Age not stated,Middle,6283,3756,10039
20938,24,State - GUJARAT,Urban,All ages,Middle,1865598,1217966,3083564
20939,24,State - GUJARAT,Urban,0-6,Middle,0,0,0
20940,24,State - GUJARAT,Urban,7,Middle,0,0,0
20941,24,State - GUJARAT,Urban,8,Middle,0,0,0
20942,24,State - GUJARAT,Urban,9,Middle,0,0,0
20943,24,State - GUJARAT,Urban,10,Middle,0,0,0
20944,24,State - GUJARAT,Urban,11,Middle,0,0,0
20945,24,State - GUJARAT,Urban,12,Middle,33897,27061,60958
20946,24,State - GUJARAT,Urban,13,Middle,94292,76918,171210
20947,24,State - GUJARAT,Urban,14,Middle,164815,129528,294343
20948,24,State - GUJARAT,Urban,15,Middle,117600,82545,200145
20949,24,State - GUJARAT,Urban,16,Middle,68614,45591,114205
20950,24,State - GUJARAT,Urban,17,Middle,50945,32089,83034
20951,24,State - GUJARAT,Urban,18,Middle,57526,33499,91025
20952,24,State - GUJARAT,Urban,19,Middle,48273,29355,77628
20953,24,State - GUJARAT,Urban,20-24,Middle,261135,159580,420715
20954,24,State - GUJARAT,Urban,25-29,Middle,228678,143925,372603
20955,24,State - GUJARAT,Urban,30-34,Middle,186527,115831,302358
20956,24,State - GUJARAT,Urban,35-39,Middle,141947,91489,233436
20957,24,State - GUJARAT,Urban,40-44,Middle,119812,77461,197273
20958,24,State - GUJARAT,Urban,45-49,Middle,95793,60655,156448
20959,24,State - GUJARAT,Urban,50-54,Middle,69424,39245,108669
20960,24,State - GUJARAT,Urban,55-59,Middle,46882,27190,74072
20961,24,State - GUJARAT,Urban,60-64,Middle,32657,18769,51426
20962,24,State - GUJARAT,Urban,65-69,Middle,18016,10223,28239
20963,24,State - GUJARAT,Urban,70-74,Middle,10165,5535,15700
20964,24,State - GUJARAT,Urban,75-79,Middle,4818,2644,7462
20965,24,State - GUJARAT,Urban,80+,Middle,5868,3575,9443
20966,24,State - GUJARAT,Urban,Age not stated,Middle,7914,5258,13172
20967,25,State - DAMAN & DIU,Total,All ages,Middle,24792,10834,35626
20968,25,State - DAMAN & DIU,Total,0-6,Middle,0,0,0
20969,25,State - DAMAN & DIU,Total,7,Middle,0,0,0
20970,25,State - DAMAN & DIU,Total,8,Middle,0,0,0
20971,25,State - DAMAN & DIU,Total,9,Middle,0,0,0
20972,25,State - DAMAN & DIU,Total,10,Middle,0,0,0
20973,25,State - DAMAN & DIU,Total,11,Middle,0,0,0
20974,25,State - DAMAN & DIU,Total,12,Middle,207,184,391
20975,25,State - DAMAN & DIU,Total,13,Middle,636,625,1261
20976,25,State - DAMAN & DIU,Total,14,Middle,1156,1085,2241
20977,25,State - DAMAN & DIU,Total,15,Middle,893,714,1607
20978,25,State - DAMAN & DIU,Total,16,Middle,757,365,1122
20979,25,State - DAMAN & DIU,Total,17,Middle,735,244,979
20980,25,State - DAMAN & DIU,Total,18,Middle,1477,273,1750
20981,25,State - DAMAN & DIU,Total,19,Middle,1200,264,1464
20982,25,State - DAMAN & DIU,Total,20-24,Middle,6210,1688,7898
20983,25,State - DAMAN & DIU,Total,25-29,Middle,4274,1629,5903
20984,25,State - DAMAN & DIU,Total,30-34,Middle,2517,1286,3803
20985,25,State - DAMAN & DIU,Total,35-39,Middle,1724,989,2713
20986,25,State - DAMAN & DIU,Total,40-44,Middle,1182,641,1823
20987,25,State - DAMAN & DIU,Total,45-49,Middle,754,402,1156
20988,25,State - DAMAN & DIU,Total,50-54,Middle,459,195,654
20989,25,State - DAMAN & DIU,Total,55-59,Middle,258,121,379
20990,25,State - DAMAN & DIU,Total,60-64,Middle,170,65,235
20991,25,State - DAMAN & DIU,Total,65-69,Middle,57,28,85
20992,25,State - DAMAN & DIU,Total,70-74,Middle,42,13,55
20993,25,State - DAMAN & DIU,Total,75-79,Middle,18,5,23
20994,25,State - DAMAN & DIU,Total,80+,Middle,32,10,42
20995,25,State - DAMAN & DIU,Total,Age not stated,Middle,34,8,42
20996,25,State - DAMAN & DIU,Rural,All ages,Middle,4812,3306,8118
20997,25,State - DAMAN & DIU,Rural,0-6,Middle,0,0,0
20998,25,State - DAMAN & DIU,Rural,7,Middle,0,0,0
20999,25,State - DAMAN & DIU,Rural,8,Middle,0,0,0
21000,25,State - DAMAN & DIU,Rural,9,Middle,0,0,0
21001,25,State - DAMAN & DIU,Rural,10,Middle,0,0,0
21002,25,State - DAMAN & DIU,Rural,11,Middle,0,0,0
21003,25,State - DAMAN & DIU,Rural,12,Middle,89,99,188
21004,25,State - DAMAN & DIU,Rural,13,Middle,267,297,564
21005,25,State - DAMAN & DIU,Rural,14,Middle,439,451,890
21006,25,State - DAMAN & DIU,Rural,15,Middle,300,252,552
21007,25,State - DAMAN & DIU,Rural,16,Middle,223,145,368
21008,25,State - DAMAN & DIU,Rural,17,Middle,166,114,280
21009,25,State - DAMAN & DIU,Rural,18,Middle,184,88,272
21010,25,State - DAMAN & DIU,Rural,19,Middle,166,98,264
21011,25,State - DAMAN & DIU,Rural,20-24,Middle,839,550,1389
21012,25,State - DAMAN & DIU,Rural,25-29,Middle,656,442,1098
21013,25,State - DAMAN & DIU,Rural,30-34,Middle,517,328,845
21014,25,State - DAMAN & DIU,Rural,35-39,Middle,365,211,576
21015,25,State - DAMAN & DIU,Rural,40-44,Middle,235,115,350
21016,25,State - DAMAN & DIU,Rural,45-49,Middle,151,63,214
21017,25,State - DAMAN & DIU,Rural,50-54,Middle,111,23,134
21018,25,State - DAMAN & DIU,Rural,55-59,Middle,41,10,51
21019,25,State - DAMAN & DIU,Rural,60-64,Middle,30,10,40
21020,25,State - DAMAN & DIU,Rural,65-69,Middle,9,5,14
21021,25,State - DAMAN & DIU,Rural,70-74,Middle,9,1,10
21022,25,State - DAMAN & DIU,Rural,75-79,Middle,4,0,4
21023,25,State - DAMAN & DIU,Rural,80+,Middle,5,2,7
21024,25,State - DAMAN & DIU,Rural,Age not stated,Middle,6,2,8
21025,25,State - DAMAN & DIU,Urban,All ages,Middle,19980,7528,27508
21026,25,State - DAMAN & DIU,Urban,0-6,Middle,0,0,0
21027,25,State - DAMAN & DIU,Urban,7,Middle,0,0,0
21028,25,State - DAMAN & DIU,Urban,8,Middle,0,0,0
21029,25,State - DAMAN & DIU,Urban,9,Middle,0,0,0
21030,25,State - DAMAN & DIU,Urban,10,Middle,0,0,0
21031,25,State - DAMAN & DIU,Urban,11,Middle,0,0,0
21032,25,State - DAMAN & DIU,Urban,12,Middle,118,85,203
21033,25,State - DAMAN & DIU,Urban,13,Middle,369,328,697
21034,25,State - DAMAN & DIU,Urban,14,Middle,717,634,1351
21035,25,State - DAMAN & DIU,Urban,15,Middle,593,462,1055
21036,25,State - DAMAN & DIU,Urban,16,Middle,534,220,754
21037,25,State - DAMAN & DIU,Urban,17,Middle,569,130,699
21038,25,State - DAMAN & DIU,Urban,18,Middle,1293,185,1478
21039,25,State - DAMAN & DIU,Urban,19,Middle,1034,166,1200
21040,25,State - DAMAN & DIU,Urban,20-24,Middle,5371,1138,6509
21041,25,State - DAMAN & DIU,Urban,25-29,Middle,3618,1187,4805
21042,25,State - DAMAN & DIU,Urban,30-34,Middle,2000,958,2958
21043,25,State - DAMAN & DIU,Urban,35-39,Middle,1359,778,2137
21044,25,State - DAMAN & DIU,Urban,40-44,Middle,947,526,1473
21045,25,State - DAMAN & DIU,Urban,45-49,Middle,603,339,942
21046,25,State - DAMAN & DIU,Urban,50-54,Middle,348,172,520
21047,25,State - DAMAN & DIU,Urban,55-59,Middle,217,111,328
21048,25,State - DAMAN & DIU,Urban,60-64,Middle,140,55,195
21049,25,State - DAMAN & DIU,Urban,65-69,Middle,48,23,71
21050,25,State - DAMAN & DIU,Urban,70-74,Middle,33,12,45
21051,25,State - DAMAN & DIU,Urban,75-79,Middle,14,5,19
21052,25,State - DAMAN & DIU,Urban,80+,Middle,27,8,35
21053,25,State - DAMAN & DIU,Urban,Age not stated,Middle,28,6,34
21054,26,State - DADRA & NAGAR HAVELI,Total,All ages,Middle,24919,12466,37385
21055,26,State - DADRA & NAGAR HAVELI,Total,0-6,Middle,0,0,0
21056,26,State - DADRA & NAGAR HAVELI,Total,7,Middle,0,0,0
21057,26,State - DADRA & NAGAR HAVELI,Total,8,Middle,0,0,0
21058,26,State - DADRA & NAGAR HAVELI,Total,9,Middle,0,0,0
21059,26,State - DADRA & NAGAR HAVELI,Total,10,Middle,0,0,0
21060,26,State - DADRA & NAGAR HAVELI,Total,11,Middle,0,0,0
21061,26,State - DADRA & NAGAR HAVELI,Total,12,Middle,307,222,529
21062,26,State - DADRA & NAGAR HAVELI,Total,13,Middle,1013,780,1793
21063,26,State - DADRA & NAGAR HAVELI,Total,14,Middle,1737,1335,3072
21064,26,State - DADRA & NAGAR HAVELI,Total,15,Middle,1620,1143,2763
21065,26,State - DADRA & NAGAR HAVELI,Total,16,Middle,1210,735,1945
21066,26,State - DADRA & NAGAR HAVELI,Total,17,Middle,1044,538,1582
21067,26,State - DADRA & NAGAR HAVELI,Total,18,Middle,1422,445,1867
21068,26,State - DADRA & NAGAR HAVELI,Total,19,Middle,1249,401,1650
21069,26,State - DADRA & NAGAR HAVELI,Total,20-24,Middle,5447,2105,7552
21070,26,State - DADRA & NAGAR HAVELI,Total,25-29,Middle,3621,1866,5487
21071,26,State - DADRA & NAGAR HAVELI,Total,30-34,Middle,2441,1199,3640
21072,26,State - DADRA & NAGAR HAVELI,Total,35-39,Middle,1585,750,2335
21073,26,State - DADRA & NAGAR HAVELI,Total,40-44,Middle,883,401,1284
21074,26,State - DADRA & NAGAR HAVELI,Total,45-49,Middle,574,234,808
21075,26,State - DADRA & NAGAR HAVELI,Total,50-54,Middle,327,134,461
21076,26,State - DADRA & NAGAR HAVELI,Total,55-59,Middle,206,74,280
21077,26,State - DADRA & NAGAR HAVELI,Total,60-64,Middle,113,44,157
21078,26,State - DADRA & NAGAR HAVELI,Total,65-69,Middle,53,25,78
21079,26,State - DADRA & NAGAR HAVELI,Total,70-74,Middle,26,6,32
21080,26,State - DADRA & NAGAR HAVELI,Total,75-79,Middle,9,6,15
21081,26,State - DADRA & NAGAR HAVELI,Total,80+,Middle,23,11,34
21082,26,State - DADRA & NAGAR HAVELI,Total,Age not stated,Middle,9,12,21
21083,26,State - DADRA & NAGAR HAVELI,Rural,All ages,Middle,11513,5455,16968
21084,26,State - DADRA & NAGAR HAVELI,Rural,0-6,Middle,0,0,0
21085,26,State - DADRA & NAGAR HAVELI,Rural,7,Middle,0,0,0
21086,26,State - DADRA & NAGAR HAVELI,Rural,8,Middle,0,0,0
21087,26,State - DADRA & NAGAR HAVELI,Rural,9,Middle,0,0,0
21088,26,State - DADRA & NAGAR HAVELI,Rural,10,Middle,0,0,0
21089,26,State - DADRA & NAGAR HAVELI,Rural,11,Middle,0,0,0
21090,26,State - DADRA & NAGAR HAVELI,Rural,12,Middle,151,108,259
21091,26,State - DADRA & NAGAR HAVELI,Rural,13,Middle,572,408,980
21092,26,State - DADRA & NAGAR HAVELI,Rural,14,Middle,924,671,1595
21093,26,State - DADRA & NAGAR HAVELI,Rural,15,Middle,963,666,1629
21094,26,State - DADRA & NAGAR HAVELI,Rural,16,Middle,744,469,1213
21095,26,State - DADRA & NAGAR HAVELI,Rural,17,Middle,603,308,911
21096,26,State - DADRA & NAGAR HAVELI,Rural,18,Middle,750,277,1027
21097,26,State - DADRA & NAGAR HAVELI,Rural,19,Middle,560,224,784
21098,26,State - DADRA & NAGAR HAVELI,Rural,20-24,Middle,2466,936,3402
21099,26,State - DADRA & NAGAR HAVELI,Rural,25-29,Middle,1458,637,2095
21100,26,State - DADRA & NAGAR HAVELI,Rural,30-34,Middle,977,365,1342
21101,26,State - DADRA & NAGAR HAVELI,Rural,35-39,Middle,591,182,773
21102,26,State - DADRA & NAGAR HAVELI,Rural,40-44,Middle,308,95,403
21103,26,State - DADRA & NAGAR HAVELI,Rural,45-49,Middle,184,46,230
21104,26,State - DADRA & NAGAR HAVELI,Rural,50-54,Middle,116,27,143
21105,26,State - DADRA & NAGAR HAVELI,Rural,55-59,Middle,72,11,83
21106,26,State - DADRA & NAGAR HAVELI,Rural,60-64,Middle,32,7,39
21107,26,State - DADRA & NAGAR HAVELI,Rural,65-69,Middle,19,7,26
21108,26,State - DADRA & NAGAR HAVELI,Rural,70-74,Middle,6,0,6
21109,26,State - DADRA & NAGAR HAVELI,Rural,75-79,Middle,4,0,4
21110,26,State - DADRA & NAGAR HAVELI,Rural,80+,Middle,9,4,13
21111,26,State - DADRA & NAGAR HAVELI,Rural,Age not stated,Middle,4,7,11
21112,26,State - DADRA & NAGAR HAVELI,Urban,All ages,Middle,13406,7011,20417
21113,26,State - DADRA & NAGAR HAVELI,Urban,0-6,Middle,0,0,0
21114,26,State - DADRA & NAGAR HAVELI,Urban,7,Middle,0,0,0
21115,26,State - DADRA & NAGAR HAVELI,Urban,8,Middle,0,0,0
21116,26,State - DADRA & NAGAR HAVELI,Urban,9,Middle,0,0,0
21117,26,State - DADRA & NAGAR HAVELI,Urban,10,Middle,0,0,0
21118,26,State - DADRA & NAGAR HAVELI,Urban,11,Middle,0,0,0
21119,26,State - DADRA & NAGAR HAVELI,Urban,12,Middle,156,114,270
21120,26,State - DADRA & NAGAR HAVELI,Urban,13,Middle,441,372,813
21121,26,State - DADRA & NAGAR HAVELI,Urban,14,Middle,813,664,1477
21122,26,State - DADRA & NAGAR HAVELI,Urban,15,Middle,657,477,1134
21123,26,State - DADRA & NAGAR HAVELI,Urban,16,Middle,466,266,732
21124,26,State - DADRA & NAGAR HAVELI,Urban,17,Middle,441,230,671
21125,26,State - DADRA & NAGAR HAVELI,Urban,18,Middle,672,168,840
21126,26,State - DADRA & NAGAR HAVELI,Urban,19,Middle,689,177,866
21127,26,State - DADRA & NAGAR HAVELI,Urban,20-24,Middle,2981,1169,4150
21128,26,State - DADRA & NAGAR HAVELI,Urban,25-29,Middle,2163,1229,3392
21129,26,State - DADRA & NAGAR HAVELI,Urban,30-34,Middle,1464,834,2298
21130,26,State - DADRA & NAGAR HAVELI,Urban,35-39,Middle,994,568,1562
21131,26,State - DADRA & NAGAR HAVELI,Urban,40-44,Middle,575,306,881
21132,26,State - DADRA & NAGAR HAVELI,Urban,45-49,Middle,390,188,578
21133,26,State - DADRA & NAGAR HAVELI,Urban,50-54,Middle,211,107,318
21134,26,State - DADRA & NAGAR HAVELI,Urban,55-59,Middle,134,63,197
21135,26,State - DADRA & NAGAR HAVELI,Urban,60-64,Middle,81,37,118
21136,26,State - DADRA & NAGAR HAVELI,Urban,65-69,Middle,34,18,52
21137,26,State - DADRA & NAGAR HAVELI,Urban,70-74,Middle,20,6,26
21138,26,State - DADRA & NAGAR HAVELI,Urban,75-79,Middle,5,6,11
21139,26,State - DADRA & NAGAR HAVELI,Urban,80+,Middle,14,7,21
21140,26,State - DADRA & NAGAR HAVELI,Urban,Age not stated,Middle,5,5,10
21141,27,State - MAHARASHTRA,Total,All ages,Middle,7132530,5460199,12592729
21142,27,State - MAHARASHTRA,Total,0-6,Middle,0,0,0
21143,27,State - MAHARASHTRA,Total,7,Middle,0,0,0
21144,27,State - MAHARASHTRA,Total,8,Middle,0,0,0
21145,27,State - MAHARASHTRA,Total,9,Middle,0,0,0
21146,27,State - MAHARASHTRA,Total,10,Middle,0,0,0
21147,27,State - MAHARASHTRA,Total,11,Middle,0,0,0
21148,27,State - MAHARASHTRA,Total,12,Middle,74910,68784,143694
21149,27,State - MAHARASHTRA,Total,13,Middle,258278,250311,508589
21150,27,State - MAHARASHTRA,Total,14,Middle,629944,583252,1213196
21151,27,State - MAHARASHTRA,Total,15,Middle,613358,524356,1137714
21152,27,State - MAHARASHTRA,Total,16,Middle,372968,288447,661415
21153,27,State - MAHARASHTRA,Total,17,Middle,213930,156362,370292
21154,27,State - MAHARASHTRA,Total,18,Middle,213513,155592,369105
21155,27,State - MAHARASHTRA,Total,19,Middle,169270,136694,305964
21156,27,State - MAHARASHTRA,Total,20-24,Middle,966780,786848,1753628
21157,27,State - MAHARASHTRA,Total,25-29,Middle,836932,695424,1532356
21158,27,State - MAHARASHTRA,Total,30-34,Middle,675666,537692,1213358
21159,27,State - MAHARASHTRA,Total,35-39,Middle,573914,425297,999211
21160,27,State - MAHARASHTRA,Total,40-44,Middle,453458,286637,740095
21161,27,State - MAHARASHTRA,Total,45-49,Middle,343584,198825,542409
21162,27,State - MAHARASHTRA,Total,50-54,Middle,259555,128301,387856
21163,27,State - MAHARASHTRA,Total,55-59,Middle,166897,84962,251859
21164,27,State - MAHARASHTRA,Total,60-64,Middle,122276,58889,181165
21165,27,State - MAHARASHTRA,Total,65-69,Middle,82084,35184,117268
21166,27,State - MAHARASHTRA,Total,70-74,Middle,41870,17196,59066
21167,27,State - MAHARASHTRA,Total,75-79,Middle,19264,9984,29248
21168,27,State - MAHARASHTRA,Total,80+,Middle,23652,15947,39599
21169,27,State - MAHARASHTRA,Total,Age not stated,Middle,20427,15215,35642
21170,27,State - MAHARASHTRA,Rural,All ages,Middle,3917698,2910666,6828364
21171,27,State - MAHARASHTRA,Rural,0-6,Middle,0,0,0
21172,27,State - MAHARASHTRA,Rural,7,Middle,0,0,0
21173,27,State - MAHARASHTRA,Rural,8,Middle,0,0,0
21174,27,State - MAHARASHTRA,Rural,9,Middle,0,0,0
21175,27,State - MAHARASHTRA,Rural,10,Middle,0,0,0
21176,27,State - MAHARASHTRA,Rural,11,Middle,0,0,0
21177,27,State - MAHARASHTRA,Rural,12,Middle,32048,27606,59654
21178,27,State - MAHARASHTRA,Rural,13,Middle,119533,111875,231408
21179,27,State - MAHARASHTRA,Rural,14,Middle,337194,305825,643019
21180,27,State - MAHARASHTRA,Rural,15,Middle,367358,313233,680591
21181,27,State - MAHARASHTRA,Rural,16,Middle,238041,185522,423563
21182,27,State - MAHARASHTRA,Rural,17,Middle,129788,96479,226267
21183,27,State - MAHARASHTRA,Rural,18,Middle,123865,94408,218273
21184,27,State - MAHARASHTRA,Rural,19,Middle,98379,84224,182603
21185,27,State - MAHARASHTRA,Rural,20-24,Middle,555337,473174,1028511
21186,27,State - MAHARASHTRA,Rural,25-29,Middle,460546,394269,854815
21187,27,State - MAHARASHTRA,Rural,30-34,Middle,367947,292835,660782
21188,27,State - MAHARASHTRA,Rural,35-39,Middle,310159,211329,521488
21189,27,State - MAHARASHTRA,Rural,40-44,Middle,238524,123311,361835
21190,27,State - MAHARASHTRA,Rural,45-49,Middle,172286,75104,247390
21191,27,State - MAHARASHTRA,Rural,50-54,Middle,128694,45276,173970
21192,27,State - MAHARASHTRA,Rural,55-59,Middle,84876,28442,113318
21193,27,State - MAHARASHTRA,Rural,60-64,Middle,62125,17551,79676
21194,27,State - MAHARASHTRA,Rural,65-69,Middle,43218,10736,53954
21195,27,State - MAHARASHTRA,Rural,70-74,Middle,19357,3959,23316
21196,27,State - MAHARASHTRA,Rural,75-79,Middle,8072,2041,10113
21197,27,State - MAHARASHTRA,Rural,80+,Middle,10406,5899,16305
21198,27,State - MAHARASHTRA,Rural,Age not stated,Middle,9945,7568,17513
21199,27,State - MAHARASHTRA,Urban,All ages,Middle,3214832,2549533,5764365
21200,27,State - MAHARASHTRA,Urban,0-6,Middle,0,0,0
21201,27,State - MAHARASHTRA,Urban,7,Middle,0,0,0
21202,27,State - MAHARASHTRA,Urban,8,Middle,0,0,0
21203,27,State - MAHARASHTRA,Urban,9,Middle,0,0,0
21204,27,State - MAHARASHTRA,Urban,10,Middle,0,0,0
21205,27,State - MAHARASHTRA,Urban,11,Middle,0,0,0
21206,27,State - MAHARASHTRA,Urban,12,Middle,42862,41178,84040
21207,27,State - MAHARASHTRA,Urban,13,Middle,138745,138436,277181
21208,27,State - MAHARASHTRA,Urban,14,Middle,292750,277427,570177
21209,27,State - MAHARASHTRA,Urban,15,Middle,246000,211123,457123
21210,27,State - MAHARASHTRA,Urban,16,Middle,134927,102925,237852
21211,27,State - MAHARASHTRA,Urban,17,Middle,84142,59883,144025
21212,27,State - MAHARASHTRA,Urban,18,Middle,89648,61184,150832
21213,27,State - MAHARASHTRA,Urban,19,Middle,70891,52470,123361
21214,27,State - MAHARASHTRA,Urban,20-24,Middle,411443,313674,725117
21215,27,State - MAHARASHTRA,Urban,25-29,Middle,376386,301155,677541
21216,27,State - MAHARASHTRA,Urban,30-34,Middle,307719,244857,552576
21217,27,State - MAHARASHTRA,Urban,35-39,Middle,263755,213968,477723
21218,27,State - MAHARASHTRA,Urban,40-44,Middle,214934,163326,378260
21219,27,State - MAHARASHTRA,Urban,45-49,Middle,171298,123721,295019
21220,27,State - MAHARASHTRA,Urban,50-54,Middle,130861,83025,213886
21221,27,State - MAHARASHTRA,Urban,55-59,Middle,82021,56520,138541
21222,27,State - MAHARASHTRA,Urban,60-64,Middle,60151,41338,101489
21223,27,State - MAHARASHTRA,Urban,65-69,Middle,38866,24448,63314
21224,27,State - MAHARASHTRA,Urban,70-74,Middle,22513,13237,35750
21225,27,State - MAHARASHTRA,Urban,75-79,Middle,11192,7943,19135
21226,27,State - MAHARASHTRA,Urban,80+,Middle,13246,10048,23294
21227,27,State - MAHARASHTRA,Urban,Age not stated,Middle,10482,7647,18129
21228,28,State - ANDHRA PRADESH,Total,All ages,Middle,3006742,2565412,5572154
21229,28,State - ANDHRA PRADESH,Total,0-6,Middle,0,0,0
21230,28,State - ANDHRA PRADESH,Total,7,Middle,0,0,0
21231,28,State - ANDHRA PRADESH,Total,8,Middle,0,0,0
21232,28,State - ANDHRA PRADESH,Total,9,Middle,0,0,0
21233,28,State - ANDHRA PRADESH,Total,10,Middle,0,0,0
21234,28,State - ANDHRA PRADESH,Total,11,Middle,0,0,0
21235,28,State - ANDHRA PRADESH,Total,12,Middle,120133,130743,250876
21236,28,State - ANDHRA PRADESH,Total,13,Middle,352831,364411,717242
21237,28,State - ANDHRA PRADESH,Total,14,Middle,566965,542815,1109780
21238,28,State - ANDHRA PRADESH,Total,15,Middle,307488,250880,558368
21239,28,State - ANDHRA PRADESH,Total,16,Middle,146599,105948,252547
21240,28,State - ANDHRA PRADESH,Total,17,Middle,77767,53458,131225
21241,28,State - ANDHRA PRADESH,Total,18,Middle,79160,63764,142924
21242,28,State - ANDHRA PRADESH,Total,19,Middle,55365,48336,103701
21243,28,State - ANDHRA PRADESH,Total,20-24,Middle,268060,238830,506890
21244,28,State - ANDHRA PRADESH,Total,25-29,Middle,236972,205628,442600
21245,28,State - ANDHRA PRADESH,Total,30-34,Middle,189918,148288,338206
21246,28,State - ANDHRA PRADESH,Total,35-39,Middle,161552,121556,283108
21247,28,State - ANDHRA PRADESH,Total,40-44,Middle,109935,75269,185204
21248,28,State - ANDHRA PRADESH,Total,45-49,Middle,80726,57499,138225
21249,28,State - ANDHRA PRADESH,Total,50-54,Middle,65677,43253,108930
21250,28,State - ANDHRA PRADESH,Total,55-59,Middle,53077,34178,87255
21251,28,State - ANDHRA PRADESH,Total,60-64,Middle,46991,27599,74590
21252,28,State - ANDHRA PRADESH,Total,65-69,Middle,30658,16081,46739
21253,28,State - ANDHRA PRADESH,Total,70-74,Middle,19083,9216,28299
21254,28,State - ANDHRA PRADESH,Total,75-79,Middle,8722,4626,13348
21255,28,State - ANDHRA PRADESH,Total,80+,Middle,9767,6226,15993
21256,28,State - ANDHRA PRADESH,Total,Age not stated,Middle,19296,16808,36104
21257,28,State - ANDHRA PRADESH,Rural,All ages,Middle,2052920,1618845,3671765
21258,28,State - ANDHRA PRADESH,Rural,0-6,Middle,0,0,0
21259,28,State - ANDHRA PRADESH,Rural,7,Middle,0,0,0
21260,28,State - ANDHRA PRADESH,Rural,8,Middle,0,0,0
21261,28,State - ANDHRA PRADESH,Rural,9,Middle,0,0,0
21262,28,State - ANDHRA PRADESH,Rural,10,Middle,0,0,0
21263,28,State - ANDHRA PRADESH,Rural,11,Middle,0,0,0
21264,28,State - ANDHRA PRADESH,Rural,12,Middle,75221,79423,154644
21265,28,State - ANDHRA PRADESH,Rural,13,Middle,236044,238293,474337
21266,28,State - ANDHRA PRADESH,Rural,14,Middle,382185,357285,739470
21267,28,State - ANDHRA PRADESH,Rural,15,Middle,213419,171788,385207
21268,28,State - ANDHRA PRADESH,Rural,16,Middle,103838,73579,177417
21269,28,State - ANDHRA PRADESH,Rural,17,Middle,55561,37039,92600
21270,28,State - ANDHRA PRADESH,Rural,18,Middle,59550,45899,105449
21271,28,State - ANDHRA PRADESH,Rural,19,Middle,40994,34002,74996
21272,28,State - ANDHRA PRADESH,Rural,20-24,Middle,197023,163591,360614
21273,28,State - ANDHRA PRADESH,Rural,25-29,Middle,169241,132236,301477
21274,28,State - ANDHRA PRADESH,Rural,30-34,Middle,133888,90086,223974
21275,28,State - ANDHRA PRADESH,Rural,35-39,Middle,111760,68196,179956
21276,28,State - ANDHRA PRADESH,Rural,40-44,Middle,71962,37497,109459
21277,28,State - ANDHRA PRADESH,Rural,45-49,Middle,49808,25499,75307
21278,28,State - ANDHRA PRADESH,Rural,50-54,Middle,38680,17763,56443
21279,28,State - ANDHRA PRADESH,Rural,55-59,Middle,31345,13612,44957
21280,28,State - ANDHRA PRADESH,Rural,60-64,Middle,28542,11018,39560
21281,28,State - ANDHRA PRADESH,Rural,65-69,Middle,19503,6180,25683
21282,28,State - ANDHRA PRADESH,Rural,70-74,Middle,12134,3307,15441
21283,28,State - ANDHRA PRADESH,Rural,75-79,Middle,5493,1528,7021
21284,28,State - ANDHRA PRADESH,Rural,80+,Middle,5982,2483,8465
21285,28,State - ANDHRA PRADESH,Rural,Age not stated,Middle,10747,8541,19288
21286,28,State - ANDHRA PRADESH,Urban,All ages,Middle,953822,946567,1900389
21287,28,State - ANDHRA PRADESH,Urban,0-6,Middle,0,0,0
21288,28,State - ANDHRA PRADESH,Urban,7,Middle,0,0,0
21289,28,State - ANDHRA PRADESH,Urban,8,Middle,0,0,0
21290,28,State - ANDHRA PRADESH,Urban,9,Middle,0,0,0
21291,28,State - ANDHRA PRADESH,Urban,10,Middle,0,0,0
21292,28,State - ANDHRA PRADESH,Urban,11,Middle,0,0,0
21293,28,State - ANDHRA PRADESH,Urban,12,Middle,44912,51320,96232
21294,28,State - ANDHRA PRADESH,Urban,13,Middle,116787,126118,242905
21295,28,State - ANDHRA PRADESH,Urban,14,Middle,184780,185530,370310
21296,28,State - ANDHRA PRADESH,Urban,15,Middle,94069,79092,173161
21297,28,State - ANDHRA PRADESH,Urban,16,Middle,42761,32369,75130
21298,28,State - ANDHRA PRADESH,Urban,17,Middle,22206,16419,38625
21299,28,State - ANDHRA PRADESH,Urban,18,Middle,19610,17865,37475
21300,28,State - ANDHRA PRADESH,Urban,19,Middle,14371,14334,28705
21301,28,State - ANDHRA PRADESH,Urban,20-24,Middle,71037,75239,146276
21302,28,State - ANDHRA PRADESH,Urban,25-29,Middle,67731,73392,141123
21303,28,State - ANDHRA PRADESH,Urban,30-34,Middle,56030,58202,114232
21304,28,State - ANDHRA PRADESH,Urban,35-39,Middle,49792,53360,103152
21305,28,State - ANDHRA PRADESH,Urban,40-44,Middle,37973,37772,75745
21306,28,State - ANDHRA PRADESH,Urban,45-49,Middle,30918,32000,62918
21307,28,State - ANDHRA PRADESH,Urban,50-54,Middle,26997,25490,52487
21308,28,State - ANDHRA PRADESH,Urban,55-59,Middle,21732,20566,42298
21309,28,State - ANDHRA PRADESH,Urban,60-64,Middle,18449,16581,35030
21310,28,State - ANDHRA PRADESH,Urban,65-69,Middle,11155,9901,21056
21311,28,State - ANDHRA PRADESH,Urban,70-74,Middle,6949,5909,12858
21312,28,State - ANDHRA PRADESH,Urban,75-79,Middle,3229,3098,6327
21313,28,State - ANDHRA PRADESH,Urban,80+,Middle,3785,3743,7528
21314,28,State - ANDHRA PRADESH,Urban,Age not stated,Middle,8549,8267,16816
21315,29,State - KARNATAKA,Total,All ages,Middle,2869395,2292313,5161708
21316,29,State - KARNATAKA,Total,0-6,Middle,0,0,0
21317,29,State - KARNATAKA,Total,7,Middle,0,0,0
21318,29,State - KARNATAKA,Total,8,Middle,0,0,0
21319,29,State - KARNATAKA,Total,9,Middle,0,0,0
21320,29,State - KARNATAKA,Total,10,Middle,0,0,0
21321,29,State - KARNATAKA,Total,11,Middle,0,0,0
21322,29,State - KARNATAKA,Total,12,Middle,43994,46322,90316
21323,29,State - KARNATAKA,Total,13,Middle,158694,161524,320218
21324,29,State - KARNATAKA,Total,14,Middle,368823,347184,716007
21325,29,State - KARNATAKA,Total,15,Middle,337660,288025,625685
21326,29,State - KARNATAKA,Total,16,Middle,183389,137704,321093
21327,29,State - KARNATAKA,Total,17,Middle,89253,61654,150907
21328,29,State - KARNATAKA,Total,18,Middle,95681,68704,164385
21329,29,State - KARNATAKA,Total,19,Middle,65888,52822,118710
21330,29,State - KARNATAKA,Total,20-24,Middle,341307,270221,611528
21331,29,State - KARNATAKA,Total,25-29,Middle,303732,251315,555047
21332,29,State - KARNATAKA,Total,30-34,Middle,224978,171166,396144
21333,29,State - KARNATAKA,Total,35-39,Middle,183321,141269,324590
21334,29,State - KARNATAKA,Total,40-44,Middle,128521,86506,215027
21335,29,State - KARNATAKA,Total,45-49,Middle,101674,65450,167124
21336,29,State - KARNATAKA,Total,50-54,Middle,70320,43117,113437
21337,29,State - KARNATAKA,Total,55-59,Middle,53219,31952,85171
21338,29,State - KARNATAKA,Total,60-64,Middle,44395,25782,70177
21339,29,State - KARNATAKA,Total,65-69,Middle,31572,17730,49302
21340,29,State - KARNATAKA,Total,70-74,Middle,20523,10082,30605
21341,29,State - KARNATAKA,Total,75-79,Middle,10245,5593,15838
21342,29,State - KARNATAKA,Total,80+,Middle,10556,7046,17602
21343,29,State - KARNATAKA,Total,Age not stated,Middle,1650,1145,2795
21344,29,State - KARNATAKA,Rural,All ages,Middle,1866652,1374449,3241101
21345,29,State - KARNATAKA,Rural,0-6,Middle,0,0,0
21346,29,State - KARNATAKA,Rural,7,Middle,0,0,0
21347,29,State - KARNATAKA,Rural,8,Middle,0,0,0
21348,29,State - KARNATAKA,Rural,9,Middle,0,0,0
21349,29,State - KARNATAKA,Rural,10,Middle,0,0,0
21350,29,State - KARNATAKA,Rural,11,Middle,0,0,0
21351,29,State - KARNATAKA,Rural,12,Middle,23813,23871,47684
21352,29,State - KARNATAKA,Rural,13,Middle,90985,89260,180245
21353,29,State - KARNATAKA,Rural,14,Middle,230275,208289,438564
21354,29,State - KARNATAKA,Rural,15,Middle,228327,189550,417877
21355,29,State - KARNATAKA,Rural,16,Middle,128981,95674,224655
21356,29,State - KARNATAKA,Rural,17,Middle,62117,42476,104593
21357,29,State - KARNATAKA,Rural,18,Middle,68389,47825,116214
21358,29,State - KARNATAKA,Rural,19,Middle,45050,36039,81089
21359,29,State - KARNATAKA,Rural,20-24,Middle,233428,178458,411886
21360,29,State - KARNATAKA,Rural,25-29,Middle,203733,157724,361457
21361,29,State - KARNATAKA,Rural,30-34,Middle,145956,100906,246862
21362,29,State - KARNATAKA,Rural,35-39,Middle,115529,78073,193602
21363,29,State - KARNATAKA,Rural,40-44,Middle,79194,43227,122421
21364,29,State - KARNATAKA,Rural,45-49,Middle,62863,29839,92702
21365,29,State - KARNATAKA,Rural,50-54,Middle,43175,17851,61026
21366,29,State - KARNATAKA,Rural,55-59,Middle,32526,12523,45049
21367,29,State - KARNATAKA,Rural,60-64,Middle,26952,9147,36099
21368,29,State - KARNATAKA,Rural,65-69,Middle,19574,6195,25769
21369,29,State - KARNATAKA,Rural,70-74,Middle,12508,3033,15541
21370,29,State - KARNATAKA,Rural,75-79,Middle,6149,1569,7718
21371,29,State - KARNATAKA,Rural,80+,Middle,5989,2211,8200
21372,29,State - KARNATAKA,Rural,Age not stated,Middle,1139,709,1848
21373,29,State - KARNATAKA,Urban,All ages,Middle,1002743,917864,1920607
21374,29,State - KARNATAKA,Urban,0-6,Middle,0,0,0
21375,29,State - KARNATAKA,Urban,7,Middle,0,0,0
21376,29,State - KARNATAKA,Urban,8,Middle,0,0,0
21377,29,State - KARNATAKA,Urban,9,Middle,0,0,0
21378,29,State - KARNATAKA,Urban,10,Middle,0,0,0
21379,29,State - KARNATAKA,Urban,11,Middle,0,0,0
21380,29,State - KARNATAKA,Urban,12,Middle,20181,22451,42632
21381,29,State - KARNATAKA,Urban,13,Middle,67709,72264,139973
21382,29,State - KARNATAKA,Urban,14,Middle,138548,138895,277443
21383,29,State - KARNATAKA,Urban,15,Middle,109333,98475,207808
21384,29,State - KARNATAKA,Urban,16,Middle,54408,42030,96438
21385,29,State - KARNATAKA,Urban,17,Middle,27136,19178,46314
21386,29,State - KARNATAKA,Urban,18,Middle,27292,20879,48171
21387,29,State - KARNATAKA,Urban,19,Middle,20838,16783,37621
21388,29,State - KARNATAKA,Urban,20-24,Middle,107879,91763,199642
21389,29,State - KARNATAKA,Urban,25-29,Middle,99999,93591,193590
21390,29,State - KARNATAKA,Urban,30-34,Middle,79022,70260,149282
21391,29,State - KARNATAKA,Urban,35-39,Middle,67792,63196,130988
21392,29,State - KARNATAKA,Urban,40-44,Middle,49327,43279,92606
21393,29,State - KARNATAKA,Urban,45-49,Middle,38811,35611,74422
21394,29,State - KARNATAKA,Urban,50-54,Middle,27145,25266,52411
21395,29,State - KARNATAKA,Urban,55-59,Middle,20693,19429,40122
21396,29,State - KARNATAKA,Urban,60-64,Middle,17443,16635,34078
21397,29,State - KARNATAKA,Urban,65-69,Middle,11998,11535,23533
21398,29,State - KARNATAKA,Urban,70-74,Middle,8015,7049,15064
21399,29,State - KARNATAKA,Urban,75-79,Middle,4096,4024,8120
21400,29,State - KARNATAKA,Urban,80+,Middle,4567,4835,9402
21401,29,State - KARNATAKA,Urban,Age not stated,Middle,511,436,947
21402,30,State - GOA,Total,All ages,Middle,91716,74807,166523
21403,30,State - GOA,Total,0-6,Middle,0,0,0
21404,30,State - GOA,Total,7,Middle,0,0,0
21405,30,State - GOA,Total,8,Middle,0,0,0
21406,30,State - GOA,Total,9,Middle,0,0,0
21407,30,State - GOA,Total,10,Middle,0,0,0
21408,30,State - GOA,Total,11,Middle,0,0,0
21409,30,State - GOA,Total,12,Middle,630,610,1240
21410,30,State - GOA,Total,13,Middle,2570,2628,5198
21411,30,State - GOA,Total,14,Middle,6427,6664,13091
21412,30,State - GOA,Total,15,Middle,5409,4885,10294
21413,30,State - GOA,Total,16,Middle,3315,2653,5968
21414,30,State - GOA,Total,17,Middle,2379,1765,4144
21415,30,State - GOA,Total,18,Middle,2143,1541,3684
21416,30,State - GOA,Total,19,Middle,1940,1521,3461
21417,30,State - GOA,Total,20-24,Middle,10139,7705,17844
21418,30,State - GOA,Total,25-29,Middle,10224,8233,18457
21419,30,State - GOA,Total,30-34,Middle,9360,7678,17038
21420,30,State - GOA,Total,35-39,Middle,9195,8319,17514
21421,30,State - GOA,Total,40-44,Middle,8119,6456,14575
21422,30,State - GOA,Total,45-49,Middle,6631,4966,11597
21423,30,State - GOA,Total,50-54,Middle,4829,3264,8093
21424,30,State - GOA,Total,55-59,Middle,3268,2341,5609
21425,30,State - GOA,Total,60-64,Middle,2493,1616,4109
21426,30,State - GOA,Total,65-69,Middle,1247,853,2100
21427,30,State - GOA,Total,70-74,Middle,669,453,1122
21428,30,State - GOA,Total,75-79,Middle,319,276,595
21429,30,State - GOA,Total,80+,Middle,286,319,605
21430,30,State - GOA,Total,Age not stated,Middle,124,61,185
21431,30,State - GOA,Rural,All ages,Middle,40225,32976,73201
21432,30,State - GOA,Rural,0-6,Middle,0,0,0
21433,30,State - GOA,Rural,7,Middle,0,0,0
21434,30,State - GOA,Rural,8,Middle,0,0,0
21435,30,State - GOA,Rural,9,Middle,0,0,0
21436,30,State - GOA,Rural,10,Middle,0,0,0
21437,30,State - GOA,Rural,11,Middle,0,0,0
21438,30,State - GOA,Rural,12,Middle,205,204,409
21439,30,State - GOA,Rural,13,Middle,869,850,1719
21440,30,State - GOA,Rural,14,Middle,2268,2478,4746
21441,30,State - GOA,Rural,15,Middle,1993,1909,3902
21442,30,State - GOA,Rural,16,Middle,1380,1163,2543
21443,30,State - GOA,Rural,17,Middle,1107,852,1959
21444,30,State - GOA,Rural,18,Middle,910,761,1671
21445,30,State - GOA,Rural,19,Middle,863,784,1647
21446,30,State - GOA,Rural,20-24,Middle,4467,3894,8361
21447,30,State - GOA,Rural,25-29,Middle,4909,4193,9102
21448,30,State - GOA,Rural,30-34,Middle,4605,3859,8464
21449,30,State - GOA,Rural,35-39,Middle,4435,3888,8323
21450,30,State - GOA,Rural,40-44,Middle,3865,2805,6670
21451,30,State - GOA,Rural,45-49,Middle,2970,1981,4951
21452,30,State - GOA,Rural,50-54,Middle,2057,1239,3296
21453,30,State - GOA,Rural,55-59,Middle,1349,892,2241
21454,30,State - GOA,Rural,60-64,Middle,979,566,1545
21455,30,State - GOA,Rural,65-69,Middle,479,286,765
21456,30,State - GOA,Rural,70-74,Middle,241,145,386
21457,30,State - GOA,Rural,75-79,Middle,115,85,200
21458,30,State - GOA,Rural,80+,Middle,95,112,207
21459,30,State - GOA,Rural,Age not stated,Middle,64,30,94
21460,30,State - GOA,Urban,All ages,Middle,51491,41831,93322
21461,30,State - GOA,Urban,0-6,Middle,0,0,0
21462,30,State - GOA,Urban,7,Middle,0,0,0
21463,30,State - GOA,Urban,8,Middle,0,0,0
21464,30,State - GOA,Urban,9,Middle,0,0,0
21465,30,State - GOA,Urban,10,Middle,0,0,0
21466,30,State - GOA,Urban,11,Middle,0,0,0
21467,30,State - GOA,Urban,12,Middle,425,406,831
21468,30,State - GOA,Urban,13,Middle,1701,1778,3479
21469,30,State - GOA,Urban,14,Middle,4159,4186,8345
21470,30,State - GOA,Urban,15,Middle,3416,2976,6392
21471,30,State - GOA,Urban,16,Middle,1935,1490,3425
21472,30,State - GOA,Urban,17,Middle,1272,913,2185
21473,30,State - GOA,Urban,18,Middle,1233,780,2013
21474,30,State - GOA,Urban,19,Middle,1077,737,1814
21475,30,State - GOA,Urban,20-24,Middle,5672,3811,9483
21476,30,State - GOA,Urban,25-29,Middle,5315,4040,9355
21477,30,State - GOA,Urban,30-34,Middle,4755,3819,8574
21478,30,State - GOA,Urban,35-39,Middle,4760,4431,9191
21479,30,State - GOA,Urban,40-44,Middle,4254,3651,7905
21480,30,State - GOA,Urban,45-49,Middle,3661,2985,6646
21481,30,State - GOA,Urban,50-54,Middle,2772,2025,4797
21482,30,State - GOA,Urban,55-59,Middle,1919,1449,3368
21483,30,State - GOA,Urban,60-64,Middle,1514,1050,2564
21484,30,State - GOA,Urban,65-69,Middle,768,567,1335
21485,30,State - GOA,Urban,70-74,Middle,428,308,736
21486,30,State - GOA,Urban,75-79,Middle,204,191,395
21487,30,State - GOA,Urban,80+,Middle,191,207,398
21488,30,State - GOA,Urban,Age not stated,Middle,60,31,91
21489,31,State - LAKSHADWEEP,Total,All ages,Middle,5970,5335,11305
21490,31,State - LAKSHADWEEP,Total,0-6,Middle,0,0,0
21491,31,State - LAKSHADWEEP,Total,7,Middle,0,0,0
21492,31,State - LAKSHADWEEP,Total,8,Middle,0,0,0
21493,31,State - LAKSHADWEEP,Total,9,Middle,0,0,0
21494,31,State - LAKSHADWEEP,Total,10,Middle,0,0,0
21495,31,State - LAKSHADWEEP,Total,11,Middle,0,0,0
21496,31,State - LAKSHADWEEP,Total,12,Middle,18,23,41
21497,31,State - LAKSHADWEEP,Total,13,Middle,60,65,125
21498,31,State - LAKSHADWEEP,Total,14,Middle,259,279,538
21499,31,State - LAKSHADWEEP,Total,15,Middle,393,439,832
21500,31,State - LAKSHADWEEP,Total,16,Middle,278,289,567
21501,31,State - LAKSHADWEEP,Total,17,Middle,180,109,289
21502,31,State - LAKSHADWEEP,Total,18,Middle,125,90,215
21503,31,State - LAKSHADWEEP,Total,19,Middle,118,61,179
21504,31,State - LAKSHADWEEP,Total,20-24,Middle,679,592,1271
21505,31,State - LAKSHADWEEP,Total,25-29,Middle,697,912,1609
21506,31,State - LAKSHADWEEP,Total,30-34,Middle,705,847,1552
21507,31,State - LAKSHADWEEP,Total,35-39,Middle,629,586,1215
21508,31,State - LAKSHADWEEP,Total,40-44,Middle,563,478,1041
21509,31,State - LAKSHADWEEP,Total,45-49,Middle,473,315,788
21510,31,State - LAKSHADWEEP,Total,50-54,Middle,307,133,440
21511,31,State - LAKSHADWEEP,Total,55-59,Middle,234,85,319
21512,31,State - LAKSHADWEEP,Total,60-64,Middle,146,18,164
21513,31,State - LAKSHADWEEP,Total,65-69,Middle,76,4,80
21514,31,State - LAKSHADWEEP,Total,70-74,Middle,9,2,11
21515,31,State - LAKSHADWEEP,Total,75-79,Middle,5,1,6
21516,31,State - LAKSHADWEEP,Total,80+,Middle,9,6,15
21517,31,State - LAKSHADWEEP,Total,Age not stated,Middle,7,1,8
21518,31,State - LAKSHADWEEP,Rural,All ages,Middle,1035,1146,2181
21519,31,State - LAKSHADWEEP,Rural,0-6,Middle,0,0,0
21520,31,State - LAKSHADWEEP,Rural,7,Middle,0,0,0
21521,31,State - LAKSHADWEEP,Rural,8,Middle,0,0,0
21522,31,State - LAKSHADWEEP,Rural,9,Middle,0,0,0
21523,31,State - LAKSHADWEEP,Rural,10,Middle,0,0,0
21524,31,State - LAKSHADWEEP,Rural,11,Middle,0,0,0
21525,31,State - LAKSHADWEEP,Rural,12,Middle,7,16,23
21526,31,State - LAKSHADWEEP,Rural,13,Middle,9,20,29
21527,31,State - LAKSHADWEEP,Rural,14,Middle,43,54,97
21528,31,State - LAKSHADWEEP,Rural,15,Middle,59,98,157
21529,31,State - LAKSHADWEEP,Rural,16,Middle,46,65,111
21530,31,State - LAKSHADWEEP,Rural,17,Middle,34,32,66
21531,31,State - LAKSHADWEEP,Rural,18,Middle,23,28,51
21532,31,State - LAKSHADWEEP,Rural,19,Middle,24,20,44
21533,31,State - LAKSHADWEEP,Rural,20-24,Middle,141,122,263
21534,31,State - LAKSHADWEEP,Rural,25-29,Middle,101,186,287
21535,31,State - LAKSHADWEEP,Rural,30-34,Middle,143,191,334
21536,31,State - LAKSHADWEEP,Rural,35-39,Middle,108,112,220
21537,31,State - LAKSHADWEEP,Rural,40-44,Middle,75,87,162
21538,31,State - LAKSHADWEEP,Rural,45-49,Middle,86,60,146
21539,31,State - LAKSHADWEEP,Rural,50-54,Middle,54,27,81
21540,31,State - LAKSHADWEEP,Rural,55-59,Middle,38,17,55
21541,31,State - LAKSHADWEEP,Rural,60-64,Middle,24,5,29
21542,31,State - LAKSHADWEEP,Rural,65-69,Middle,12,0,12
21543,31,State - LAKSHADWEEP,Rural,70-74,Middle,1,1,2
21544,31,State - LAKSHADWEEP,Rural,75-79,Middle,1,1,2
21545,31,State - LAKSHADWEEP,Rural,80+,Middle,2,4,6
21546,31,State - LAKSHADWEEP,Rural,Age not stated,Middle,4,0,4
21547,31,State - LAKSHADWEEP,Urban,All ages,Middle,4935,4189,9124
21548,31,State - LAKSHADWEEP,Urban,0-6,Middle,0,0,0
21549,31,State - LAKSHADWEEP,Urban,7,Middle,0,0,0
21550,31,State - LAKSHADWEEP,Urban,8,Middle,0,0,0
21551,31,State - LAKSHADWEEP,Urban,9,Middle,0,0,0
21552,31,State - LAKSHADWEEP,Urban,10,Middle,0,0,0
21553,31,State - LAKSHADWEEP,Urban,11,Middle,0,0,0
21554,31,State - LAKSHADWEEP,Urban,12,Middle,11,7,18
21555,31,State - LAKSHADWEEP,Urban,13,Middle,51,45,96
21556,31,State - LAKSHADWEEP,Urban,14,Middle,216,225,441
21557,31,State - LAKSHADWEEP,Urban,15,Middle,334,341,675
21558,31,State - LAKSHADWEEP,Urban,16,Middle,232,224,456
21559,31,State - LAKSHADWEEP,Urban,17,Middle,146,77,223
21560,31,State - LAKSHADWEEP,Urban,18,Middle,102,62,164
21561,31,State - LAKSHADWEEP,Urban,19,Middle,94,41,135
21562,31,State - LAKSHADWEEP,Urban,20-24,Middle,538,470,1008
21563,31,State - LAKSHADWEEP,Urban,25-29,Middle,596,726,1322
21564,31,State - LAKSHADWEEP,Urban,30-34,Middle,562,656,1218
21565,31,State - LAKSHADWEEP,Urban,35-39,Middle,521,474,995
21566,31,State - LAKSHADWEEP,Urban,40-44,Middle,488,391,879
21567,31,State - LAKSHADWEEP,Urban,45-49,Middle,387,255,642
21568,31,State - LAKSHADWEEP,Urban,50-54,Middle,253,106,359
21569,31,State - LAKSHADWEEP,Urban,55-59,Middle,196,68,264
21570,31,State - LAKSHADWEEP,Urban,60-64,Middle,122,13,135
21571,31,State - LAKSHADWEEP,Urban,65-69,Middle,64,4,68
21572,31,State - LAKSHADWEEP,Urban,70-74,Middle,8,1,9
21573,31,State - LAKSHADWEEP,Urban,75-79,Middle,4,0,4
21574,31,State - LAKSHADWEEP,Urban,80+,Middle,7,2,9
21575,31,State - LAKSHADWEEP,Urban,Age not stated,Middle,3,1,4
21576,32,State - KERALA,Total,All ages,Middle,2590783,2469026,5059809
21577,32,State - KERALA,Total,0-6,Middle,0,0,0
21578,32,State - KERALA,Total,7,Middle,0,0,0
21579,32,State - KERALA,Total,8,Middle,0,0,0
21580,32,State - KERALA,Total,9,Middle,0,0,0
21581,32,State - KERALA,Total,10,Middle,0,0,0
21582,32,State - KERALA,Total,11,Middle,0,0,0
21583,32,State - KERALA,Total,12,Middle,18057,20054,38111
21584,32,State - KERALA,Total,13,Middle,86458,98271,184729
21585,32,State - KERALA,Total,14,Middle,204560,215750,420310
21586,32,State - KERALA,Total,15,Middle,179407,165128,344535
21587,32,State - KERALA,Total,16,Middle,76314,50144,126458
21588,32,State - KERALA,Total,17,Middle,32002,15873,47875
21589,32,State - KERALA,Total,18,Middle,22456,12448,34904
21590,32,State - KERALA,Total,19,Middle,20454,12909,33363
21591,32,State - KERALA,Total,20-24,Middle,175751,143912,319663
21592,32,State - KERALA,Total,25-29,Middle,278316,267657,545973
21593,32,State - KERALA,Total,30-34,Middle,274859,279076,553935
21594,32,State - KERALA,Total,35-39,Middle,258251,288782,547033
21595,32,State - KERALA,Total,40-44,Middle,245761,248681,494442
21596,32,State - KERALA,Total,45-49,Middle,212390,202596,414986
21597,32,State - KERALA,Total,50-54,Middle,161799,152449,314248
21598,32,State - KERALA,Total,55-59,Middle,136946,119331,256277
21599,32,State - KERALA,Total,60-64,Middle,93285,78954,172239
21600,32,State - KERALA,Total,65-69,Middle,54001,43710,97711
21601,32,State - KERALA,Total,70-74,Middle,31424,26084,57508
21602,32,State - KERALA,Total,75-79,Middle,15147,13745,28892
21603,32,State - KERALA,Total,80+,Middle,11378,11856,23234
21604,32,State - KERALA,Total,Age not stated,Middle,1767,1616,3383
21605,32,State - KERALA,Rural,All ages,Middle,1391467,1318425,2709892
21606,32,State - KERALA,Rural,0-6,Middle,0,0,0
21607,32,State - KERALA,Rural,7,Middle,0,0,0
21608,32,State - KERALA,Rural,8,Middle,0,0,0
21609,32,State - KERALA,Rural,9,Middle,0,0,0
21610,32,State - KERALA,Rural,10,Middle,0,0,0
21611,32,State - KERALA,Rural,11,Middle,0,0,0
21612,32,State - KERALA,Rural,12,Middle,9689,10514,20203
21613,32,State - KERALA,Rural,13,Middle,44947,51570,96517
21614,32,State - KERALA,Rural,14,Middle,106911,113520,220431
21615,32,State - KERALA,Rural,15,Middle,94491,87382,181873
21616,32,State - KERALA,Rural,16,Middle,41474,27516,68990
21617,32,State - KERALA,Rural,17,Middle,17898,9323,27221
21618,32,State - KERALA,Rural,18,Middle,12991,7655,20646
21619,32,State - KERALA,Rural,19,Middle,11961,7926,19887
21620,32,State - KERALA,Rural,20-24,Middle,101815,84572,186387
21621,32,State - KERALA,Rural,25-29,Middle,156995,150335,307330
21622,32,State - KERALA,Rural,30-34,Middle,149834,150622,300456
21623,32,State - KERALA,Rural,35-39,Middle,138164,153398,291562
21624,32,State - KERALA,Rural,40-44,Middle,128786,130029,258815
21625,32,State - KERALA,Rural,45-49,Middle,110841,106352,217193
21626,32,State - KERALA,Rural,50-54,Middle,85210,79264,164474
21627,32,State - KERALA,Rural,55-59,Middle,71975,61861,133836
21628,32,State - KERALA,Rural,60-64,Middle,48264,39976,88240
21629,32,State - KERALA,Rural,65-69,Middle,28531,22316,50847
21630,32,State - KERALA,Rural,70-74,Middle,16422,12773,29195
21631,32,State - KERALA,Rural,75-79,Middle,7842,5986,13828
21632,32,State - KERALA,Rural,80+,Middle,5523,4693,10216
21633,32,State - KERALA,Rural,Age not stated,Middle,903,842,1745
21634,32,State - KERALA,Urban,All ages,Middle,1199316,1150601,2349917
21635,32,State - KERALA,Urban,0-6,Middle,0,0,0
21636,32,State - KERALA,Urban,7,Middle,0,0,0
21637,32,State - KERALA,Urban,8,Middle,0,0,0
21638,32,State - KERALA,Urban,9,Middle,0,0,0
21639,32,State - KERALA,Urban,10,Middle,0,0,0
21640,32,State - KERALA,Urban,11,Middle,0,0,0
21641,32,State - KERALA,Urban,12,Middle,8368,9540,17908
21642,32,State - KERALA,Urban,13,Middle,41511,46701,88212
21643,32,State - KERALA,Urban,14,Middle,97649,102230,199879
21644,32,State - KERALA,Urban,15,Middle,84916,77746,162662
21645,32,State - KERALA,Urban,16,Middle,34840,22628,57468
21646,32,State - KERALA,Urban,17,Middle,14104,6550,20654
21647,32,State - KERALA,Urban,18,Middle,9465,4793,14258
21648,32,State - KERALA,Urban,19,Middle,8493,4983,13476
21649,32,State - KERALA,Urban,20-24,Middle,73936,59340,133276
21650,32,State - KERALA,Urban,25-29,Middle,121321,117322,238643
21651,32,State - KERALA,Urban,30-34,Middle,125025,128454,253479
21652,32,State - KERALA,Urban,35-39,Middle,120087,135384,255471
21653,32,State - KERALA,Urban,40-44,Middle,116975,118652,235627
21654,32,State - KERALA,Urban,45-49,Middle,101549,96244,197793
21655,32,State - KERALA,Urban,50-54,Middle,76589,73185,149774
21656,32,State - KERALA,Urban,55-59,Middle,64971,57470,122441
21657,32,State - KERALA,Urban,60-64,Middle,45021,38978,83999
21658,32,State - KERALA,Urban,65-69,Middle,25470,21394,46864
21659,32,State - KERALA,Urban,70-74,Middle,15002,13311,28313
21660,32,State - KERALA,Urban,75-79,Middle,7305,7759,15064
21661,32,State - KERALA,Urban,80+,Middle,5855,7163,13018
21662,32,State - KERALA,Urban,Age not stated,Middle,864,774,1638
21663,33,State - TAMIL NADU,Total,All ages,Middle,5087592,4520412,9608004
21664,33,State - TAMIL NADU,Total,0-6,Middle,0,0,0
21665,33,State - TAMIL NADU,Total,7,Middle,0,0,0
21666,33,State - TAMIL NADU,Total,8,Middle,0,0,0
21667,33,State - TAMIL NADU,Total,9,Middle,0,0,0
21668,33,State - TAMIL NADU,Total,10,Middle,0,0,0
21669,33,State - TAMIL NADU,Total,11,Middle,0,0,0
21670,33,State - TAMIL NADU,Total,12,Middle,124419,130916,255335
21671,33,State - TAMIL NADU,Total,13,Middle,361791,367735,729526
21672,33,State - TAMIL NADU,Total,14,Middle,527311,505410,1032721
21673,33,State - TAMIL NADU,Total,15,Middle,278665,227454,506119
21674,33,State - TAMIL NADU,Total,16,Middle,128499,92923,221422
21675,33,State - TAMIL NADU,Total,17,Middle,92338,66136,158474
21676,33,State - TAMIL NADU,Total,18,Middle,96385,79344,175729
21677,33,State - TAMIL NADU,Total,19,Middle,88994,81488,170482
21678,33,State - TAMIL NADU,Total,20-24,Middle,473549,498877,972426
21679,33,State - TAMIL NADU,Total,25-29,Middle,539758,589761,1129519
21680,33,State - TAMIL NADU,Total,30-34,Middle,485708,461328,947036
21681,33,State - TAMIL NADU,Total,35-39,Middle,435351,388265,823616
21682,33,State - TAMIL NADU,Total,40-44,Middle,366461,283333,649794
21683,33,State - TAMIL NADU,Total,45-49,Middle,328221,239530,567751
21684,33,State - TAMIL NADU,Total,50-54,Middle,243970,172936,416906
21685,33,State - TAMIL NADU,Total,55-59,Middle,183329,124247,307576
21686,33,State - TAMIL NADU,Total,60-64,Middle,134255,87378,221633
21687,33,State - TAMIL NADU,Total,65-69,Middle,81889,51901,133790
21688,33,State - TAMIL NADU,Total,70-74,Middle,58577,33708,92285
21689,33,State - TAMIL NADU,Total,75-79,Middle,28745,18065,46810
21690,33,State - TAMIL NADU,Total,80+,Middle,26501,17064,43565
21691,33,State - TAMIL NADU,Total,Age not stated,Middle,2876,2613,5489
21692,33,State - TAMIL NADU,Rural,All ages,Middle,2754507,2266136,5020643
21693,33,State - TAMIL NADU,Rural,0-6,Middle,0,0,0
21694,33,State - TAMIL NADU,Rural,7,Middle,0,0,0
21695,33,State - TAMIL NADU,Rural,8,Middle,0,0,0
21696,33,State - TAMIL NADU,Rural,9,Middle,0,0,0
21697,33,State - TAMIL NADU,Rural,10,Middle,0,0,0
21698,33,State - TAMIL NADU,Rural,11,Middle,0,0,0
21699,33,State - TAMIL NADU,Rural,12,Middle,67857,70155,138012
21700,33,State - TAMIL NADU,Rural,13,Middle,197679,197245,394924
21701,33,State - TAMIL NADU,Rural,14,Middle,284826,267364,552190
21702,33,State - TAMIL NADU,Rural,15,Middle,155852,125110,280962
21703,33,State - TAMIL NADU,Rural,16,Middle,76438,55971,132409
21704,33,State - TAMIL NADU,Rural,17,Middle,57670,41834,99504
21705,33,State - TAMIL NADU,Rural,18,Middle,61671,51115,112786
21706,33,State - TAMIL NADU,Rural,19,Middle,56707,51868,108575
21707,33,State - TAMIL NADU,Rural,20-24,Middle,291915,301836,593751
21708,33,State - TAMIL NADU,Rural,25-29,Middle,316691,331685,648376
21709,33,State - TAMIL NADU,Rural,30-34,Middle,269484,235411,504895
21710,33,State - TAMIL NADU,Rural,35-39,Middle,227930,176823,404753
21711,33,State - TAMIL NADU,Rural,40-44,Middle,179276,111590,290866
21712,33,State - TAMIL NADU,Rural,45-49,Middle,158188,89783,247971
21713,33,State - TAMIL NADU,Rural,50-54,Middle,115810,61119,176929
21714,33,State - TAMIL NADU,Rural,55-59,Middle,86893,42142,129035
21715,33,State - TAMIL NADU,Rural,60-64,Middle,62391,25494,87885
21716,33,State - TAMIL NADU,Rural,65-69,Middle,37107,13700,50807
21717,33,State - TAMIL NADU,Rural,70-74,Middle,25786,7599,33385
21718,33,State - TAMIL NADU,Rural,75-79,Middle,11949,3445,15394
21719,33,State - TAMIL NADU,Rural,80+,Middle,10745,3417,14162
21720,33,State - TAMIL NADU,Rural,Age not stated,Middle,1642,1430,3072
21721,33,State - TAMIL NADU,Urban,All ages,Middle,2333085,2254276,4587361
21722,33,State - TAMIL NADU,Urban,0-6,Middle,0,0,0
21723,33,State - TAMIL NADU,Urban,7,Middle,0,0,0
21724,33,State - TAMIL NADU,Urban,8,Middle,0,0,0
21725,33,State - TAMIL NADU,Urban,9,Middle,0,0,0
21726,33,State - TAMIL NADU,Urban,10,Middle,0,0,0
21727,33,State - TAMIL NADU,Urban,11,Middle,0,0,0
21728,33,State - TAMIL NADU,Urban,12,Middle,56562,60761,117323
21729,33,State - TAMIL NADU,Urban,13,Middle,164112,170490,334602
21730,33,State - TAMIL NADU,Urban,14,Middle,242485,238046,480531
21731,33,State - TAMIL NADU,Urban,15,Middle,122813,102344,225157
21732,33,State - TAMIL NADU,Urban,16,Middle,52061,36952,89013
21733,33,State - TAMIL NADU,Urban,17,Middle,34668,24302,58970
21734,33,State - TAMIL NADU,Urban,18,Middle,34714,28229,62943
21735,33,State - TAMIL NADU,Urban,19,Middle,32287,29620,61907
21736,33,State - TAMIL NADU,Urban,20-24,Middle,181634,197041,378675
21737,33,State - TAMIL NADU,Urban,25-29,Middle,223067,258076,481143
21738,33,State - TAMIL NADU,Urban,30-34,Middle,216224,225917,442141
21739,33,State - TAMIL NADU,Urban,35-39,Middle,207421,211442,418863
21740,33,State - TAMIL NADU,Urban,40-44,Middle,187185,171743,358928
21741,33,State - TAMIL NADU,Urban,45-49,Middle,170033,149747,319780
21742,33,State - TAMIL NADU,Urban,50-54,Middle,128160,111817,239977
21743,33,State - TAMIL NADU,Urban,55-59,Middle,96436,82105,178541
21744,33,State - TAMIL NADU,Urban,60-64,Middle,71864,61884,133748
21745,33,State - TAMIL NADU,Urban,65-69,Middle,44782,38201,82983
21746,33,State - TAMIL NADU,Urban,70-74,Middle,32791,26109,58900
21747,33,State - TAMIL NADU,Urban,75-79,Middle,16796,14620,31416
21748,33,State - TAMIL NADU,Urban,80+,Middle,15756,13647,29403
21749,33,State - TAMIL NADU,Urban,Age not stated,Middle,1234,1183,2417
21750,34,State - PUDUCHERRY,Total,All ages,Middle,85255,86046,171301
21751,34,State - PUDUCHERRY,Total,0-6,Middle,0,0,0
21752,34,State - PUDUCHERRY,Total,7,Middle,0,0,0
21753,34,State - PUDUCHERRY,Total,8,Middle,0,0,0
21754,34,State - PUDUCHERRY,Total,9,Middle,0,0,0
21755,34,State - PUDUCHERRY,Total,10,Middle,0,0,0
21756,34,State - PUDUCHERRY,Total,11,Middle,0,0,0
21757,34,State - PUDUCHERRY,Total,12,Middle,1392,1493,2885
21758,34,State - PUDUCHERRY,Total,13,Middle,5077,5247,10324
21759,34,State - PUDUCHERRY,Total,14,Middle,8573,8610,17183
21760,34,State - PUDUCHERRY,Total,15,Middle,5630,4894,10524
21761,34,State - PUDUCHERRY,Total,16,Middle,2353,1635,3988
21762,34,State - PUDUCHERRY,Total,17,Middle,1307,958,2265
21763,34,State - PUDUCHERRY,Total,18,Middle,1261,1047,2308
21764,34,State - PUDUCHERRY,Total,19,Middle,1066,1008,2074
21765,34,State - PUDUCHERRY,Total,20-24,Middle,5875,7011,12886
21766,34,State - PUDUCHERRY,Total,25-29,Middle,8461,10747,19208
21767,34,State - PUDUCHERRY,Total,30-34,Middle,8382,9859,18241
21768,34,State - PUDUCHERRY,Total,35-39,Middle,8295,8830,17125
21769,34,State - PUDUCHERRY,Total,40-44,Middle,7175,6688,13863
21770,34,State - PUDUCHERRY,Total,45-49,Middle,6247,5342,11589
21771,34,State - PUDUCHERRY,Total,50-54,Middle,4644,4223,8867
21772,34,State - PUDUCHERRY,Total,55-59,Middle,3277,3126,6403
21773,34,State - PUDUCHERRY,Total,60-64,Middle,2449,2290,4739
21774,34,State - PUDUCHERRY,Total,65-69,Middle,1414,1255,2669
21775,34,State - PUDUCHERRY,Total,70-74,Middle,1144,850,1994
21776,34,State - PUDUCHERRY,Total,75-79,Middle,570,456,1026
21777,34,State - PUDUCHERRY,Total,80+,Middle,601,425,1026
21778,34,State - PUDUCHERRY,Total,Age not stated,Middle,62,52,114
21779,34,State - PUDUCHERRY,Rural,All ages,Middle,29986,28296,58282
21780,34,State - PUDUCHERRY,Rural,0-6,Middle,0,0,0
21781,34,State - PUDUCHERRY,Rural,7,Middle,0,0,0
21782,34,State - PUDUCHERRY,Rural,8,Middle,0,0,0
21783,34,State - PUDUCHERRY,Rural,9,Middle,0,0,0
21784,34,State - PUDUCHERRY,Rural,10,Middle,0,0,0
21785,34,State - PUDUCHERRY,Rural,11,Middle,0,0,0
21786,34,State - PUDUCHERRY,Rural,12,Middle,540,552,1092
21787,34,State - PUDUCHERRY,Rural,13,Middle,1757,1853,3610
21788,34,State - PUDUCHERRY,Rural,14,Middle,2863,2826,5689
21789,34,State - PUDUCHERRY,Rural,15,Middle,1794,1596,3390
21790,34,State - PUDUCHERRY,Rural,16,Middle,878,585,1463
21791,34,State - PUDUCHERRY,Rural,17,Middle,549,373,922
21792,34,State - PUDUCHERRY,Rural,18,Middle,518,480,998
21793,34,State - PUDUCHERRY,Rural,19,Middle,458,418,876
21794,34,State - PUDUCHERRY,Rural,20-24,Middle,2409,3118,5527
21795,34,State - PUDUCHERRY,Rural,25-29,Middle,3426,4529,7955
21796,34,State - PUDUCHERRY,Rural,30-34,Middle,3204,3637,6841
21797,34,State - PUDUCHERRY,Rural,35-39,Middle,2981,2971,5952
21798,34,State - PUDUCHERRY,Rural,40-44,Middle,2460,1806,4266
21799,34,State - PUDUCHERRY,Rural,45-49,Middle,2068,1297,3365
21800,34,State - PUDUCHERRY,Rural,50-54,Middle,1451,879,2330
21801,34,State - PUDUCHERRY,Rural,55-59,Middle,984,605,1589
21802,34,State - PUDUCHERRY,Rural,60-64,Middle,709,368,1077
21803,34,State - PUDUCHERRY,Rural,65-69,Middle,375,175,550
21804,34,State - PUDUCHERRY,Rural,70-74,Middle,275,106,381
21805,34,State - PUDUCHERRY,Rural,75-79,Middle,113,52,165
21806,34,State - PUDUCHERRY,Rural,80+,Middle,146,48,194
21807,34,State - PUDUCHERRY,Rural,Age not stated,Middle,28,22,50
21808,34,State - PUDUCHERRY,Urban,All ages,Middle,55269,57750,113019
21809,34,State - PUDUCHERRY,Urban,0-6,Middle,0,0,0
21810,34,State - PUDUCHERRY,Urban,7,Middle,0,0,0
21811,34,State - PUDUCHERRY,Urban,8,Middle,0,0,0
21812,34,State - PUDUCHERRY,Urban,9,Middle,0,0,0
21813,34,State - PUDUCHERRY,Urban,10,Middle,0,0,0
21814,34,State - PUDUCHERRY,Urban,11,Middle,0,0,0
21815,34,State - PUDUCHERRY,Urban,12,Middle,852,941,1793
21816,34,State - PUDUCHERRY,Urban,13,Middle,3320,3394,6714
21817,34,State - PUDUCHERRY,Urban,14,Middle,5710,5784,11494
21818,34,State - PUDUCHERRY,Urban,15,Middle,3836,3298,7134
21819,34,State - PUDUCHERRY,Urban,16,Middle,1475,1050,2525
21820,34,State - PUDUCHERRY,Urban,17,Middle,758,585,1343
21821,34,State - PUDUCHERRY,Urban,18,Middle,743,567,1310
21822,34,State - PUDUCHERRY,Urban,19,Middle,608,590,1198
21823,34,State - PUDUCHERRY,Urban,20-24,Middle,3466,3893,7359
21824,34,State - PUDUCHERRY,Urban,25-29,Middle,5035,6218,11253
21825,34,State - PUDUCHERRY,Urban,30-34,Middle,5178,6222,11400
21826,34,State - PUDUCHERRY,Urban,35-39,Middle,5314,5859,11173
21827,34,State - PUDUCHERRY,Urban,40-44,Middle,4715,4882,9597
21828,34,State - PUDUCHERRY,Urban,45-49,Middle,4179,4045,8224
21829,34,State - PUDUCHERRY,Urban,50-54,Middle,3193,3344,6537
21830,34,State - PUDUCHERRY,Urban,55-59,Middle,2293,2521,4814
21831,34,State - PUDUCHERRY,Urban,60-64,Middle,1740,1922,3662
21832,34,State - PUDUCHERRY,Urban,65-69,Middle,1039,1080,2119
21833,34,State - PUDUCHERRY,Urban,70-74,Middle,869,744,1613
21834,34,State - PUDUCHERRY,Urban,75-79,Middle,457,404,861
21835,34,State - PUDUCHERRY,Urban,80+,Middle,455,377,832
21836,34,State - PUDUCHERRY,Urban,Age not stated,Middle,34,30,64
21837,35,State - ANDAMAN & NICOBAR ISLANDS,Total,All ages,Middle,39337,29283,68620
21838,35,State - ANDAMAN & NICOBAR ISLANDS,Total,0-6,Middle,0,0,0
21839,35,State - ANDAMAN & NICOBAR ISLANDS,Total,7,Middle,0,0,0
21840,35,State - ANDAMAN & NICOBAR ISLANDS,Total,8,Middle,0,0,0
21841,35,State - ANDAMAN & NICOBAR ISLANDS,Total,9,Middle,0,0,0
21842,35,State - ANDAMAN & NICOBAR ISLANDS,Total,10,Middle,0,0,0
21843,35,State - ANDAMAN & NICOBAR ISLANDS,Total,11,Middle,0,0,0
21844,35,State - ANDAMAN & NICOBAR ISLANDS,Total,12,Middle,303,266,569
21845,35,State - ANDAMAN & NICOBAR ISLANDS,Total,13,Middle,986,1031,2017
21846,35,State - ANDAMAN & NICOBAR ISLANDS,Total,14,Middle,2071,2071,4142
21847,35,State - ANDAMAN & NICOBAR ISLANDS,Total,15,Middle,1995,1859,3854
21848,35,State - ANDAMAN & NICOBAR ISLANDS,Total,16,Middle,1434,1115,2549
21849,35,State - ANDAMAN & NICOBAR ISLANDS,Total,17,Middle,1062,736,1798
21850,35,State - ANDAMAN & NICOBAR ISLANDS,Total,18,Middle,903,723,1626
21851,35,State - ANDAMAN & NICOBAR ISLANDS,Total,19,Middle,785,641,1426
21852,35,State - ANDAMAN & NICOBAR ISLANDS,Total,20-24,Middle,4642,3864,8506
21853,35,State - ANDAMAN & NICOBAR ISLANDS,Total,25-29,Middle,5706,4791,10497
21854,35,State - ANDAMAN & NICOBAR ISLANDS,Total,30-34,Middle,5210,4045,9255
21855,35,State - ANDAMAN & NICOBAR ISLANDS,Total,35-39,Middle,4264,3269,7533
21856,35,State - ANDAMAN & NICOBAR ISLANDS,Total,40-44,Middle,3038,1804,4842
21857,35,State - ANDAMAN & NICOBAR ISLANDS,Total,45-49,Middle,2429,1242,3671
21858,35,State - ANDAMAN & NICOBAR ISLANDS,Total,50-54,Middle,1686,834,2520
21859,35,State - ANDAMAN & NICOBAR ISLANDS,Total,55-59,Middle,1193,469,1662
21860,35,State - ANDAMAN & NICOBAR ISLANDS,Total,60-64,Middle,727,255,982
21861,35,State - ANDAMAN & NICOBAR ISLANDS,Total,65-69,Middle,355,124,479
21862,35,State - ANDAMAN & NICOBAR ISLANDS,Total,70-74,Middle,246,48,294
21863,35,State - ANDAMAN & NICOBAR ISLANDS,Total,75-79,Middle,140,35,175
21864,35,State - ANDAMAN & NICOBAR ISLANDS,Total,80+,Middle,133,38,171
21865,35,State - ANDAMAN & NICOBAR ISLANDS,Total,Age not stated,Middle,29,23,52
21866,35,State - ANDAMAN & NICOBAR ISLANDS,Rural,All ages,Middle,25476,19140,44616
21867,35,State - ANDAMAN & NICOBAR ISLANDS,Rural,0-6,Middle,0,0,0
21868,35,State - ANDAMAN & NICOBAR ISLANDS,Rural,7,Middle,0,0,0
21869,35,State - ANDAMAN & NICOBAR ISLANDS,Rural,8,Middle,0,0,0
21870,35,State - ANDAMAN & NICOBAR ISLANDS,Rural,9,Middle,0,0,0
21871,35,State - ANDAMAN & NICOBAR ISLANDS,Rural,10,Middle,0,0,0
21872,35,State - ANDAMAN & NICOBAR ISLANDS,Rural,11,Middle,0,0,0
21873,35,State - ANDAMAN & NICOBAR ISLANDS,Rural,12,Middle,175,133,308
21874,35,State - ANDAMAN & NICOBAR ISLANDS,Rural,13,Middle,578,653,1231
21875,35,State - ANDAMAN & NICOBAR ISLANDS,Rural,14,Middle,1269,1258,2527
21876,35,State - ANDAMAN & NICOBAR ISLANDS,Rural,15,Middle,1234,1138,2372
21877,35,State - ANDAMAN & NICOBAR ISLANDS,Rural,16,Middle,923,741,1664
21878,35,State - ANDAMAN & NICOBAR ISLANDS,Rural,17,Middle,702,519,1221
21879,35,State - ANDAMAN & NICOBAR ISLANDS,Rural,18,Middle,617,523,1140
21880,35,State - ANDAMAN & NICOBAR ISLANDS,Rural,19,Middle,535,467,1002
21881,35,State - ANDAMAN & NICOBAR ISLANDS,Rural,20-24,Middle,3044,2714,5758
21882,35,State - ANDAMAN & NICOBAR ISLANDS,Rural,25-29,Middle,3823,3220,7043
21883,35,State - ANDAMAN & NICOBAR ISLANDS,Rural,30-34,Middle,3505,2757,6262
21884,35,State - ANDAMAN & NICOBAR ISLANDS,Rural,35-39,Middle,2784,2160,4944
21885,35,State - ANDAMAN & NICOBAR ISLANDS,Rural,40-44,Middle,1961,1094,3055
21886,35,State - ANDAMAN & NICOBAR ISLANDS,Rural,45-49,Middle,1505,765,2270
21887,35,State - ANDAMAN & NICOBAR ISLANDS,Rural,50-54,Middle,1056,470,1526
21888,35,State - ANDAMAN & NICOBAR ISLANDS,Rural,55-59,Middle,745,275,1020
21889,35,State - ANDAMAN & NICOBAR ISLANDS,Rural,60-64,Middle,442,140,582
21890,35,State - ANDAMAN & NICOBAR ISLANDS,Rural,65-69,Middle,232,61,293
21891,35,State - ANDAMAN & NICOBAR ISLANDS,Rural,70-74,Middle,153,20,173
21892,35,State - ANDAMAN & NICOBAR ISLANDS,Rural,75-79,Middle,92,9,101
21893,35,State - ANDAMAN & NICOBAR ISLANDS,Rural,80+,Middle,87,16,103
21894,35,State - ANDAMAN & NICOBAR ISLANDS,Rural,Age not stated,Middle,14,7,21
21895,35,State - ANDAMAN & NICOBAR ISLANDS,Urban,All ages,Middle,13861,10143,24004
21896,35,State - ANDAMAN & NICOBAR ISLANDS,Urban,0-6,Middle,0,0,0
21897,35,State - ANDAMAN & NICOBAR ISLANDS,Urban,7,Middle,0,0,0
21898,35,State - ANDAMAN & NICOBAR ISLANDS,Urban,8,Middle,0,0,0
21899,35,State - ANDAMAN & NICOBAR ISLANDS,Urban,9,Middle,0,0,0
21900,35,State - ANDAMAN & NICOBAR ISLANDS,Urban,10,Middle,0,0,0
21901,35,State - ANDAMAN & NICOBAR ISLANDS,Urban,11,Middle,0,0,0
21902,35,State - ANDAMAN & NICOBAR ISLANDS,Urban,12,Middle,128,133,261
21903,35,State - ANDAMAN & NICOBAR ISLANDS,Urban,13,Middle,408,378,786
21904,35,State - ANDAMAN & NICOBAR ISLANDS,Urban,14,Middle,802,813,1615
21905,35,State - ANDAMAN & NICOBAR ISLANDS,Urban,15,Middle,761,721,1482
21906,35,State - ANDAMAN & NICOBAR ISLANDS,Urban,16,Middle,511,374,885
21907,35,State - ANDAMAN & NICOBAR ISLANDS,Urban,17,Middle,360,217,577
21908,35,State - ANDAMAN & NICOBAR ISLANDS,Urban,18,Middle,286,200,486
21909,35,State - ANDAMAN & NICOBAR ISLANDS,Urban,19,Middle,250,174,424
21910,35,State - ANDAMAN & NICOBAR ISLANDS,Urban,20-24,Middle,1598,1150,2748
21911,35,State - ANDAMAN & NICOBAR ISLANDS,Urban,25-29,Middle,1883,1571,3454
21912,35,State - ANDAMAN & NICOBAR ISLANDS,Urban,30-34,Middle,1705,1288,2993
21913,35,State - ANDAMAN & NICOBAR ISLANDS,Urban,35-39,Middle,1480,1109,2589
21914,35,State - ANDAMAN & NICOBAR ISLANDS,Urban,40-44,Middle,1077,710,1787
21915,35,State - ANDAMAN & NICOBAR ISLANDS,Urban,45-49,Middle,924,477,1401
21916,35,State - ANDAMAN & NICOBAR ISLANDS,Urban,50-54,Middle,630,364,994
21917,35,State - ANDAMAN & NICOBAR ISLANDS,Urban,55-59,Middle,448,194,642
21918,35,State - ANDAMAN & NICOBAR ISLANDS,Urban,60-64,Middle,285,115,400
21919,35,State - ANDAMAN & NICOBAR ISLANDS,Urban,65-69,Middle,123,63,186
21920,35,State - ANDAMAN & NICOBAR ISLANDS,Urban,70-74,Middle,93,28,121
21921,35,State - ANDAMAN & NICOBAR ISLANDS,Urban,75-79,Middle,48,26,74
21922,35,State - ANDAMAN & NICOBAR ISLANDS,Urban,80+,Middle,46,22,68
21923,35,State - ANDAMAN & NICOBAR ISLANDS,Urban,Age not stated,Middle,15,16,31
21924,0,INDIA,Total,All ages,Secondary,63769834,42169909,105939743
21925,0,INDIA,Total,0-6,Secondary,0,0,0
21926,0,INDIA,Total,7,Secondary,0,0,0
21927,0,INDIA,Total,8,Secondary,0,0,0
21928,0,INDIA,Total,9,Secondary,0,0,0
21929,0,INDIA,Total,10,Secondary,0,0,0
21930,0,INDIA,Total,11,Secondary,0,0,0
21931,0,INDIA,Total,12,Secondary,0,0,0
21932,0,INDIA,Total,13,Secondary,0,0,0
21933,0,INDIA,Total,14,Secondary,0,0,0
21934,0,INDIA,Total,15,Secondary,2855043,2600915,5455958
21935,0,INDIA,Total,16,Secondary,4885541,4367677,9253218
21936,0,INDIA,Total,17,Secondary,5639883,4832873,10472756
21937,0,INDIA,Total,18,Secondary,3009603,2239427,5249030
21938,0,INDIA,Total,19,Secondary,1792747,1403943,3196690
21939,0,INDIA,Total,20-24,Secondary,7801967,6146693,13948660
21940,0,INDIA,Total,25-29,Secondary,7178310,5279910,12458220
21941,0,INDIA,Total,30-34,Secondary,6369666,4105771,10475437
21942,0,INDIA,Total,35-39,Secondary,5834727,3358595,9193322
21943,0,INDIA,Total,40-44,Secondary,4800572,2409153,7209725
21944,0,INDIA,Total,45-49,Secondary,3805133,1804884,5610017
21945,0,INDIA,Total,50-54,Secondary,2979135,1283244,4262379
21946,0,INDIA,Total,55-59,Secondary,2320540,907897,3228437
21947,0,INDIA,Total,60-64,Secondary,1817072,586411,2403483
21948,0,INDIA,Total,65-69,Secondary,1137617,334844,1472461
21949,0,INDIA,Total,70-74,Secondary,687022,174141,861163
21950,0,INDIA,Total,75-79,Secondary,330710,90402,421112
21951,0,INDIA,Total,80+,Secondary,329093,119823,448916
21952,0,INDIA,Total,Age not stated,Secondary,195453,123306,318759
21953,0,INDIA,Rural,All ages,Secondary,38437368,22645654,61083022
21954,0,INDIA,Rural,0-6,Secondary,0,0,0
21955,0,INDIA,Rural,7,Secondary,0,0,0
21956,0,INDIA,Rural,8,Secondary,0,0,0
21957,0,INDIA,Rural,9,Secondary,0,0,0
21958,0,INDIA,Rural,10,Secondary,0,0,0
21959,0,INDIA,Rural,11,Secondary,0,0,0
21960,0,INDIA,Rural,12,Secondary,0,0,0
21961,0,INDIA,Rural,13,Secondary,0,0,0
21962,0,INDIA,Rural,14,Secondary,0,0,0
21963,0,INDIA,Rural,15,Secondary,1786264,1541759,3328023
21964,0,INDIA,Rural,16,Secondary,3069484,2614085,5683569
21965,0,INDIA,Rural,17,Secondary,3493247,2837132,6330379
21966,0,INDIA,Rural,18,Secondary,2077927,1493529,3571456
21967,0,INDIA,Rural,19,Secondary,1202821,920518,2123339
21968,0,INDIA,Rural,20-24,Secondary,5111115,3810725,8921840
21969,0,INDIA,Rural,25-29,Secondary,4416418,2963174,7379592
21970,0,INDIA,Rural,30-34,Secondary,3814290,2145841,5960131
21971,0,INDIA,Rural,35-39,Secondary,3471169,1600753,5071922
21972,0,INDIA,Rural,40-44,Secondary,2758323,1000668,3758991
21973,0,INDIA,Rural,45-49,Secondary,2082148,649212,2731360
21974,0,INDIA,Rural,50-54,Secondary,1574207,407592,1981799
21975,0,INDIA,Rural,55-59,Secondary,1227673,267662,1495335
21976,0,INDIA,Rural,60-64,Secondary,989106,149733,1138839
21977,0,INDIA,Rural,65-69,Secondary,607315,86066,693381
21978,0,INDIA,Rural,70-74,Secondary,343389,36866,380255
21979,0,INDIA,Rural,75-79,Secondary,147434,18675,166109
21980,0,INDIA,Rural,80+,Secondary,151693,39977,191670
21981,0,INDIA,Rural,Age not stated,Secondary,113345,61687,175032
21982,0,INDIA,Urban,All ages,Secondary,25332466,19524255,44856721
21983,0,INDIA,Urban,0-6,Secondary,0,0,0
21984,0,INDIA,Urban,7,Secondary,0,0,0
21985,0,INDIA,Urban,8,Secondary,0,0,0
21986,0,INDIA,Urban,9,Secondary,0,0,0
21987,0,INDIA,Urban,10,Secondary,0,0,0
21988,0,INDIA,Urban,11,Secondary,0,0,0
21989,0,INDIA,Urban,12,Secondary,0,0,0
21990,0,INDIA,Urban,13,Secondary,0,0,0
21991,0,INDIA,Urban,14,Secondary,0,0,0
21992,0,INDIA,Urban,15,Secondary,1068779,1059156,2127935
21993,0,INDIA,Urban,16,Secondary,1816057,1753592,3569649
21994,0,INDIA,Urban,17,Secondary,2146636,1995741,4142377
21995,0,INDIA,Urban,18,Secondary,931676,745898,1677574
21996,0,INDIA,Urban,19,Secondary,589926,483425,1073351
21997,0,INDIA,Urban,20-24,Secondary,2690852,2335968,5026820
21998,0,INDIA,Urban,25-29,Secondary,2761892,2316736,5078628
21999,0,INDIA,Urban,30-34,Secondary,2555376,1959930,4515306
22000,0,INDIA,Urban,35-39,Secondary,2363558,1757842,4121400
22001,0,INDIA,Urban,40-44,Secondary,2042249,1408485,3450734
22002,0,INDIA,Urban,45-49,Secondary,1722985,1155672,2878657
22003,0,INDIA,Urban,50-54,Secondary,1404928,875652,2280580
22004,0,INDIA,Urban,55-59,Secondary,1092867,640235,1733102
22005,0,INDIA,Urban,60-64,Secondary,827966,436678,1264644
22006,0,INDIA,Urban,65-69,Secondary,530302,248778,779080
22007,0,INDIA,Urban,70-74,Secondary,343633,137275,480908
22008,0,INDIA,Urban,75-79,Secondary,183276,71727,255003
22009,0,INDIA,Urban,80+,Secondary,177400,79846,257246
22010,0,INDIA,Urban,Age not stated,Secondary,82108,61619,143727
22011,1,State - JAMMU & KASHMIR,Total,All ages,Secondary,919672,492301,1411973
22012,1,State - JAMMU & KASHMIR,Total,0-6,Secondary,0,0,0
22013,1,State - JAMMU & KASHMIR,Total,7,Secondary,0,0,0
22014,1,State - JAMMU & KASHMIR,Total,8,Secondary,0,0,0
22015,1,State - JAMMU & KASHMIR,Total,9,Secondary,0,0,0
22016,1,State - JAMMU & KASHMIR,Total,10,Secondary,0,0,0
22017,1,State - JAMMU & KASHMIR,Total,11,Secondary,0,0,0
22018,1,State - JAMMU & KASHMIR,Total,12,Secondary,0,0,0
22019,1,State - JAMMU & KASHMIR,Total,13,Secondary,0,0,0
22020,1,State - JAMMU & KASHMIR,Total,14,Secondary,0,0,0
22021,1,State - JAMMU & KASHMIR,Total,15,Secondary,31024,25906,56930
22022,1,State - JAMMU & KASHMIR,Total,16,Secondary,56842,47220,104062
22023,1,State - JAMMU & KASHMIR,Total,17,Secondary,62951,52146,115097
22024,1,State - JAMMU & KASHMIR,Total,18,Secondary,42103,33199,75302
22025,1,State - JAMMU & KASHMIR,Total,19,Secondary,26300,20285,46585
22026,1,State - JAMMU & KASHMIR,Total,20-24,Secondary,121211,79735,200946
22027,1,State - JAMMU & KASHMIR,Total,25-29,Secondary,127065,61303,188368
22028,1,State - JAMMU & KASHMIR,Total,30-34,Secondary,105311,47871,153182
22029,1,State - JAMMU & KASHMIR,Total,35-39,Secondary,89344,39695,129039
22030,1,State - JAMMU & KASHMIR,Total,40-44,Secondary,77929,28310,106239
22031,1,State - JAMMU & KASHMIR,Total,45-49,Secondary,55749,21154,76903
22032,1,State - JAMMU & KASHMIR,Total,50-54,Secondary,43519,14830,58349
22033,1,State - JAMMU & KASHMIR,Total,55-59,Secondary,31053,9625,40678
22034,1,State - JAMMU & KASHMIR,Total,60-64,Secondary,22549,5415,27964
22035,1,State - JAMMU & KASHMIR,Total,65-69,Secondary,11919,2637,14556
22036,1,State - JAMMU & KASHMIR,Total,70-74,Secondary,6977,1183,8160
22037,1,State - JAMMU & KASHMIR,Total,75-79,Secondary,3164,482,3646
22038,1,State - JAMMU & KASHMIR,Total,80+,Secondary,3935,977,4912
22039,1,State - JAMMU & KASHMIR,Total,Age not stated,Secondary,727,328,1055
22040,1,State - JAMMU & KASHMIR,Rural,All ages,Secondary,583213,304184,887397
22041,1,State - JAMMU & KASHMIR,Rural,0-6,Secondary,0,0,0
22042,1,State - JAMMU & KASHMIR,Rural,7,Secondary,0,0,0
22043,1,State - JAMMU & KASHMIR,Rural,8,Secondary,0,0,0
22044,1,State - JAMMU & KASHMIR,Rural,9,Secondary,0,0,0
22045,1,State - JAMMU & KASHMIR,Rural,10,Secondary,0,0,0
22046,1,State - JAMMU & KASHMIR,Rural,11,Secondary,0,0,0
22047,1,State - JAMMU & KASHMIR,Rural,12,Secondary,0,0,0
22048,1,State - JAMMU & KASHMIR,Rural,13,Secondary,0,0,0
22049,1,State - JAMMU & KASHMIR,Rural,14,Secondary,0,0,0
22050,1,State - JAMMU & KASHMIR,Rural,15,Secondary,21899,17398,39297
22051,1,State - JAMMU & KASHMIR,Rural,16,Secondary,39485,31408,70893
22052,1,State - JAMMU & KASHMIR,Rural,17,Secondary,43138,33951,77089
22053,1,State - JAMMU & KASHMIR,Rural,18,Secondary,31420,24155,55575
22054,1,State - JAMMU & KASHMIR,Rural,19,Secondary,20250,15285,35535
22055,1,State - JAMMU & KASHMIR,Rural,20-24,Secondary,86334,58703,145037
22056,1,State - JAMMU & KASHMIR,Rural,25-29,Secondary,77367,40588,117955
22057,1,State - JAMMU & KASHMIR,Rural,30-34,Secondary,63877,29367,93244
22058,1,State - JAMMU & KASHMIR,Rural,35-39,Secondary,52874,21735,74609
22059,1,State - JAMMU & KASHMIR,Rural,40-44,Secondary,44386,13536,57922
22060,1,State - JAMMU & KASHMIR,Rural,45-49,Secondary,32130,8166,40296
22061,1,State - JAMMU & KASHMIR,Rural,50-54,Secondary,25745,4666,30411
22062,1,State - JAMMU & KASHMIR,Rural,55-59,Secondary,18574,2589,21163
22063,1,State - JAMMU & KASHMIR,Rural,60-64,Secondary,13060,1158,14218
22064,1,State - JAMMU & KASHMIR,Rural,65-69,Secondary,6281,520,6801
22065,1,State - JAMMU & KASHMIR,Rural,70-74,Secondary,3141,221,3362
22066,1,State - JAMMU & KASHMIR,Rural,75-79,Secondary,1144,91,1235
22067,1,State - JAMMU & KASHMIR,Rural,80+,Secondary,1643,427,2070
22068,1,State - JAMMU & KASHMIR,Rural,Age not stated,Secondary,465,220,685
22069,1,State - JAMMU & KASHMIR,Urban,All ages,Secondary,336459,188117,524576
22070,1,State - JAMMU & KASHMIR,Urban,0-6,Secondary,0,0,0
22071,1,State - JAMMU & KASHMIR,Urban,7,Secondary,0,0,0
22072,1,State - JAMMU & KASHMIR,Urban,8,Secondary,0,0,0
22073,1,State - JAMMU & KASHMIR,Urban,9,Secondary,0,0,0
22074,1,State - JAMMU & KASHMIR,Urban,10,Secondary,0,0,0
22075,1,State - JAMMU & KASHMIR,Urban,11,Secondary,0,0,0
22076,1,State - JAMMU & KASHMIR,Urban,12,Secondary,0,0,0
22077,1,State - JAMMU & KASHMIR,Urban,13,Secondary,0,0,0
22078,1,State - JAMMU & KASHMIR,Urban,14,Secondary,0,0,0
22079,1,State - JAMMU & KASHMIR,Urban,15,Secondary,9125,8508,17633
22080,1,State - JAMMU & KASHMIR,Urban,16,Secondary,17357,15812,33169
22081,1,State - JAMMU & KASHMIR,Urban,17,Secondary,19813,18195,38008
22082,1,State - JAMMU & KASHMIR,Urban,18,Secondary,10683,9044,19727
22083,1,State - JAMMU & KASHMIR,Urban,19,Secondary,6050,5000,11050
22084,1,State - JAMMU & KASHMIR,Urban,20-24,Secondary,34877,21032,55909
22085,1,State - JAMMU & KASHMIR,Urban,25-29,Secondary,49698,20715,70413
22086,1,State - JAMMU & KASHMIR,Urban,30-34,Secondary,41434,18504,59938
22087,1,State - JAMMU & KASHMIR,Urban,35-39,Secondary,36470,17960,54430
22088,1,State - JAMMU & KASHMIR,Urban,40-44,Secondary,33543,14774,48317
22089,1,State - JAMMU & KASHMIR,Urban,45-49,Secondary,23619,12988,36607
22090,1,State - JAMMU & KASHMIR,Urban,50-54,Secondary,17774,10164,27938
22091,1,State - JAMMU & KASHMIR,Urban,55-59,Secondary,12479,7036,19515
22092,1,State - JAMMU & KASHMIR,Urban,60-64,Secondary,9489,4257,13746
22093,1,State - JAMMU & KASHMIR,Urban,65-69,Secondary,5638,2117,7755
22094,1,State - JAMMU & KASHMIR,Urban,70-74,Secondary,3836,962,4798
22095,1,State - JAMMU & KASHMIR,Urban,75-79,Secondary,2020,391,2411
22096,1,State - JAMMU & KASHMIR,Urban,80+,Secondary,2292,550,2842
22097,1,State - JAMMU & KASHMIR,Urban,Age not stated,Secondary,262,108,370
22098,2,State - HIMACHAL PRADESH,Total,All ages,Secondary,666498,461499,1127997
22099,2,State - HIMACHAL PRADESH,Total,0-6,Secondary,0,0,0
22100,2,State - HIMACHAL PRADESH,Total,7,Secondary,0,0,0
22101,2,State - HIMACHAL PRADESH,Total,8,Secondary,0,0,0
22102,2,State - HIMACHAL PRADESH,Total,9,Secondary,0,0,0
22103,2,State - HIMACHAL PRADESH,Total,10,Secondary,0,0,0
22104,2,State - HIMACHAL PRADESH,Total,11,Secondary,0,0,0
22105,2,State - HIMACHAL PRADESH,Total,12,Secondary,0,0,0
22106,2,State - HIMACHAL PRADESH,Total,13,Secondary,0,0,0
22107,2,State - HIMACHAL PRADESH,Total,14,Secondary,0,0,0
22108,2,State - HIMACHAL PRADESH,Total,15,Secondary,14800,14244,29044
22109,2,State - HIMACHAL PRADESH,Total,16,Secondary,32942,30698,63640
22110,2,State - HIMACHAL PRADESH,Total,17,Secondary,42962,39819,82781
22111,2,State - HIMACHAL PRADESH,Total,18,Secondary,26311,22441,48752
22112,2,State - HIMACHAL PRADESH,Total,19,Secondary,17955,15347,33302
22113,2,State - HIMACHAL PRADESH,Total,20-24,Secondary,71046,67713,138759
22114,2,State - HIMACHAL PRADESH,Total,25-29,Secondary,69611,68007,137618
22115,2,State - HIMACHAL PRADESH,Total,30-34,Secondary,70967,63545,134512
22116,2,State - HIMACHAL PRADESH,Total,35-39,Secondary,70501,51662,122163
22117,2,State - HIMACHAL PRADESH,Total,40-44,Secondary,62936,34652,97588
22118,2,State - HIMACHAL PRADESH,Total,45-49,Secondary,53082,21622,74704
22119,2,State - HIMACHAL PRADESH,Total,50-54,Secondary,43059,13733,56792
22120,2,State - HIMACHAL PRADESH,Total,55-59,Secondary,33689,8574,42263
22121,2,State - HIMACHAL PRADESH,Total,60-64,Secondary,24117,4500,28617
22122,2,State - HIMACHAL PRADESH,Total,65-69,Secondary,14832,2299,17131
22123,2,State - HIMACHAL PRADESH,Total,70-74,Secondary,9149,1068,10217
22124,2,State - HIMACHAL PRADESH,Total,75-79,Secondary,4513,380,4893
22125,2,State - HIMACHAL PRADESH,Total,80+,Secondary,3253,619,3872
22126,2,State - HIMACHAL PRADESH,Total,Age not stated,Secondary,773,576,1349
22127,2,State - HIMACHAL PRADESH,Rural,All ages,Secondary,598104,411166,1009270
22128,2,State - HIMACHAL PRADESH,Rural,0-6,Secondary,0,0,0
22129,2,State - HIMACHAL PRADESH,Rural,7,Secondary,0,0,0
22130,2,State - HIMACHAL PRADESH,Rural,8,Secondary,0,0,0
22131,2,State - HIMACHAL PRADESH,Rural,9,Secondary,0,0,0
22132,2,State - HIMACHAL PRADESH,Rural,10,Secondary,0,0,0
22133,2,State - HIMACHAL PRADESH,Rural,11,Secondary,0,0,0
22134,2,State - HIMACHAL PRADESH,Rural,12,Secondary,0,0,0
22135,2,State - HIMACHAL PRADESH,Rural,13,Secondary,0,0,0
22136,2,State - HIMACHAL PRADESH,Rural,14,Secondary,0,0,0
22137,2,State - HIMACHAL PRADESH,Rural,15,Secondary,13206,12750,25956
22138,2,State - HIMACHAL PRADESH,Rural,16,Secondary,29201,27380,56581
22139,2,State - HIMACHAL PRADESH,Rural,17,Secondary,38196,35379,73575
22140,2,State - HIMACHAL PRADESH,Rural,18,Secondary,23768,20653,44421
22141,2,State - HIMACHAL PRADESH,Rural,19,Secondary,16461,14345,30806
22142,2,State - HIMACHAL PRADESH,Rural,20-24,Secondary,64987,64038,129025
22143,2,State - HIMACHAL PRADESH,Rural,25-29,Secondary,63217,63725,126942
22144,2,State - HIMACHAL PRADESH,Rural,30-34,Secondary,64545,58493,123038
22145,2,State - HIMACHAL PRADESH,Rural,35-39,Secondary,64131,45938,110069
22146,2,State - HIMACHAL PRADESH,Rural,40-44,Secondary,56132,29009,85141
22147,2,State - HIMACHAL PRADESH,Rural,45-49,Secondary,46751,16909,63660
22148,2,State - HIMACHAL PRADESH,Rural,50-54,Secondary,37814,10379,48193
22149,2,State - HIMACHAL PRADESH,Rural,55-59,Secondary,29913,6192,36105
22150,2,State - HIMACHAL PRADESH,Rural,60-64,Secondary,21763,2859,24622
22151,2,State - HIMACHAL PRADESH,Rural,65-69,Secondary,13102,1370,14472
22152,2,State - HIMACHAL PRADESH,Rural,70-74,Secondary,7832,552,8384
22153,2,State - HIMACHAL PRADESH,Rural,75-79,Secondary,3773,211,3984
22154,2,State - HIMACHAL PRADESH,Rural,80+,Secondary,2619,446,3065
22155,2,State - HIMACHAL PRADESH,Rural,Age not stated,Secondary,693,538,1231
22156,2,State - HIMACHAL PRADESH,Urban,All ages,Secondary,68394,50333,118727
22157,2,State - HIMACHAL PRADESH,Urban,0-6,Secondary,0,0,0
22158,2,State - HIMACHAL PRADESH,Urban,7,Secondary,0,0,0
22159,2,State - HIMACHAL PRADESH,Urban,8,Secondary,0,0,0
22160,2,State - HIMACHAL PRADESH,Urban,9,Secondary,0,0,0
22161,2,State - HIMACHAL PRADESH,Urban,10,Secondary,0,0,0
22162,2,State - HIMACHAL PRADESH,Urban,11,Secondary,0,0,0
22163,2,State - HIMACHAL PRADESH,Urban,12,Secondary,0,0,0
22164,2,State - HIMACHAL PRADESH,Urban,13,Secondary,0,0,0
22165,2,State - HIMACHAL PRADESH,Urban,14,Secondary,0,0,0
22166,2,State - HIMACHAL PRADESH,Urban,15,Secondary,1594,1494,3088
22167,2,State - HIMACHAL PRADESH,Urban,16,Secondary,3741,3318,7059
22168,2,State - HIMACHAL PRADESH,Urban,17,Secondary,4766,4440,9206
22169,2,State - HIMACHAL PRADESH,Urban,18,Secondary,2543,1788,4331
22170,2,State - HIMACHAL PRADESH,Urban,19,Secondary,1494,1002,2496
22171,2,State - HIMACHAL PRADESH,Urban,20-24,Secondary,6059,3675,9734
22172,2,State - HIMACHAL PRADESH,Urban,25-29,Secondary,6394,4282,10676
22173,2,State - HIMACHAL PRADESH,Urban,30-34,Secondary,6422,5052,11474
22174,2,State - HIMACHAL PRADESH,Urban,35-39,Secondary,6370,5724,12094
22175,2,State - HIMACHAL PRADESH,Urban,40-44,Secondary,6804,5643,12447
22176,2,State - HIMACHAL PRADESH,Urban,45-49,Secondary,6331,4713,11044
22177,2,State - HIMACHAL PRADESH,Urban,50-54,Secondary,5245,3354,8599
22178,2,State - HIMACHAL PRADESH,Urban,55-59,Secondary,3776,2382,6158
22179,2,State - HIMACHAL PRADESH,Urban,60-64,Secondary,2354,1641,3995
22180,2,State - HIMACHAL PRADESH,Urban,65-69,Secondary,1730,929,2659
22181,2,State - HIMACHAL PRADESH,Urban,70-74,Secondary,1317,516,1833
22182,2,State - HIMACHAL PRADESH,Urban,75-79,Secondary,740,169,909
22183,2,State - HIMACHAL PRADESH,Urban,80+,Secondary,634,173,807
22184,2,State - HIMACHAL PRADESH,Urban,Age not stated,Secondary,80,38,118
22185,3,State - PUNJAB,Total,All ages,Secondary,2472299,1714074,4186373
22186,3,State - PUNJAB,Total,0-6,Secondary,0,0,0
22187,3,State - PUNJAB,Total,7,Secondary,0,0,0
22188,3,State - PUNJAB,Total,8,Secondary,0,0,0
22189,3,State - PUNJAB,Total,9,Secondary,0,0,0
22190,3,State - PUNJAB,Total,10,Secondary,0,0,0
22191,3,State - PUNJAB,Total,11,Secondary,0,0,0
22192,3,State - PUNJAB,Total,12,Secondary,0,0,0
22193,3,State - PUNJAB,Total,13,Secondary,0,0,0
22194,3,State - PUNJAB,Total,14,Secondary,0,0,0
22195,3,State - PUNJAB,Total,15,Secondary,47261,46933,94194
22196,3,State - PUNJAB,Total,16,Secondary,109521,103323,212844
22197,3,State - PUNJAB,Total,17,Secondary,153330,135777,289107
22198,3,State - PUNJAB,Total,18,Secondary,101501,73440,174941
22199,3,State - PUNJAB,Total,19,Secondary,65364,45498,110862
22200,3,State - PUNJAB,Total,20-24,Secondary,270513,222165,492678
22201,3,State - PUNJAB,Total,25-29,Secondary,277836,232539,510375
22202,3,State - PUNJAB,Total,30-34,Secondary,259837,199900,459737
22203,3,State - PUNJAB,Total,35-39,Secondary,258531,183545,442076
22204,3,State - PUNJAB,Total,40-44,Secondary,229450,151343,380793
22205,3,State - PUNJAB,Total,45-49,Secondary,203780,120689,324469
22206,3,State - PUNJAB,Total,50-54,Secondary,151915,78818,230733
22207,3,State - PUNJAB,Total,55-59,Secondary,111468,52524,163992
22208,3,State - PUNJAB,Total,60-64,Secondary,90619,33617,124236
22209,3,State - PUNJAB,Total,65-69,Secondary,64858,16549,81407
22210,3,State - PUNJAB,Total,70-74,Secondary,39178,7712,46890
22211,3,State - PUNJAB,Total,75-79,Secondary,17687,3242,20929
22212,3,State - PUNJAB,Total,80+,Secondary,16852,4417,21269
22213,3,State - PUNJAB,Total,Age not stated,Secondary,2798,2043,4841
22214,3,State - PUNJAB,Rural,All ages,Secondary,1452187,989427,2441614
22215,3,State - PUNJAB,Rural,0-6,Secondary,0,0,0
22216,3,State - PUNJAB,Rural,7,Secondary,0,0,0
22217,3,State - PUNJAB,Rural,8,Secondary,0,0,0
22218,3,State - PUNJAB,Rural,9,Secondary,0,0,0
22219,3,State - PUNJAB,Rural,10,Secondary,0,0,0
22220,3,State - PUNJAB,Rural,11,Secondary,0,0,0
22221,3,State - PUNJAB,Rural,12,Secondary,0,0,0
22222,3,State - PUNJAB,Rural,13,Secondary,0,0,0
22223,3,State - PUNJAB,Rural,14,Secondary,0,0,0
22224,3,State - PUNJAB,Rural,15,Secondary,25730,26335,52065
22225,3,State - PUNJAB,Rural,16,Secondary,62622,61362,123984
22226,3,State - PUNJAB,Rural,17,Secondary,90943,82302,173245
22227,3,State - PUNJAB,Rural,18,Secondary,67228,49228,116456
22228,3,State - PUNJAB,Rural,19,Secondary,44665,31655,76320
22229,3,State - PUNJAB,Rural,20-24,Secondary,175239,153035,328274
22230,3,State - PUNJAB,Rural,25-29,Secondary,167431,154171,321602
22231,3,State - PUNJAB,Rural,30-34,Secondary,155421,127126,282547
22232,3,State - PUNJAB,Rural,35-39,Secondary,155184,107214,262398
22233,3,State - PUNJAB,Rural,40-44,Secondary,135345,79305,214650
22234,3,State - PUNJAB,Rural,45-49,Secondary,115036,53752,168788
22235,3,State - PUNJAB,Rural,50-54,Secondary,80443,28330,108773
22236,3,State - PUNJAB,Rural,55-59,Secondary,57078,16435,73513
22237,3,State - PUNJAB,Rural,60-64,Secondary,46688,9109,55797
22238,3,State - PUNJAB,Rural,65-69,Secondary,34608,4168,38776
22239,3,State - PUNJAB,Rural,70-74,Secondary,20312,1902,22214
22240,3,State - PUNJAB,Rural,75-79,Secondary,8223,779,9002
22241,3,State - PUNJAB,Rural,80+,Secondary,8070,1838,9908
22242,3,State - PUNJAB,Rural,Age not stated,Secondary,1921,1381,3302
22243,3,State - PUNJAB,Urban,All ages,Secondary,1020112,724647,1744759
22244,3,State - PUNJAB,Urban,0-6,Secondary,0,0,0
22245,3,State - PUNJAB,Urban,7,Secondary,0,0,0
22246,3,State - PUNJAB,Urban,8,Secondary,0,0,0
22247,3,State - PUNJAB,Urban,9,Secondary,0,0,0
22248,3,State - PUNJAB,Urban,10,Secondary,0,0,0
22249,3,State - PUNJAB,Urban,11,Secondary,0,0,0
22250,3,State - PUNJAB,Urban,12,Secondary,0,0,0
22251,3,State - PUNJAB,Urban,13,Secondary,0,0,0
22252,3,State - PUNJAB,Urban,14,Secondary,0,0,0
22253,3,State - PUNJAB,Urban,15,Secondary,21531,20598,42129
22254,3,State - PUNJAB,Urban,16,Secondary,46899,41961,88860
22255,3,State - PUNJAB,Urban,17,Secondary,62387,53475,115862
22256,3,State - PUNJAB,Urban,18,Secondary,34273,24212,58485
22257,3,State - PUNJAB,Urban,19,Secondary,20699,13843,34542
22258,3,State - PUNJAB,Urban,20-24,Secondary,95274,69130,164404
22259,3,State - PUNJAB,Urban,25-29,Secondary,110405,78368,188773
22260,3,State - PUNJAB,Urban,30-34,Secondary,104416,72774,177190
22261,3,State - PUNJAB,Urban,35-39,Secondary,103347,76331,179678
22262,3,State - PUNJAB,Urban,40-44,Secondary,94105,72038,166143
22263,3,State - PUNJAB,Urban,45-49,Secondary,88744,66937,155681
22264,3,State - PUNJAB,Urban,50-54,Secondary,71472,50488,121960
22265,3,State - PUNJAB,Urban,55-59,Secondary,54390,36089,90479
22266,3,State - PUNJAB,Urban,60-64,Secondary,43931,24508,68439
22267,3,State - PUNJAB,Urban,65-69,Secondary,30250,12381,42631
22268,3,State - PUNJAB,Urban,70-74,Secondary,18866,5810,24676
22269,3,State - PUNJAB,Urban,75-79,Secondary,9464,2463,11927
22270,3,State - PUNJAB,Urban,80+,Secondary,8782,2579,11361
22271,3,State - PUNJAB,Urban,Age not stated,Secondary,877,662,1539
22272,4,State - CHANDIGARH,Total,All ages,Secondary,88021,54185,142206
22273,4,State - CHANDIGARH,Total,0-6,Secondary,0,0,0
22274,4,State - CHANDIGARH,Total,7,Secondary,0,0,0
22275,4,State - CHANDIGARH,Total,8,Secondary,0,0,0
22276,4,State - CHANDIGARH,Total,9,Secondary,0,0,0
22277,4,State - CHANDIGARH,Total,10,Secondary,0,0,0
22278,4,State - CHANDIGARH,Total,11,Secondary,0,0,0
22279,4,State - CHANDIGARH,Total,12,Secondary,0,0,0
22280,4,State - CHANDIGARH,Total,13,Secondary,0,0,0
22281,4,State - CHANDIGARH,Total,14,Secondary,0,0,0
22282,4,State - CHANDIGARH,Total,15,Secondary,1654,1367,3021
22283,4,State - CHANDIGARH,Total,16,Secondary,4493,3723,8216
22284,4,State - CHANDIGARH,Total,17,Secondary,6376,5027,11403
22285,4,State - CHANDIGARH,Total,18,Secondary,3718,2466,6184
22286,4,State - CHANDIGARH,Total,19,Secondary,2238,1348,3586
22287,4,State - CHANDIGARH,Total,20-24,Secondary,9826,6032,15858
22288,4,State - CHANDIGARH,Total,25-29,Secondary,10045,6070,16115
22289,4,State - CHANDIGARH,Total,30-34,Secondary,9258,5148,14406
22290,4,State - CHANDIGARH,Total,35-39,Secondary,9206,5344,14550
22291,4,State - CHANDIGARH,Total,40-44,Secondary,8375,4655,13030
22292,4,State - CHANDIGARH,Total,45-49,Secondary,7219,4029,11248
22293,4,State - CHANDIGARH,Total,50-54,Secondary,5535,2889,8424
22294,4,State - CHANDIGARH,Total,55-59,Secondary,3853,2096,5949
22295,4,State - CHANDIGARH,Total,60-64,Secondary,2234,1485,3719
22296,4,State - CHANDIGARH,Total,65-69,Secondary,1500,1015,2515
22297,4,State - CHANDIGARH,Total,70-74,Secondary,1129,698,1827
22298,4,State - CHANDIGARH,Total,75-79,Secondary,622,400,1022
22299,4,State - CHANDIGARH,Total,80+,Secondary,721,378,1099
22300,4,State - CHANDIGARH,Total,Age not stated,Secondary,19,15,34
22301,4,State - CHANDIGARH,Rural,All ages,Secondary,2862,1359,4221
22302,4,State - CHANDIGARH,Rural,0-6,Secondary,0,0,0
22303,4,State - CHANDIGARH,Rural,7,Secondary,0,0,0
22304,4,State - CHANDIGARH,Rural,8,Secondary,0,0,0
22305,4,State - CHANDIGARH,Rural,9,Secondary,0,0,0
22306,4,State - CHANDIGARH,Rural,10,Secondary,0,0,0
22307,4,State - CHANDIGARH,Rural,11,Secondary,0,0,0
22308,4,State - CHANDIGARH,Rural,12,Secondary,0,0,0
22309,4,State - CHANDIGARH,Rural,13,Secondary,0,0,0
22310,4,State - CHANDIGARH,Rural,14,Secondary,0,0,0
22311,4,State - CHANDIGARH,Rural,15,Secondary,33,24,57
22312,4,State - CHANDIGARH,Rural,16,Secondary,96,62,158
22313,4,State - CHANDIGARH,Rural,17,Secondary,116,93,209
22314,4,State - CHANDIGARH,Rural,18,Secondary,96,58,154
22315,4,State - CHANDIGARH,Rural,19,Secondary,66,32,98
22316,4,State - CHANDIGARH,Rural,20-24,Secondary,443,251,694
22317,4,State - CHANDIGARH,Rural,25-29,Secondary,472,288,760
22318,4,State - CHANDIGARH,Rural,30-34,Secondary,450,205,655
22319,4,State - CHANDIGARH,Rural,35-39,Secondary,355,149,504
22320,4,State - CHANDIGARH,Rural,40-44,Secondary,261,78,339
22321,4,State - CHANDIGARH,Rural,45-49,Secondary,159,46,205
22322,4,State - CHANDIGARH,Rural,50-54,Secondary,113,37,150
22323,4,State - CHANDIGARH,Rural,55-59,Secondary,75,21,96
22324,4,State - CHANDIGARH,Rural,60-64,Secondary,60,7,67
22325,4,State - CHANDIGARH,Rural,65-69,Secondary,27,1,28
22326,4,State - CHANDIGARH,Rural,70-74,Secondary,25,4,29
22327,4,State - CHANDIGARH,Rural,75-79,Secondary,10,1,11
22328,4,State - CHANDIGARH,Rural,80+,Secondary,5,2,7
22329,4,State - CHANDIGARH,Rural,Age not stated,Secondary,0,0,0
22330,4,State - CHANDIGARH,Urban,All ages,Secondary,85159,52826,137985
22331,4,State - CHANDIGARH,Urban,0-6,Secondary,0,0,0
22332,4,State - CHANDIGARH,Urban,7,Secondary,0,0,0
22333,4,State - CHANDIGARH,Urban,8,Secondary,0,0,0
22334,4,State - CHANDIGARH,Urban,9,Secondary,0,0,0
22335,4,State - CHANDIGARH,Urban,10,Secondary,0,0,0
22336,4,State - CHANDIGARH,Urban,11,Secondary,0,0,0
22337,4,State - CHANDIGARH,Urban,12,Secondary,0,0,0
22338,4,State - CHANDIGARH,Urban,13,Secondary,0,0,0
22339,4,State - CHANDIGARH,Urban,14,Secondary,0,0,0
22340,4,State - CHANDIGARH,Urban,15,Secondary,1621,1343,2964
22341,4,State - CHANDIGARH,Urban,16,Secondary,4397,3661,8058
22342,4,State - CHANDIGARH,Urban,17,Secondary,6260,4934,11194
22343,4,State - CHANDIGARH,Urban,18,Secondary,3622,2408,6030
22344,4,State - CHANDIGARH,Urban,19,Secondary,2172,1316,3488
22345,4,State - CHANDIGARH,Urban,20-24,Secondary,9383,5781,15164
22346,4,State - CHANDIGARH,Urban,25-29,Secondary,9573,5782,15355
22347,4,State - CHANDIGARH,Urban,30-34,Secondary,8808,4943,13751
22348,4,State - CHANDIGARH,Urban,35-39,Secondary,8851,5195,14046
22349,4,State - CHANDIGARH,Urban,40-44,Secondary,8114,4577,12691
22350,4,State - CHANDIGARH,Urban,45-49,Secondary,7060,3983,11043
22351,4,State - CHANDIGARH,Urban,50-54,Secondary,5422,2852,8274
22352,4,State - CHANDIGARH,Urban,55-59,Secondary,3778,2075,5853
22353,4,State - CHANDIGARH,Urban,60-64,Secondary,2174,1478,3652
22354,4,State - CHANDIGARH,Urban,65-69,Secondary,1473,1014,2487
22355,4,State - CHANDIGARH,Urban,70-74,Secondary,1104,694,1798
22356,4,State - CHANDIGARH,Urban,75-79,Secondary,612,399,1011
22357,4,State - CHANDIGARH,Urban,80+,Secondary,716,376,1092
22358,4,State - CHANDIGARH,Urban,Age not stated,Secondary,19,15,34
22359,5,State - UTTARAKHAND,Total,All ages,Secondary,627977,391513,1019490
22360,5,State - UTTARAKHAND,Total,0-6,Secondary,0,0,0
22361,5,State - UTTARAKHAND,Total,7,Secondary,0,0,0
22362,5,State - UTTARAKHAND,Total,8,Secondary,0,0,0
22363,5,State - UTTARAKHAND,Total,9,Secondary,0,0,0
22364,5,State - UTTARAKHAND,Total,10,Secondary,0,0,0
22365,5,State - UTTARAKHAND,Total,11,Secondary,0,0,0
22366,5,State - UTTARAKHAND,Total,12,Secondary,0,0,0
22367,5,State - UTTARAKHAND,Total,13,Secondary,0,0,0
22368,5,State - UTTARAKHAND,Total,14,Secondary,0,0,0
22369,5,State - UTTARAKHAND,Total,15,Secondary,26743,24820,51563
22370,5,State - UTTARAKHAND,Total,16,Secondary,47806,44794,92600
22371,5,State - UTTARAKHAND,Total,17,Secondary,59200,53235,112435
22372,5,State - UTTARAKHAND,Total,18,Secondary,38291,28555,66846
22373,5,State - UTTARAKHAND,Total,19,Secondary,23353,16320,39673
22374,5,State - UTTARAKHAND,Total,20-24,Secondary,76732,58945,135677
22375,5,State - UTTARAKHAND,Total,25-29,Secondary,64998,46167,111165
22376,5,State - UTTARAKHAND,Total,30-34,Secondary,56290,32711,89001
22377,5,State - UTTARAKHAND,Total,35-39,Secondary,53213,26616,79829
22378,5,State - UTTARAKHAND,Total,40-44,Secondary,44903,18518,63421
22379,5,State - UTTARAKHAND,Total,45-49,Secondary,36493,13444,49937
22380,5,State - UTTARAKHAND,Total,50-54,Secondary,28043,8993,37036
22381,5,State - UTTARAKHAND,Total,55-59,Secondary,21588,6606,28194
22382,5,State - UTTARAKHAND,Total,60-64,Secondary,19566,4721,24287
22383,5,State - UTTARAKHAND,Total,65-69,Secondary,13163,3106,16269
22384,5,State - UTTARAKHAND,Total,70-74,Secondary,8472,1521,9993
22385,5,State - UTTARAKHAND,Total,75-79,Secondary,4240,757,4997
22386,5,State - UTTARAKHAND,Total,80+,Secondary,3883,1114,4997
22387,5,State - UTTARAKHAND,Total,Age not stated,Secondary,1000,570,1570
22388,5,State - UTTARAKHAND,Rural,All ages,Secondary,418485,252100,670585
22389,5,State - UTTARAKHAND,Rural,0-6,Secondary,0,0,0
22390,5,State - UTTARAKHAND,Rural,7,Secondary,0,0,0
22391,5,State - UTTARAKHAND,Rural,8,Secondary,0,0,0
22392,5,State - UTTARAKHAND,Rural,9,Secondary,0,0,0
22393,5,State - UTTARAKHAND,Rural,10,Secondary,0,0,0
22394,5,State - UTTARAKHAND,Rural,11,Secondary,0,0,0
22395,5,State - UTTARAKHAND,Rural,12,Secondary,0,0,0
22396,5,State - UTTARAKHAND,Rural,13,Secondary,0,0,0
22397,5,State - UTTARAKHAND,Rural,14,Secondary,0,0,0
22398,5,State - UTTARAKHAND,Rural,15,Secondary,17775,16252,34027
22399,5,State - UTTARAKHAND,Rural,16,Secondary,31811,30050,61861
22400,5,State - UTTARAKHAND,Rural,17,Secondary,39752,35387,75139
22401,5,State - UTTARAKHAND,Rural,18,Secondary,28024,21150,49174
22402,5,State - UTTARAKHAND,Rural,19,Secondary,17030,12541,29571
22403,5,State - UTTARAKHAND,Rural,20-24,Secondary,53013,43535,96548
22404,5,State - UTTARAKHAND,Rural,25-29,Secondary,42499,31867,74366
22405,5,State - UTTARAKHAND,Rural,30-34,Secondary,36791,21174,57965
22406,5,State - UTTARAKHAND,Rural,35-39,Secondary,35111,15287,50398
22407,5,State - UTTARAKHAND,Rural,40-44,Secondary,29679,9383,39062
22408,5,State - UTTARAKHAND,Rural,45-49,Secondary,23730,6124,29854
22409,5,State - UTTARAKHAND,Rural,50-54,Secondary,18282,3469,21751
22410,5,State - UTTARAKHAND,Rural,55-59,Secondary,13703,2298,16001
22411,5,State - UTTARAKHAND,Rural,60-64,Secondary,12982,1316,14298
22412,5,State - UTTARAKHAND,Rural,65-69,Secondary,8051,958,9009
22413,5,State - UTTARAKHAND,Rural,70-74,Secondary,5196,360,5556
22414,5,State - UTTARAKHAND,Rural,75-79,Secondary,2439,177,2616
22415,5,State - UTTARAKHAND,Rural,80+,Secondary,2090,452,2542
22416,5,State - UTTARAKHAND,Rural,Age not stated,Secondary,527,320,847
22417,5,State - UTTARAKHAND,Urban,All ages,Secondary,209492,139413,348905
22418,5,State - UTTARAKHAND,Urban,0-6,Secondary,0,0,0
22419,5,State - UTTARAKHAND,Urban,7,Secondary,0,0,0
22420,5,State - UTTARAKHAND,Urban,8,Secondary,0,0,0
22421,5,State - UTTARAKHAND,Urban,9,Secondary,0,0,0
22422,5,State - UTTARAKHAND,Urban,10,Secondary,0,0,0
22423,5,State - UTTARAKHAND,Urban,11,Secondary,0,0,0
22424,5,State - UTTARAKHAND,Urban,12,Secondary,0,0,0
22425,5,State - UTTARAKHAND,Urban,13,Secondary,0,0,0
22426,5,State - UTTARAKHAND,Urban,14,Secondary,0,0,0
22427,5,State - UTTARAKHAND,Urban,15,Secondary,8968,8568,17536
22428,5,State - UTTARAKHAND,Urban,16,Secondary,15995,14744,30739
22429,5,State - UTTARAKHAND,Urban,17,Secondary,19448,17848,37296
22430,5,State - UTTARAKHAND,Urban,18,Secondary,10267,7405,17672
22431,5,State - UTTARAKHAND,Urban,19,Secondary,6323,3779,10102
22432,5,State - UTTARAKHAND,Urban,20-24,Secondary,23719,15410,39129
22433,5,State - UTTARAKHAND,Urban,25-29,Secondary,22499,14300,36799
22434,5,State - UTTARAKHAND,Urban,30-34,Secondary,19499,11537,31036
22435,5,State - UTTARAKHAND,Urban,35-39,Secondary,18102,11329,29431
22436,5,State - UTTARAKHAND,Urban,40-44,Secondary,15224,9135,24359
22437,5,State - UTTARAKHAND,Urban,45-49,Secondary,12763,7320,20083
22438,5,State - UTTARAKHAND,Urban,50-54,Secondary,9761,5524,15285
22439,5,State - UTTARAKHAND,Urban,55-59,Secondary,7885,4308,12193
22440,5,State - UTTARAKHAND,Urban,60-64,Secondary,6584,3405,9989
22441,5,State - UTTARAKHAND,Urban,65-69,Secondary,5112,2148,7260
22442,5,State - UTTARAKHAND,Urban,70-74,Secondary,3276,1161,4437
22443,5,State - UTTARAKHAND,Urban,75-79,Secondary,1801,580,2381
22444,5,State - UTTARAKHAND,Urban,80+,Secondary,1793,662,2455
22445,5,State - UTTARAKHAND,Urban,Age not stated,Secondary,473,250,723
22446,6,State - HARYANA,Total,All ages,Secondary,2064923,1161013,3225936
22447,6,State - HARYANA,Total,0-6,Secondary,0,0,0
22448,6,State - HARYANA,Total,7,Secondary,0,0,0
22449,6,State - HARYANA,Total,8,Secondary,0,0,0
22450,6,State - HARYANA,Total,9,Secondary,0,0,0
22451,6,State - HARYANA,Total,10,Secondary,0,0,0
22452,6,State - HARYANA,Total,11,Secondary,0,0,0
22453,6,State - HARYANA,Total,12,Secondary,0,0,0
22454,6,State - HARYANA,Total,13,Secondary,0,0,0
22455,6,State - HARYANA,Total,14,Secondary,0,0,0
22456,6,State - HARYANA,Total,15,Secondary,68771,56730,125501
22457,6,State - HARYANA,Total,16,Secondary,138822,110775,249597
22458,6,State - HARYANA,Total,17,Secondary,168266,128627,296893
22459,6,State - HARYANA,Total,18,Secondary,94512,64395,158907
22460,6,State - HARYANA,Total,19,Secondary,52309,36896,89205
22461,6,State - HARYANA,Total,20-24,Secondary,216210,171391,387601
22462,6,State - HARYANA,Total,25-29,Secondary,219096,151587,370683
22463,6,State - HARYANA,Total,30-34,Secondary,201748,125017,326765
22464,6,State - HARYANA,Total,35-39,Secondary,205698,101376,307074
22465,6,State - HARYANA,Total,40-44,Secondary,180898,69092,249990
22466,6,State - HARYANA,Total,45-49,Secondary,147795,49240,197035
22467,6,State - HARYANA,Total,50-54,Secondary,116198,36376,152574
22468,6,State - HARYANA,Total,55-59,Secondary,89241,24743,113984
22469,6,State - HARYANA,Total,60-64,Secondary,74159,16492,90651
22470,6,State - HARYANA,Total,65-69,Secondary,42781,8545,51326
22471,6,State - HARYANA,Total,70-74,Secondary,25371,4239,29610
22472,6,State - HARYANA,Total,75-79,Secondary,11037,1760,12797
22473,6,State - HARYANA,Total,80+,Secondary,10071,2540,12611
22474,6,State - HARYANA,Total,Age not stated,Secondary,1940,1192,3132
22475,6,State - HARYANA,Rural,All ages,Secondary,1300547,662219,1962766
22476,6,State - HARYANA,Rural,0-6,Secondary,0,0,0
22477,6,State - HARYANA,Rural,7,Secondary,0,0,0
22478,6,State - HARYANA,Rural,8,Secondary,0,0,0
22479,6,State - HARYANA,Rural,9,Secondary,0,0,0
22480,6,State - HARYANA,Rural,10,Secondary,0,0,0
22481,6,State - HARYANA,Rural,11,Secondary,0,0,0
22482,6,State - HARYANA,Rural,12,Secondary,0,0,0
22483,6,State - HARYANA,Rural,13,Secondary,0,0,0
22484,6,State - HARYANA,Rural,14,Secondary,0,0,0
22485,6,State - HARYANA,Rural,15,Secondary,43589,34638,78227
22486,6,State - HARYANA,Rural,16,Secondary,89251,69911,159162
22487,6,State - HARYANA,Rural,17,Secondary,108486,80626,189112
22488,6,State - HARYANA,Rural,18,Secondary,65280,45092,110372
22489,6,State - HARYANA,Rural,19,Secondary,36513,26751,63264
22490,6,State - HARYANA,Rural,20-24,Secondary,146443,119409,265852
22491,6,State - HARYANA,Rural,25-29,Secondary,143394,97218,240612
22492,6,State - HARYANA,Rural,30-34,Secondary,128173,73918,202091
22493,6,State - HARYANA,Rural,35-39,Secondary,133558,52320,185878
22494,6,State - HARYANA,Rural,40-44,Secondary,113652,27054,140706
22495,6,State - HARYANA,Rural,45-49,Secondary,86891,13953,100844
22496,6,State - HARYANA,Rural,50-54,Secondary,65300,8884,74184
22497,6,State - HARYANA,Rural,55-59,Secondary,50611,5415,56026
22498,6,State - HARYANA,Rural,60-64,Secondary,42491,2972,45463
22499,6,State - HARYANA,Rural,65-69,Secondary,23153,1677,24830
22500,6,State - HARYANA,Rural,70-74,Secondary,12977,641,13618
22501,6,State - HARYANA,Rural,75-79,Secondary,4995,256,5251
22502,6,State - HARYANA,Rural,80+,Secondary,4563,779,5342
22503,6,State - HARYANA,Rural,Age not stated,Secondary,1227,705,1932
22504,6,State - HARYANA,Urban,All ages,Secondary,764376,498794,1263170
22505,6,State - HARYANA,Urban,0-6,Secondary,0,0,0
22506,6,State - HARYANA,Urban,7,Secondary,0,0,0
22507,6,State - HARYANA,Urban,8,Secondary,0,0,0
22508,6,State - HARYANA,Urban,9,Secondary,0,0,0
22509,6,State - HARYANA,Urban,10,Secondary,0,0,0
22510,6,State - HARYANA,Urban,11,Secondary,0,0,0
22511,6,State - HARYANA,Urban,12,Secondary,0,0,0
22512,6,State - HARYANA,Urban,13,Secondary,0,0,0
22513,6,State - HARYANA,Urban,14,Secondary,0,0,0
22514,6,State - HARYANA,Urban,15,Secondary,25182,22092,47274
22515,6,State - HARYANA,Urban,16,Secondary,49571,40864,90435
22516,6,State - HARYANA,Urban,17,Secondary,59780,48001,107781
22517,6,State - HARYANA,Urban,18,Secondary,29232,19303,48535
22518,6,State - HARYANA,Urban,19,Secondary,15796,10145,25941
22519,6,State - HARYANA,Urban,20-24,Secondary,69767,51982,121749
22520,6,State - HARYANA,Urban,25-29,Secondary,75702,54369,130071
22521,6,State - HARYANA,Urban,30-34,Secondary,73575,51099,124674
22522,6,State - HARYANA,Urban,35-39,Secondary,72140,49056,121196
22523,6,State - HARYANA,Urban,40-44,Secondary,67246,42038,109284
22524,6,State - HARYANA,Urban,45-49,Secondary,60904,35287,96191
22525,6,State - HARYANA,Urban,50-54,Secondary,50898,27492,78390
22526,6,State - HARYANA,Urban,55-59,Secondary,38630,19328,57958
22527,6,State - HARYANA,Urban,60-64,Secondary,31668,13520,45188
22528,6,State - HARYANA,Urban,65-69,Secondary,19628,6868,26496
22529,6,State - HARYANA,Urban,70-74,Secondary,12394,3598,15992
22530,6,State - HARYANA,Urban,75-79,Secondary,6042,1504,7546
22531,6,State - HARYANA,Urban,80+,Secondary,5508,1761,7269
22532,6,State - HARYANA,Urban,Age not stated,Secondary,713,487,1200
22533,7,State - NCT OF DELHI,Total,All ages,Secondary,1318133,868181,2186314
22534,7,State - NCT OF DELHI,Total,0-6,Secondary,0,0,0
22535,7,State - NCT OF DELHI,Total,7,Secondary,0,0,0
22536,7,State - NCT OF DELHI,Total,8,Secondary,0,0,0
22537,7,State - NCT OF DELHI,Total,9,Secondary,0,0,0
22538,7,State - NCT OF DELHI,Total,10,Secondary,0,0,0
22539,7,State - NCT OF DELHI,Total,11,Secondary,0,0,0
22540,7,State - NCT OF DELHI,Total,12,Secondary,0,0,0
22541,7,State - NCT OF DELHI,Total,13,Secondary,0,0,0
22542,7,State - NCT OF DELHI,Total,14,Secondary,0,0,0
22543,7,State - NCT OF DELHI,Total,15,Secondary,34313,32157,66470
22544,7,State - NCT OF DELHI,Total,16,Secondary,73999,67191,141190
22545,7,State - NCT OF DELHI,Total,17,Secondary,98175,84783,182958
22546,7,State - NCT OF DELHI,Total,18,Secondary,62011,44900,106911
22547,7,State - NCT OF DELHI,Total,19,Secondary,34601,23954,58555
22548,7,State - NCT OF DELHI,Total,20-24,Secondary,143996,107178,251174
22549,7,State - NCT OF DELHI,Total,25-29,Secondary,151159,104802,255961
22550,7,State - NCT OF DELHI,Total,30-34,Secondary,145189,90779,235968
22551,7,State - NCT OF DELHI,Total,35-39,Secondary,137366,78669,216035
22552,7,State - NCT OF DELHI,Total,40-44,Secondary,113213,60976,174189
22553,7,State - NCT OF DELHI,Total,45-49,Secondary,94309,48963,143272
22554,7,State - NCT OF DELHI,Total,50-54,Secondary,70277,37389,107666
22555,7,State - NCT OF DELHI,Total,55-59,Secondary,49156,27406,76562
22556,7,State - NCT OF DELHI,Total,60-64,Secondary,42881,23854,66735
22557,7,State - NCT OF DELHI,Total,65-69,Secondary,27674,15380,43054
22558,7,State - NCT OF DELHI,Total,70-74,Secondary,18780,9626,28406
22559,7,State - NCT OF DELHI,Total,75-79,Secondary,10027,4991,15018
22560,7,State - NCT OF DELHI,Total,80+,Secondary,9958,4562,14520
22561,7,State - NCT OF DELHI,Total,Age not stated,Secondary,1049,621,1670
22562,7,State - NCT OF DELHI,Rural,All ages,Secondary,38776,23150,61926
22563,7,State - NCT OF DELHI,Rural,0-6,Secondary,0,0,0
22564,7,State - NCT OF DELHI,Rural,7,Secondary,0,0,0
22565,7,State - NCT OF DELHI,Rural,8,Secondary,0,0,0
22566,7,State - NCT OF DELHI,Rural,9,Secondary,0,0,0
22567,7,State - NCT OF DELHI,Rural,10,Secondary,0,0,0
22568,7,State - NCT OF DELHI,Rural,11,Secondary,0,0,0
22569,7,State - NCT OF DELHI,Rural,12,Secondary,0,0,0
22570,7,State - NCT OF DELHI,Rural,13,Secondary,0,0,0
22571,7,State - NCT OF DELHI,Rural,14,Secondary,0,0,0
22572,7,State - NCT OF DELHI,Rural,15,Secondary,932,842,1774
22573,7,State - NCT OF DELHI,Rural,16,Secondary,1975,1731,3706
22574,7,State - NCT OF DELHI,Rural,17,Secondary,2600,2027,4627
22575,7,State - NCT OF DELHI,Rural,18,Secondary,1712,1177,2889
22576,7,State - NCT OF DELHI,Rural,19,Secondary,985,697,1682
22577,7,State - NCT OF DELHI,Rural,20-24,Secondary,4291,3379,7670
22578,7,State - NCT OF DELHI,Rural,25-29,Secondary,4521,3440,7961
22579,7,State - NCT OF DELHI,Rural,30-34,Secondary,4570,3182,7752
22580,7,State - NCT OF DELHI,Rural,35-39,Secondary,4189,2614,6803
22581,7,State - NCT OF DELHI,Rural,40-44,Secondary,3436,1622,5058
22582,7,State - NCT OF DELHI,Rural,45-49,Secondary,2951,986,3937
22583,7,State - NCT OF DELHI,Rural,50-54,Secondary,2133,595,2728
22584,7,State - NCT OF DELHI,Rural,55-59,Secondary,1426,365,1791
22585,7,State - NCT OF DELHI,Rural,60-64,Secondary,1378,271,1649
22586,7,State - NCT OF DELHI,Rural,65-69,Secondary,781,113,894
22587,7,State - NCT OF DELHI,Rural,70-74,Secondary,510,38,548
22588,7,State - NCT OF DELHI,Rural,75-79,Secondary,178,14,192
22589,7,State - NCT OF DELHI,Rural,80+,Secondary,181,41,222
22590,7,State - NCT OF DELHI,Rural,Age not stated,Secondary,27,16,43
22591,7,State - NCT OF DELHI,Urban,All ages,Secondary,1279357,845031,2124388
22592,7,State - NCT OF DELHI,Urban,0-6,Secondary,0,0,0
22593,7,State - NCT OF DELHI,Urban,7,Secondary,0,0,0
22594,7,State - NCT OF DELHI,Urban,8,Secondary,0,0,0
22595,7,State - NCT OF DELHI,Urban,9,Secondary,0,0,0
22596,7,State - NCT OF DELHI,Urban,10,Secondary,0,0,0
22597,7,State - NCT OF DELHI,Urban,11,Secondary,0,0,0
22598,7,State - NCT OF DELHI,Urban,12,Secondary,0,0,0
22599,7,State - NCT OF DELHI,Urban,13,Secondary,0,0,0
22600,7,State - NCT OF DELHI,Urban,14,Secondary,0,0,0
22601,7,State - NCT OF DELHI,Urban,15,Secondary,33381,31315,64696
22602,7,State - NCT OF DELHI,Urban,16,Secondary,72024,65460,137484
22603,7,State - NCT OF DELHI,Urban,17,Secondary,95575,82756,178331
22604,7,State - NCT OF DELHI,Urban,18,Secondary,60299,43723,104022
22605,7,State - NCT OF DELHI,Urban,19,Secondary,33616,23257,56873
22606,7,State - NCT OF DELHI,Urban,20-24,Secondary,139705,103799,243504
22607,7,State - NCT OF DELHI,Urban,25-29,Secondary,146638,101362,248000
22608,7,State - NCT OF DELHI,Urban,30-34,Secondary,140619,87597,228216
22609,7,State - NCT OF DELHI,Urban,35-39,Secondary,133177,76055,209232
22610,7,State - NCT OF DELHI,Urban,40-44,Secondary,109777,59354,169131
22611,7,State - NCT OF DELHI,Urban,45-49,Secondary,91358,47977,139335
22612,7,State - NCT OF DELHI,Urban,50-54,Secondary,68144,36794,104938
22613,7,State - NCT OF DELHI,Urban,55-59,Secondary,47730,27041,74771
22614,7,State - NCT OF DELHI,Urban,60-64,Secondary,41503,23583,65086
22615,7,State - NCT OF DELHI,Urban,65-69,Secondary,26893,15267,42160
22616,7,State - NCT OF DELHI,Urban,70-74,Secondary,18270,9588,27858
22617,7,State - NCT OF DELHI,Urban,75-79,Secondary,9849,4977,14826
22618,7,State - NCT OF DELHI,Urban,80+,Secondary,9777,4521,14298
22619,7,State - NCT OF DELHI,Urban,Age not stated,Secondary,1022,605,1627
22620,8,State - RAJASTHAN,Total,All ages,Secondary,3168905,1441280,4610185
22621,8,State - RAJASTHAN,Total,0-6,Secondary,0,0,0
22622,8,State - RAJASTHAN,Total,7,Secondary,0,0,0
22623,8,State - RAJASTHAN,Total,8,Secondary,0,0,0
22624,8,State - RAJASTHAN,Total,9,Secondary,0,0,0
22625,8,State - RAJASTHAN,Total,10,Secondary,0,0,0
22626,8,State - RAJASTHAN,Total,11,Secondary,0,0,0
22627,8,State - RAJASTHAN,Total,12,Secondary,0,0,0
22628,8,State - RAJASTHAN,Total,13,Secondary,0,0,0
22629,8,State - RAJASTHAN,Total,14,Secondary,0,0,0
22630,8,State - RAJASTHAN,Total,15,Secondary,184664,122065,306729
22631,8,State - RAJASTHAN,Total,16,Secondary,297482,192211,489693
22632,8,State - RAJASTHAN,Total,17,Secondary,318701,199861,518562
22633,8,State - RAJASTHAN,Total,18,Secondary,190485,110160,300645
22634,8,State - RAJASTHAN,Total,19,Secondary,97450,60117,157567
22635,8,State - RAJASTHAN,Total,20-24,Secondary,405726,218998,624724
22636,8,State - RAJASTHAN,Total,25-29,Secondary,325533,146294,471827
22637,8,State - RAJASTHAN,Total,30-34,Secondary,286371,107043,393414
22638,8,State - RAJASTHAN,Total,35-39,Secondary,264842,84758,349600
22639,8,State - RAJASTHAN,Total,40-44,Secondary,224015,62609,286624
22640,8,State - RAJASTHAN,Total,45-49,Secondary,170705,46143,216848
22641,8,State - RAJASTHAN,Total,50-54,Secondary,128350,31723,160073
22642,8,State - RAJASTHAN,Total,55-59,Secondary,93869,21257,115126
22643,8,State - RAJASTHAN,Total,60-64,Secondary,73170,14226,87396
22644,8,State - RAJASTHAN,Total,65-69,Secondary,45473,9160,54633
22645,8,State - RAJASTHAN,Total,70-74,Secondary,27379,4741,32120
22646,8,State - RAJASTHAN,Total,75-79,Secondary,12819,2122,14941
22647,8,State - RAJASTHAN,Total,80+,Secondary,11082,2649,13731
22648,8,State - RAJASTHAN,Total,Age not stated,Secondary,10789,5143,15932
22649,8,State - RAJASTHAN,Rural,All ages,Secondary,2044266,747687,2791953
22650,8,State - RAJASTHAN,Rural,0-6,Secondary,0,0,0
22651,8,State - RAJASTHAN,Rural,7,Secondary,0,0,0
22652,8,State - RAJASTHAN,Rural,8,Secondary,0,0,0
22653,8,State - RAJASTHAN,Rural,9,Secondary,0,0,0
22654,8,State - RAJASTHAN,Rural,10,Secondary,0,0,0
22655,8,State - RAJASTHAN,Rural,11,Secondary,0,0,0
22656,8,State - RAJASTHAN,Rural,12,Secondary,0,0,0
22657,8,State - RAJASTHAN,Rural,13,Secondary,0,0,0
22658,8,State - RAJASTHAN,Rural,14,Secondary,0,0,0
22659,8,State - RAJASTHAN,Rural,15,Secondary,128934,75701,204635
22660,8,State - RAJASTHAN,Rural,16,Secondary,208915,120195,329110
22661,8,State - RAJASTHAN,Rural,17,Secondary,218705,121011,339716
22662,8,State - RAJASTHAN,Rural,18,Secondary,142162,75557,217719
22663,8,State - RAJASTHAN,Rural,19,Secondary,71095,40748,111843
22664,8,State - RAJASTHAN,Rural,20-24,Secondary,287531,132325,419856
22665,8,State - RAJASTHAN,Rural,25-29,Secondary,212272,70713,282985
22666,8,State - RAJASTHAN,Rural,30-34,Secondary,181467,43874,225341
22667,8,State - RAJASTHAN,Rural,35-39,Secondary,163890,27415,191305
22668,8,State - RAJASTHAN,Rural,40-44,Secondary,134055,15761,149816
22669,8,State - RAJASTHAN,Rural,45-49,Secondary,95765,8808,104573
22670,8,State - RAJASTHAN,Rural,50-54,Secondary,67462,4814,72276
22671,8,State - RAJASTHAN,Rural,55-59,Secondary,47428,2724,50152
22672,8,State - RAJASTHAN,Rural,60-64,Secondary,36578,1597,38175
22673,8,State - RAJASTHAN,Rural,65-69,Secondary,21005,1611,22616
22674,8,State - RAJASTHAN,Rural,70-74,Secondary,11075,523,11598
22675,8,State - RAJASTHAN,Rural,75-79,Secondary,4318,295,4613
22676,8,State - RAJASTHAN,Rural,80+,Secondary,4024,729,4753
22677,8,State - RAJASTHAN,Rural,Age not stated,Secondary,7585,3286,10871
22678,8,State - RAJASTHAN,Urban,All ages,Secondary,1124639,693593,1818232
22679,8,State - RAJASTHAN,Urban,0-6,Secondary,0,0,0
22680,8,State - RAJASTHAN,Urban,7,Secondary,0,0,0
22681,8,State - RAJASTHAN,Urban,8,Secondary,0,0,0
22682,8,State - RAJASTHAN,Urban,9,Secondary,0,0,0
22683,8,State - RAJASTHAN,Urban,10,Secondary,0,0,0
22684,8,State - RAJASTHAN,Urban,11,Secondary,0,0,0
22685,8,State - RAJASTHAN,Urban,12,Secondary,0,0,0
22686,8,State - RAJASTHAN,Urban,13,Secondary,0,0,0
22687,8,State - RAJASTHAN,Urban,14,Secondary,0,0,0
22688,8,State - RAJASTHAN,Urban,15,Secondary,55730,46364,102094
22689,8,State - RAJASTHAN,Urban,16,Secondary,88567,72016,160583
22690,8,State - RAJASTHAN,Urban,17,Secondary,99996,78850,178846
22691,8,State - RAJASTHAN,Urban,18,Secondary,48323,34603,82926
22692,8,State - RAJASTHAN,Urban,19,Secondary,26355,19369,45724
22693,8,State - RAJASTHAN,Urban,20-24,Secondary,118195,86673,204868
22694,8,State - RAJASTHAN,Urban,25-29,Secondary,113261,75581,188842
22695,8,State - RAJASTHAN,Urban,30-34,Secondary,104904,63169,168073
22696,8,State - RAJASTHAN,Urban,35-39,Secondary,100952,57343,158295
22697,8,State - RAJASTHAN,Urban,40-44,Secondary,89960,46848,136808
22698,8,State - RAJASTHAN,Urban,45-49,Secondary,74940,37335,112275
22699,8,State - RAJASTHAN,Urban,50-54,Secondary,60888,26909,87797
22700,8,State - RAJASTHAN,Urban,55-59,Secondary,46441,18533,64974
22701,8,State - RAJASTHAN,Urban,60-64,Secondary,36592,12629,49221
22702,8,State - RAJASTHAN,Urban,65-69,Secondary,24468,7549,32017
22703,8,State - RAJASTHAN,Urban,70-74,Secondary,16304,4218,20522
22704,8,State - RAJASTHAN,Urban,75-79,Secondary,8501,1827,10328
22705,8,State - RAJASTHAN,Urban,80+,Secondary,7058,1920,8978
22706,8,State - RAJASTHAN,Urban,Age not stated,Secondary,3204,1857,5061
22707,9,State - UTTAR PRADESH,Total,All ages,Secondary,9748121,5389194,15137315
22708,9,State - UTTAR PRADESH,Total,0-6,Secondary,0,0,0
22709,9,State - UTTAR PRADESH,Total,7,Secondary,0,0,0
22710,9,State - UTTAR PRADESH,Total,8,Secondary,0,0,0
22711,9,State - UTTAR PRADESH,Total,9,Secondary,0,0,0
22712,9,State - UTTAR PRADESH,Total,10,Secondary,0,0,0
22713,9,State - UTTAR PRADESH,Total,11,Secondary,0,0,0
22714,9,State - UTTAR PRADESH,Total,12,Secondary,0,0,0
22715,9,State - UTTAR PRADESH,Total,13,Secondary,0,0,0
22716,9,State - UTTAR PRADESH,Total,14,Secondary,0,0,0
22717,9,State - UTTAR PRADESH,Total,15,Secondary,549826,483556,1033382
22718,9,State - UTTAR PRADESH,Total,16,Secondary,852040,768257,1620297
22719,9,State - UTTAR PRADESH,Total,17,Secondary,907157,790421,1697578
22720,9,State - UTTAR PRADESH,Total,18,Secondary,637362,427043,1064405
22721,9,State - UTTAR PRADESH,Total,19,Secondary,311937,200373,512310
22722,9,State - UTTAR PRADESH,Total,20-24,Secondary,1234061,714097,1948158
22723,9,State - UTTAR PRADESH,Total,25-29,Secondary,995494,518248,1513742
22724,9,State - UTTAR PRADESH,Total,30-34,Secondary,845147,403967,1249114
22725,9,State - UTTAR PRADESH,Total,35-39,Secondary,841181,337754,1178935
22726,9,State - UTTAR PRADESH,Total,40-44,Secondary,672917,228421,901338
22727,9,State - UTTAR PRADESH,Total,45-49,Secondary,519599,163136,682735
22728,9,State - UTTAR PRADESH,Total,50-54,Secondary,387194,105918,493112
22729,9,State - UTTAR PRADESH,Total,55-59,Secondary,286092,74943,361035
22730,9,State - UTTAR PRADESH,Total,60-64,Secondary,257823,52887,310710
22731,9,State - UTTAR PRADESH,Total,65-69,Secondary,166047,36365,202412
22732,9,State - UTTAR PRADESH,Total,70-74,Secondary,109911,18039,127950
22733,9,State - UTTAR PRADESH,Total,75-79,Secondary,48651,10238,58889
22734,9,State - UTTAR PRADESH,Total,80+,Secondary,59209,20141,79350
22735,9,State - UTTAR PRADESH,Total,Age not stated,Secondary,66473,35390,101863
22736,9,State - UTTAR PRADESH,Rural,All ages,Secondary,7193250,3566675,10759925
22737,9,State - UTTAR PRADESH,Rural,0-6,Secondary,0,0,0
22738,9,State - UTTAR PRADESH,Rural,7,Secondary,0,0,0
22739,9,State - UTTAR PRADESH,Rural,8,Secondary,0,0,0
22740,9,State - UTTAR PRADESH,Rural,9,Secondary,0,0,0
22741,9,State - UTTAR PRADESH,Rural,10,Secondary,0,0,0
22742,9,State - UTTAR PRADESH,Rural,11,Secondary,0,0,0
22743,9,State - UTTAR PRADESH,Rural,12,Secondary,0,0,0
22744,9,State - UTTAR PRADESH,Rural,13,Secondary,0,0,0
22745,9,State - UTTAR PRADESH,Rural,14,Secondary,0,0,0
22746,9,State - UTTAR PRADESH,Rural,15,Secondary,404177,339903,744080
22747,9,State - UTTAR PRADESH,Rural,16,Secondary,637530,554671,1192201
22748,9,State - UTTAR PRADESH,Rural,17,Secondary,665685,560814,1226499
22749,9,State - UTTAR PRADESH,Rural,18,Secondary,502074,326382,828456
22750,9,State - UTTAR PRADESH,Rural,19,Secondary,237447,147704,385151
22751,9,State - UTTAR PRADESH,Rural,20-24,Secondary,930681,507436,1438117
22752,9,State - UTTAR PRADESH,Rural,25-29,Secondary,733962,343841,1077803
22753,9,State - UTTAR PRADESH,Rural,30-34,Secondary,621611,255324,876935
22754,9,State - UTTAR PRADESH,Rural,35-39,Secondary,625696,194817,820513
22755,9,State - UTTAR PRADESH,Rural,40-44,Secondary,494077,117965,612042
22756,9,State - UTTAR PRADESH,Rural,45-49,Secondary,370532,73898,444430
22757,9,State - UTTAR PRADESH,Rural,50-54,Secondary,273490,43329,316819
22758,9,State - UTTAR PRADESH,Rural,55-59,Secondary,199788,28039,227827
22759,9,State - UTTAR PRADESH,Rural,60-64,Secondary,186187,17644,203831
22760,9,State - UTTAR PRADESH,Rural,65-69,Secondary,117965,14205,132170
22761,9,State - UTTAR PRADESH,Rural,70-74,Secondary,76593,5555,82148
22762,9,State - UTTAR PRADESH,Rural,75-79,Secondary,32238,3677,35915
22763,9,State - UTTAR PRADESH,Rural,80+,Secondary,38365,10289,48654
22764,9,State - UTTAR PRADESH,Rural,Age not stated,Secondary,45152,21182,66334
22765,9,State - UTTAR PRADESH,Urban,All ages,Secondary,2554871,1822519,4377390
22766,9,State - UTTAR PRADESH,Urban,0-6,Secondary,0,0,0
22767,9,State - UTTAR PRADESH,Urban,7,Secondary,0,0,0
22768,9,State - UTTAR PRADESH,Urban,8,Secondary,0,0,0
22769,9,State - UTTAR PRADESH,Urban,9,Secondary,0,0,0
22770,9,State - UTTAR PRADESH,Urban,10,Secondary,0,0,0
22771,9,State - UTTAR PRADESH,Urban,11,Secondary,0,0,0
22772,9,State - UTTAR PRADESH,Urban,12,Secondary,0,0,0
22773,9,State - UTTAR PRADESH,Urban,13,Secondary,0,0,0
22774,9,State - UTTAR PRADESH,Urban,14,Secondary,0,0,0
22775,9,State - UTTAR PRADESH,Urban,15,Secondary,145649,143653,289302
22776,9,State - UTTAR PRADESH,Urban,16,Secondary,214510,213586,428096
22777,9,State - UTTAR PRADESH,Urban,17,Secondary,241472,229607,471079
22778,9,State - UTTAR PRADESH,Urban,18,Secondary,135288,100661,235949
22779,9,State - UTTAR PRADESH,Urban,19,Secondary,74490,52669,127159
22780,9,State - UTTAR PRADESH,Urban,20-24,Secondary,303380,206661,510041
22781,9,State - UTTAR PRADESH,Urban,25-29,Secondary,261532,174407,435939
22782,9,State - UTTAR PRADESH,Urban,30-34,Secondary,223536,148643,372179
22783,9,State - UTTAR PRADESH,Urban,35-39,Secondary,215485,142937,358422
22784,9,State - UTTAR PRADESH,Urban,40-44,Secondary,178840,110456,289296
22785,9,State - UTTAR PRADESH,Urban,45-49,Secondary,149067,89238,238305
22786,9,State - UTTAR PRADESH,Urban,50-54,Secondary,113704,62589,176293
22787,9,State - UTTAR PRADESH,Urban,55-59,Secondary,86304,46904,133208
22788,9,State - UTTAR PRADESH,Urban,60-64,Secondary,71636,35243,106879
22789,9,State - UTTAR PRADESH,Urban,65-69,Secondary,48082,22160,70242
22790,9,State - UTTAR PRADESH,Urban,70-74,Secondary,33318,12484,45802
22791,9,State - UTTAR PRADESH,Urban,75-79,Secondary,16413,6561,22974
22792,9,State - UTTAR PRADESH,Urban,80+,Secondary,20844,9852,30696
22793,9,State - UTTAR PRADESH,Urban,Age not stated,Secondary,21321,14208,35529
22794,10,State - BIHAR,Total,All ages,Secondary,4785058,2481070,7266128
22795,10,State - BIHAR,Total,0-6,Secondary,0,0,0
22796,10,State - BIHAR,Total,7,Secondary,0,0,0
22797,10,State - BIHAR,Total,8,Secondary,0,0,0
22798,10,State - BIHAR,Total,9,Secondary,0,0,0
22799,10,State - BIHAR,Total,10,Secondary,0,0,0
22800,10,State - BIHAR,Total,11,Secondary,0,0,0
22801,10,State - BIHAR,Total,12,Secondary,0,0,0
22802,10,State - BIHAR,Total,13,Secondary,0,0,0
22803,10,State - BIHAR,Total,14,Secondary,0,0,0
22804,10,State - BIHAR,Total,15,Secondary,233252,169659,402911
22805,10,State - BIHAR,Total,16,Secondary,339073,247630,586703
22806,10,State - BIHAR,Total,17,Secondary,323291,223066,546357
22807,10,State - BIHAR,Total,18,Secondary,232410,149950,382360
22808,10,State - BIHAR,Total,19,Secondary,116572,82876,199448
22809,10,State - BIHAR,Total,20-24,Secondary,561135,371893,933028
22810,10,State - BIHAR,Total,25-29,Secondary,517146,325837,842983
22811,10,State - BIHAR,Total,30-34,Secondary,498551,282775,781326
22812,10,State - BIHAR,Total,35-39,Secondary,452200,218370,670570
22813,10,State - BIHAR,Total,40-44,Secondary,366821,141468,508289
22814,10,State - BIHAR,Total,45-49,Secondary,285771,94224,379995
22815,10,State - BIHAR,Total,50-54,Secondary,225895,57955,283850
22816,10,State - BIHAR,Total,55-59,Secondary,180854,41796,222650
22817,10,State - BIHAR,Total,60-64,Secondary,174563,28847,203410
22818,10,State - BIHAR,Total,65-69,Secondary,122826,17807,140633
22819,10,State - BIHAR,Total,70-74,Secondary,75710,8076,83786
22820,10,State - BIHAR,Total,75-79,Secondary,31200,3736,34936
22821,10,State - BIHAR,Total,80+,Secondary,32235,6775,39010
22822,10,State - BIHAR,Total,Age not stated,Secondary,15553,8330,23883
22823,10,State - BIHAR,Rural,All ages,Secondary,4063729,1910999,5974728
22824,10,State - BIHAR,Rural,0-6,Secondary,0,0,0
22825,10,State - BIHAR,Rural,7,Secondary,0,0,0
22826,10,State - BIHAR,Rural,8,Secondary,0,0,0
22827,10,State - BIHAR,Rural,9,Secondary,0,0,0
22828,10,State - BIHAR,Rural,10,Secondary,0,0,0
22829,10,State - BIHAR,Rural,11,Secondary,0,0,0
22830,10,State - BIHAR,Rural,12,Secondary,0,0,0
22831,10,State - BIHAR,Rural,13,Secondary,0,0,0
22832,10,State - BIHAR,Rural,14,Secondary,0,0,0
22833,10,State - BIHAR,Rural,15,Secondary,190759,132246,323005
22834,10,State - BIHAR,Rural,16,Secondary,278005,192838,470843
22835,10,State - BIHAR,Rural,17,Secondary,260450,169734,430184
22836,10,State - BIHAR,Rural,18,Secondary,200901,124408,325309
22837,10,State - BIHAR,Rural,19,Secondary,100375,68918,169293
22838,10,State - BIHAR,Rural,20-24,Secondary,488238,306846,795084
22839,10,State - BIHAR,Rural,25-29,Secondary,449446,259896,709342
22840,10,State - BIHAR,Rural,30-34,Secondary,433385,220878,654263
22841,10,State - BIHAR,Rural,35-39,Secondary,394024,165547,559571
22842,10,State - BIHAR,Rural,40-44,Secondary,314987,101120,416107
22843,10,State - BIHAR,Rural,45-49,Secondary,240187,62046,302233
22844,10,State - BIHAR,Rural,50-54,Secondary,187374,35412,222786
22845,10,State - BIHAR,Rural,55-59,Secondary,149585,25186,174771
22846,10,State - BIHAR,Rural,60-64,Secondary,147135,17065,164200
22847,10,State - BIHAR,Rural,65-69,Secondary,103048,11071,114119
22848,10,State - BIHAR,Rural,70-74,Secondary,62234,4829,67063
22849,10,State - BIHAR,Rural,75-79,Secondary,24912,2189,27101
22850,10,State - BIHAR,Rural,80+,Secondary,26082,4709,30791
22851,10,State - BIHAR,Rural,Age not stated,Secondary,12602,6061,18663
22852,10,State - BIHAR,Urban,All ages,Secondary,721329,570071,1291400
22853,10,State - BIHAR,Urban,0-6,Secondary,0,0,0
22854,10,State - BIHAR,Urban,7,Secondary,0,0,0
22855,10,State - BIHAR,Urban,8,Secondary,0,0,0
22856,10,State - BIHAR,Urban,9,Secondary,0,0,0
22857,10,State - BIHAR,Urban,10,Secondary,0,0,0
22858,10,State - BIHAR,Urban,11,Secondary,0,0,0
22859,10,State - BIHAR,Urban,12,Secondary,0,0,0
22860,10,State - BIHAR,Urban,13,Secondary,0,0,0
22861,10,State - BIHAR,Urban,14,Secondary,0,0,0
22862,10,State - BIHAR,Urban,15,Secondary,42493,37413,79906
22863,10,State - BIHAR,Urban,16,Secondary,61068,54792,115860
22864,10,State - BIHAR,Urban,17,Secondary,62841,53332,116173
22865,10,State - BIHAR,Urban,18,Secondary,31509,25542,57051
22866,10,State - BIHAR,Urban,19,Secondary,16197,13958,30155
22867,10,State - BIHAR,Urban,20-24,Secondary,72897,65047,137944
22868,10,State - BIHAR,Urban,25-29,Secondary,67700,65941,133641
22869,10,State - BIHAR,Urban,30-34,Secondary,65166,61897,127063
22870,10,State - BIHAR,Urban,35-39,Secondary,58176,52823,110999
22871,10,State - BIHAR,Urban,40-44,Secondary,51834,40348,92182
22872,10,State - BIHAR,Urban,45-49,Secondary,45584,32178,77762
22873,10,State - BIHAR,Urban,50-54,Secondary,38521,22543,61064
22874,10,State - BIHAR,Urban,55-59,Secondary,31269,16610,47879
22875,10,State - BIHAR,Urban,60-64,Secondary,27428,11782,39210
22876,10,State - BIHAR,Urban,65-69,Secondary,19778,6736,26514
22877,10,State - BIHAR,Urban,70-74,Secondary,13476,3247,16723
22878,10,State - BIHAR,Urban,75-79,Secondary,6288,1547,7835
22879,10,State - BIHAR,Urban,80+,Secondary,6153,2066,8219
22880,10,State - BIHAR,Urban,Age not stated,Secondary,2951,2269,5220
22881,11,State - SIKKIM,Total,All ages,Secondary,31220,22048,53268
22882,11,State - SIKKIM,Total,0-6,Secondary,0,0,0
22883,11,State - SIKKIM,Total,7,Secondary,0,0,0
22884,11,State - SIKKIM,Total,8,Secondary,0,0,0
22885,11,State - SIKKIM,Total,9,Secondary,0,0,0
22886,11,State - SIKKIM,Total,10,Secondary,0,0,0
22887,11,State - SIKKIM,Total,11,Secondary,0,0,0
22888,11,State - SIKKIM,Total,12,Secondary,0,0,0
22889,11,State - SIKKIM,Total,13,Secondary,0,0,0
22890,11,State - SIKKIM,Total,14,Secondary,0,0,0
22891,11,State - SIKKIM,Total,15,Secondary,562,654,1216
22892,11,State - SIKKIM,Total,16,Secondary,1108,1167,2275
22893,11,State - SIKKIM,Total,17,Secondary,1729,1697,3426
22894,11,State - SIKKIM,Total,18,Secondary,1374,1449,2823
22895,11,State - SIKKIM,Total,19,Secondary,1140,1090,2230
22896,11,State - SIKKIM,Total,20-24,Secondary,4425,3904,8329
22897,11,State - SIKKIM,Total,25-29,Secondary,4882,3013,7895
22898,11,State - SIKKIM,Total,30-34,Secondary,4609,2723,7332
22899,11,State - SIKKIM,Total,35-39,Secondary,3438,2311,5749
22900,11,State - SIKKIM,Total,40-44,Secondary,2977,1610,4587
22901,11,State - SIKKIM,Total,45-49,Secondary,1953,1021,2974
22902,11,State - SIKKIM,Total,50-54,Secondary,1227,688,1915
22903,11,State - SIKKIM,Total,55-59,Secondary,723,327,1050
22904,11,State - SIKKIM,Total,60-64,Secondary,373,121,494
22905,11,State - SIKKIM,Total,65-69,Secondary,257,117,374
22906,11,State - SIKKIM,Total,70-74,Secondary,176,43,219
22907,11,State - SIKKIM,Total,75-79,Secondary,76,26,102
22908,11,State - SIKKIM,Total,80+,Secondary,138,40,178
22909,11,State - SIKKIM,Total,Age not stated,Secondary,53,47,100
22910,11,State - SIKKIM,Rural,All ages,Secondary,20731,13341,34072
22911,11,State - SIKKIM,Rural,0-6,Secondary,0,0,0
22912,11,State - SIKKIM,Rural,7,Secondary,0,0,0
22913,11,State - SIKKIM,Rural,8,Secondary,0,0,0
22914,11,State - SIKKIM,Rural,9,Secondary,0,0,0
22915,11,State - SIKKIM,Rural,10,Secondary,0,0,0
22916,11,State - SIKKIM,Rural,11,Secondary,0,0,0
22917,11,State - SIKKIM,Rural,12,Secondary,0,0,0
22918,11,State - SIKKIM,Rural,13,Secondary,0,0,0
22919,11,State - SIKKIM,Rural,14,Secondary,0,0,0
22920,11,State - SIKKIM,Rural,15,Secondary,355,409,764
22921,11,State - SIKKIM,Rural,16,Secondary,683,738,1421
22922,11,State - SIKKIM,Rural,17,Secondary,1073,1071,2144
22923,11,State - SIKKIM,Rural,18,Secondary,911,987,1898
22924,11,State - SIKKIM,Rural,19,Secondary,786,785,1571
22925,11,State - SIKKIM,Rural,20-24,Secondary,3248,2775,6023
22926,11,State - SIKKIM,Rural,25-29,Secondary,3527,1859,5386
22927,11,State - SIKKIM,Rural,30-34,Secondary,3197,1580,4777
22928,11,State - SIKKIM,Rural,35-39,Secondary,2182,1289,3471
22929,11,State - SIKKIM,Rural,40-44,Secondary,1935,833,2768
22930,11,State - SIKKIM,Rural,45-49,Secondary,1172,467,1639
22931,11,State - SIKKIM,Rural,50-54,Secondary,689,275,964
22932,11,State - SIKKIM,Rural,55-59,Secondary,389,110,499
22933,11,State - SIKKIM,Rural,60-64,Secondary,195,39,234
22934,11,State - SIKKIM,Rural,65-69,Secondary,141,43,184
22935,11,State - SIKKIM,Rural,70-74,Secondary,84,18,102
22936,11,State - SIKKIM,Rural,75-79,Secondary,39,7,46
22937,11,State - SIKKIM,Rural,80+,Secondary,90,21,111
22938,11,State - SIKKIM,Rural,Age not stated,Secondary,35,35,70
22939,11,State - SIKKIM,Urban,All ages,Secondary,10489,8707,19196
22940,11,State - SIKKIM,Urban,0-6,Secondary,0,0,0
22941,11,State - SIKKIM,Urban,7,Secondary,0,0,0
22942,11,State - SIKKIM,Urban,8,Secondary,0,0,0
22943,11,State - SIKKIM,Urban,9,Secondary,0,0,0
22944,11,State - SIKKIM,Urban,10,Secondary,0,0,0
22945,11,State - SIKKIM,Urban,11,Secondary,0,0,0
22946,11,State - SIKKIM,Urban,12,Secondary,0,0,0
22947,11,State - SIKKIM,Urban,13,Secondary,0,0,0
22948,11,State - SIKKIM,Urban,14,Secondary,0,0,0
22949,11,State - SIKKIM,Urban,15,Secondary,207,245,452
22950,11,State - SIKKIM,Urban,16,Secondary,425,429,854
22951,11,State - SIKKIM,Urban,17,Secondary,656,626,1282
22952,11,State - SIKKIM,Urban,18,Secondary,463,462,925
22953,11,State - SIKKIM,Urban,19,Secondary,354,305,659
22954,11,State - SIKKIM,Urban,20-24,Secondary,1177,1129,2306
22955,11,State - SIKKIM,Urban,25-29,Secondary,1355,1154,2509
22956,11,State - SIKKIM,Urban,30-34,Secondary,1412,1143,2555
22957,11,State - SIKKIM,Urban,35-39,Secondary,1256,1022,2278
22958,11,State - SIKKIM,Urban,40-44,Secondary,1042,777,1819
22959,11,State - SIKKIM,Urban,45-49,Secondary,781,554,1335
22960,11,State - SIKKIM,Urban,50-54,Secondary,538,413,951
22961,11,State - SIKKIM,Urban,55-59,Secondary,334,217,551
22962,11,State - SIKKIM,Urban,60-64,Secondary,178,82,260
22963,11,State - SIKKIM,Urban,65-69,Secondary,116,74,190
22964,11,State - SIKKIM,Urban,70-74,Secondary,92,25,117
22965,11,State - SIKKIM,Urban,75-79,Secondary,37,19,56
22966,11,State - SIKKIM,Urban,80+,Secondary,48,19,67
22967,11,State - SIKKIM,Urban,Age not stated,Secondary,18,12,30
22968,12,State - ARUNACHAL PRADESH,Total,All ages,Secondary,65757,43547,109304
22969,12,State - ARUNACHAL PRADESH,Total,0-6,Secondary,0,0,0
22970,12,State - ARUNACHAL PRADESH,Total,7,Secondary,0,0,0
22971,12,State - ARUNACHAL PRADESH,Total,8,Secondary,0,0,0
22972,12,State - ARUNACHAL PRADESH,Total,9,Secondary,0,0,0
22973,12,State - ARUNACHAL PRADESH,Total,10,Secondary,0,0,0
22974,12,State - ARUNACHAL PRADESH,Total,11,Secondary,0,0,0
22975,12,State - ARUNACHAL PRADESH,Total,12,Secondary,0,0,0
22976,12,State - ARUNACHAL PRADESH,Total,13,Secondary,0,0,0
22977,12,State - ARUNACHAL PRADESH,Total,14,Secondary,0,0,0
22978,12,State - ARUNACHAL PRADESH,Total,15,Secondary,2558,2418,4976
22979,12,State - ARUNACHAL PRADESH,Total,16,Secondary,4161,4063,8224
22980,12,State - ARUNACHAL PRADESH,Total,17,Secondary,5066,4894,9960
22981,12,State - ARUNACHAL PRADESH,Total,18,Secondary,3841,3513,7354
22982,12,State - ARUNACHAL PRADESH,Total,19,Secondary,2619,2374,4993
22983,12,State - ARUNACHAL PRADESH,Total,20-24,Secondary,10799,8547,19346
22984,12,State - ARUNACHAL PRADESH,Total,25-29,Secondary,9451,5824,15275
22985,12,State - ARUNACHAL PRADESH,Total,30-34,Secondary,7809,4294,12103
22986,12,State - ARUNACHAL PRADESH,Total,35-39,Secondary,6362,3420,9782
22987,12,State - ARUNACHAL PRADESH,Total,40-44,Secondary,5535,2048,7583
22988,12,State - ARUNACHAL PRADESH,Total,45-49,Secondary,3463,1166,4629
22989,12,State - ARUNACHAL PRADESH,Total,50-54,Secondary,2026,492,2518
22990,12,State - ARUNACHAL PRADESH,Total,55-59,Secondary,927,154,1081
22991,12,State - ARUNACHAL PRADESH,Total,60-64,Secondary,457,96,553
22992,12,State - ARUNACHAL PRADESH,Total,65-69,Secondary,265,80,345
22993,12,State - ARUNACHAL PRADESH,Total,70-74,Secondary,114,25,139
22994,12,State - ARUNACHAL PRADESH,Total,75-79,Secondary,50,19,69
22995,12,State - ARUNACHAL PRADESH,Total,80+,Secondary,184,86,270
22996,12,State - ARUNACHAL PRADESH,Total,Age not stated,Secondary,70,34,104
22997,12,State - ARUNACHAL PRADESH,Rural,All ages,Secondary,40256,26007,66263
22998,12,State - ARUNACHAL PRADESH,Rural,0-6,Secondary,0,0,0
22999,12,State - ARUNACHAL PRADESH,Rural,7,Secondary,0,0,0
23000,12,State - ARUNACHAL PRADESH,Rural,8,Secondary,0,0,0
23001,12,State - ARUNACHAL PRADESH,Rural,9,Secondary,0,0,0
23002,12,State - ARUNACHAL PRADESH,Rural,10,Secondary,0,0,0
23003,12,State - ARUNACHAL PRADESH,Rural,11,Secondary,0,0,0
23004,12,State - ARUNACHAL PRADESH,Rural,12,Secondary,0,0,0
23005,12,State - ARUNACHAL PRADESH,Rural,13,Secondary,0,0,0
23006,12,State - ARUNACHAL PRADESH,Rural,14,Secondary,0,0,0
23007,12,State - ARUNACHAL PRADESH,Rural,15,Secondary,1653,1516,3169
23008,12,State - ARUNACHAL PRADESH,Rural,16,Secondary,2570,2350,4920
23009,12,State - ARUNACHAL PRADESH,Rural,17,Secondary,3068,2803,5871
23010,12,State - ARUNACHAL PRADESH,Rural,18,Secondary,2547,2300,4847
23011,12,State - ARUNACHAL PRADESH,Rural,19,Secondary,1811,1568,3379
23012,12,State - ARUNACHAL PRADESH,Rural,20-24,Secondary,7374,5814,13188
23013,12,State - ARUNACHAL PRADESH,Rural,25-29,Secondary,5612,3555,9167
23014,12,State - ARUNACHAL PRADESH,Rural,30-34,Secondary,4574,2407,6981
23015,12,State - ARUNACHAL PRADESH,Rural,35-39,Secondary,3759,1754,5513
23016,12,State - ARUNACHAL PRADESH,Rural,40-44,Secondary,3089,960,4049
23017,12,State - ARUNACHAL PRADESH,Rural,45-49,Secondary,1914,535,2449
23018,12,State - ARUNACHAL PRADESH,Rural,50-54,Secondary,1139,211,1350
23019,12,State - ARUNACHAL PRADESH,Rural,55-59,Secondary,451,55,506
23020,12,State - ARUNACHAL PRADESH,Rural,60-64,Secondary,272,49,321
23021,12,State - ARUNACHAL PRADESH,Rural,65-69,Secondary,172,41,213
23022,12,State - ARUNACHAL PRADESH,Rural,70-74,Secondary,72,14,86
23023,12,State - ARUNACHAL PRADESH,Rural,75-79,Secondary,28,10,38
23024,12,State - ARUNACHAL PRADESH,Rural,80+,Secondary,106,47,153
23025,12,State - ARUNACHAL PRADESH,Rural,Age not stated,Secondary,45,18,63
23026,12,State - ARUNACHAL PRADESH,Urban,All ages,Secondary,25501,17540,43041
23027,12,State - ARUNACHAL PRADESH,Urban,0-6,Secondary,0,0,0
23028,12,State - ARUNACHAL PRADESH,Urban,7,Secondary,0,0,0
23029,12,State - ARUNACHAL PRADESH,Urban,8,Secondary,0,0,0
23030,12,State - ARUNACHAL PRADESH,Urban,9,Secondary,0,0,0
23031,12,State - ARUNACHAL PRADESH,Urban,10,Secondary,0,0,0
23032,12,State - ARUNACHAL PRADESH,Urban,11,Secondary,0,0,0
23033,12,State - ARUNACHAL PRADESH,Urban,12,Secondary,0,0,0
23034,12,State - ARUNACHAL PRADESH,Urban,13,Secondary,0,0,0
23035,12,State - ARUNACHAL PRADESH,Urban,14,Secondary,0,0,0
23036,12,State - ARUNACHAL PRADESH,Urban,15,Secondary,905,902,1807
23037,12,State - ARUNACHAL PRADESH,Urban,16,Secondary,1591,1713,3304
23038,12,State - ARUNACHAL PRADESH,Urban,17,Secondary,1998,2091,4089
23039,12,State - ARUNACHAL PRADESH,Urban,18,Secondary,1294,1213,2507
23040,12,State - ARUNACHAL PRADESH,Urban,19,Secondary,808,806,1614
23041,12,State - ARUNACHAL PRADESH,Urban,20-24,Secondary,3425,2733,6158
23042,12,State - ARUNACHAL PRADESH,Urban,25-29,Secondary,3839,2269,6108
23043,12,State - ARUNACHAL PRADESH,Urban,30-34,Secondary,3235,1887,5122
23044,12,State - ARUNACHAL PRADESH,Urban,35-39,Secondary,2603,1666,4269
23045,12,State - ARUNACHAL PRADESH,Urban,40-44,Secondary,2446,1088,3534
23046,12,State - ARUNACHAL PRADESH,Urban,45-49,Secondary,1549,631,2180
23047,12,State - ARUNACHAL PRADESH,Urban,50-54,Secondary,887,281,1168
23048,12,State - ARUNACHAL PRADESH,Urban,55-59,Secondary,476,99,575
23049,12,State - ARUNACHAL PRADESH,Urban,60-64,Secondary,185,47,232
23050,12,State - ARUNACHAL PRADESH,Urban,65-69,Secondary,93,39,132
23051,12,State - ARUNACHAL PRADESH,Urban,70-74,Secondary,42,11,53
23052,12,State - ARUNACHAL PRADESH,Urban,75-79,Secondary,22,9,31
23053,12,State - ARUNACHAL PRADESH,Urban,80+,Secondary,78,39,117
23054,12,State - ARUNACHAL PRADESH,Urban,Age not stated,Secondary,25,16,41
23055,13,State - NAGALAND,Total,All ages,Secondary,96490,73035,169525
23056,13,State - NAGALAND,Total,0-6,Secondary,0,0,0
23057,13,State - NAGALAND,Total,7,Secondary,0,0,0
23058,13,State - NAGALAND,Total,8,Secondary,0,0,0
23059,13,State - NAGALAND,Total,9,Secondary,0,0,0
23060,13,State - NAGALAND,Total,10,Secondary,0,0,0
23061,13,State - NAGALAND,Total,11,Secondary,0,0,0
23062,13,State - NAGALAND,Total,12,Secondary,0,0,0
23063,13,State - NAGALAND,Total,13,Secondary,0,0,0
23064,13,State - NAGALAND,Total,14,Secondary,0,0,0
23065,13,State - NAGALAND,Total,15,Secondary,2505,2425,4930
23066,13,State - NAGALAND,Total,16,Secondary,4843,4905,9748
23067,13,State - NAGALAND,Total,17,Secondary,6773,6836,13609
23068,13,State - NAGALAND,Total,18,Secondary,5645,5372,11017
23069,13,State - NAGALAND,Total,19,Secondary,3894,3544,7438
23070,13,State - NAGALAND,Total,20-24,Secondary,14805,13054,27859
23071,13,State - NAGALAND,Total,25-29,Secondary,12065,9364,21429
23072,13,State - NAGALAND,Total,30-34,Secondary,10644,8080,18724
23073,13,State - NAGALAND,Total,35-39,Secondary,9501,6489,15990
23074,13,State - NAGALAND,Total,40-44,Secondary,8236,4980,13216
23075,13,State - NAGALAND,Total,45-49,Secondary,6371,3397,9768
23076,13,State - NAGALAND,Total,50-54,Secondary,4353,2104,6457
23077,13,State - NAGALAND,Total,55-59,Secondary,2718,1112,3830
23078,13,State - NAGALAND,Total,60-64,Secondary,1703,592,2295
23079,13,State - NAGALAND,Total,65-69,Secondary,1134,415,1549
23080,13,State - NAGALAND,Total,70-74,Secondary,615,168,783
23081,13,State - NAGALAND,Total,75-79,Secondary,311,69,380
23082,13,State - NAGALAND,Total,80+,Secondary,328,103,431
23083,13,State - NAGALAND,Total,Age not stated,Secondary,46,26,72
23084,13,State - NAGALAND,Rural,All ages,Secondary,56446,40300,96746
23085,13,State - NAGALAND,Rural,0-6,Secondary,0,0,0
23086,13,State - NAGALAND,Rural,7,Secondary,0,0,0
23087,13,State - NAGALAND,Rural,8,Secondary,0,0,0
23088,13,State - NAGALAND,Rural,9,Secondary,0,0,0
23089,13,State - NAGALAND,Rural,10,Secondary,0,0,0
23090,13,State - NAGALAND,Rural,11,Secondary,0,0,0
23091,13,State - NAGALAND,Rural,12,Secondary,0,0,0
23092,13,State - NAGALAND,Rural,13,Secondary,0,0,0
23093,13,State - NAGALAND,Rural,14,Secondary,0,0,0
23094,13,State - NAGALAND,Rural,15,Secondary,1502,1398,2900
23095,13,State - NAGALAND,Rural,16,Secondary,2901,2868,5769
23096,13,State - NAGALAND,Rural,17,Secondary,3895,3761,7656
23097,13,State - NAGALAND,Rural,18,Secondary,3413,3227,6640
23098,13,State - NAGALAND,Rural,19,Secondary,2385,2107,4492
23099,13,State - NAGALAND,Rural,20-24,Secondary,9191,7943,17134
23100,13,State - NAGALAND,Rural,25-29,Secondary,6964,5289,12253
23101,13,State - NAGALAND,Rural,30-34,Secondary,6175,4363,10538
23102,13,State - NAGALAND,Rural,35-39,Secondary,5453,3412,8865
23103,13,State - NAGALAND,Rural,40-44,Secondary,4722,2430,7152
23104,13,State - NAGALAND,Rural,45-49,Secondary,3555,1519,5074
23105,13,State - NAGALAND,Rural,50-54,Secondary,2415,912,3327
23106,13,State - NAGALAND,Rural,55-59,Secondary,1481,461,1942
23107,13,State - NAGALAND,Rural,60-64,Secondary,962,251,1213
23108,13,State - NAGALAND,Rural,65-69,Secondary,657,189,846
23109,13,State - NAGALAND,Rural,70-74,Secondary,361,75,436
23110,13,State - NAGALAND,Rural,75-79,Secondary,188,31,219
23111,13,State - NAGALAND,Rural,80+,Secondary,190,42,232
23112,13,State - NAGALAND,Rural,Age not stated,Secondary,36,22,58
23113,13,State - NAGALAND,Urban,All ages,Secondary,40044,32735,72779
23114,13,State - NAGALAND,Urban,0-6,Secondary,0,0,0
23115,13,State - NAGALAND,Urban,7,Secondary,0,0,0
23116,13,State - NAGALAND,Urban,8,Secondary,0,0,0
23117,13,State - NAGALAND,Urban,9,Secondary,0,0,0
23118,13,State - NAGALAND,Urban,10,Secondary,0,0,0
23119,13,State - NAGALAND,Urban,11,Secondary,0,0,0
23120,13,State - NAGALAND,Urban,12,Secondary,0,0,0
23121,13,State - NAGALAND,Urban,13,Secondary,0,0,0
23122,13,State - NAGALAND,Urban,14,Secondary,0,0,0
23123,13,State - NAGALAND,Urban,15,Secondary,1003,1027,2030
23124,13,State - NAGALAND,Urban,16,Secondary,1942,2037,3979
23125,13,State - NAGALAND,Urban,17,Secondary,2878,3075,5953
23126,13,State - NAGALAND,Urban,18,Secondary,2232,2145,4377
23127,13,State - NAGALAND,Urban,19,Secondary,1509,1437,2946
23128,13,State - NAGALAND,Urban,20-24,Secondary,5614,5111,10725
23129,13,State - NAGALAND,Urban,25-29,Secondary,5101,4075,9176
23130,13,State - NAGALAND,Urban,30-34,Secondary,4469,3717,8186
23131,13,State - NAGALAND,Urban,35-39,Secondary,4048,3077,7125
23132,13,State - NAGALAND,Urban,40-44,Secondary,3514,2550,6064
23133,13,State - NAGALAND,Urban,45-49,Secondary,2816,1878,4694
23134,13,State - NAGALAND,Urban,50-54,Secondary,1938,1192,3130
23135,13,State - NAGALAND,Urban,55-59,Secondary,1237,651,1888
23136,13,State - NAGALAND,Urban,60-64,Secondary,741,341,1082
23137,13,State - NAGALAND,Urban,65-69,Secondary,477,226,703
23138,13,State - NAGALAND,Urban,70-74,Secondary,254,93,347
23139,13,State - NAGALAND,Urban,75-79,Secondary,123,38,161
23140,13,State - NAGALAND,Urban,80+,Secondary,138,61,199
23141,13,State - NAGALAND,Urban,Age not stated,Secondary,10,4,14
23142,14,State - MANIPUR,Total,All ages,Secondary,185952,144264,330216
23143,14,State - MANIPUR,Total,0-6,Secondary,0,0,0
23144,14,State - MANIPUR,Total,7,Secondary,0,0,0
23145,14,State - MANIPUR,Total,8,Secondary,0,0,0
23146,14,State - MANIPUR,Total,9,Secondary,0,0,0
23147,14,State - MANIPUR,Total,10,Secondary,0,0,0
23148,14,State - MANIPUR,Total,11,Secondary,0,0,0
23149,14,State - MANIPUR,Total,12,Secondary,0,0,0
23150,14,State - MANIPUR,Total,13,Secondary,0,0,0
23151,14,State - MANIPUR,Total,14,Secondary,0,0,0
23152,14,State - MANIPUR,Total,15,Secondary,6620,6128,12748
23153,14,State - MANIPUR,Total,16,Secondary,10001,9397,19398
23154,14,State - MANIPUR,Total,17,Secondary,12349,11291,23640
23155,14,State - MANIPUR,Total,18,Secondary,8707,7919,16626
23156,14,State - MANIPUR,Total,19,Secondary,6013,5603,11616
23157,14,State - MANIPUR,Total,20-24,Secondary,27711,25724,53435
23158,14,State - MANIPUR,Total,25-29,Secondary,25657,22387,48044
23159,14,State - MANIPUR,Total,30-34,Secondary,19520,16191,35711
23160,14,State - MANIPUR,Total,35-39,Secondary,17182,13089,30271
23161,14,State - MANIPUR,Total,40-44,Secondary,14670,9272,23942
23162,14,State - MANIPUR,Total,45-49,Secondary,11564,6377,17941
23163,14,State - MANIPUR,Total,50-54,Secondary,8751,4410,13161
23164,14,State - MANIPUR,Total,55-59,Secondary,6072,2737,8809
23165,14,State - MANIPUR,Total,60-64,Secondary,4408,1785,6193
23166,14,State - MANIPUR,Total,65-69,Secondary,2861,835,3696
23167,14,State - MANIPUR,Total,70-74,Secondary,1667,357,2024
23168,14,State - MANIPUR,Total,75-79,Secondary,914,163,1077
23169,14,State - MANIPUR,Total,80+,Secondary,882,266,1148
23170,14,State - MANIPUR,Total,Age not stated,Secondary,403,333,736
23171,14,State - MANIPUR,Rural,All ages,Secondary,125034,91937,216971
23172,14,State - MANIPUR,Rural,0-6,Secondary,0,0,0
23173,14,State - MANIPUR,Rural,7,Secondary,0,0,0
23174,14,State - MANIPUR,Rural,8,Secondary,0,0,0
23175,14,State - MANIPUR,Rural,9,Secondary,0,0,0
23176,14,State - MANIPUR,Rural,10,Secondary,0,0,0
23177,14,State - MANIPUR,Rural,11,Secondary,0,0,0
23178,14,State - MANIPUR,Rural,12,Secondary,0,0,0
23179,14,State - MANIPUR,Rural,13,Secondary,0,0,0
23180,14,State - MANIPUR,Rural,14,Secondary,0,0,0
23181,14,State - MANIPUR,Rural,15,Secondary,4399,4033,8432
23182,14,State - MANIPUR,Rural,16,Secondary,6701,6090,12791
23183,14,State - MANIPUR,Rural,17,Secondary,8229,7344,15573
23184,14,State - MANIPUR,Rural,18,Secondary,6346,5706,12052
23185,14,State - MANIPUR,Rural,19,Secondary,4401,3993,8394
23186,14,State - MANIPUR,Rural,20-24,Secondary,19704,17646,37350
23187,14,State - MANIPUR,Rural,25-29,Secondary,17529,14493,32022
23188,14,State - MANIPUR,Rural,30-34,Secondary,13527,10304,23831
23189,14,State - MANIPUR,Rural,35-39,Secondary,11711,8151,19862
23190,14,State - MANIPUR,Rural,40-44,Secondary,9834,5521,15355
23191,14,State - MANIPUR,Rural,45-49,Secondary,7584,3603,11187
23192,14,State - MANIPUR,Rural,50-54,Secondary,5395,2176,7571
23193,14,State - MANIPUR,Rural,55-59,Secondary,3608,1238,4846
23194,14,State - MANIPUR,Rural,60-64,Secondary,2556,756,3312
23195,14,State - MANIPUR,Rural,65-69,Secondary,1540,323,1863
23196,14,State - MANIPUR,Rural,70-74,Secondary,864,146,1010
23197,14,State - MANIPUR,Rural,75-79,Secondary,411,61,472
23198,14,State - MANIPUR,Rural,80+,Secondary,434,150,584
23199,14,State - MANIPUR,Rural,Age not stated,Secondary,261,203,464
23200,14,State - MANIPUR,Urban,All ages,Secondary,60918,52327,113245
23201,14,State - MANIPUR,Urban,0-6,Secondary,0,0,0
23202,14,State - MANIPUR,Urban,7,Secondary,0,0,0
23203,14,State - MANIPUR,Urban,8,Secondary,0,0,0
23204,14,State - MANIPUR,Urban,9,Secondary,0,0,0
23205,14,State - MANIPUR,Urban,10,Secondary,0,0,0
23206,14,State - MANIPUR,Urban,11,Secondary,0,0,0
23207,14,State - MANIPUR,Urban,12,Secondary,0,0,0
23208,14,State - MANIPUR,Urban,13,Secondary,0,0,0
23209,14,State - MANIPUR,Urban,14,Secondary,0,0,0
23210,14,State - MANIPUR,Urban,15,Secondary,2221,2095,4316
23211,14,State - MANIPUR,Urban,16,Secondary,3300,3307,6607
23212,14,State - MANIPUR,Urban,17,Secondary,4120,3947,8067
23213,14,State - MANIPUR,Urban,18,Secondary,2361,2213,4574
23214,14,State - MANIPUR,Urban,19,Secondary,1612,1610,3222
23215,14,State - MANIPUR,Urban,20-24,Secondary,8007,8078,16085
23216,14,State - MANIPUR,Urban,25-29,Secondary,8128,7894,16022
23217,14,State - MANIPUR,Urban,30-34,Secondary,5993,5887,11880
23218,14,State - MANIPUR,Urban,35-39,Secondary,5471,4938,10409
23219,14,State - MANIPUR,Urban,40-44,Secondary,4836,3751,8587
23220,14,State - MANIPUR,Urban,45-49,Secondary,3980,2774,6754
23221,14,State - MANIPUR,Urban,50-54,Secondary,3356,2234,5590
23222,14,State - MANIPUR,Urban,55-59,Secondary,2464,1499,3963
23223,14,State - MANIPUR,Urban,60-64,Secondary,1852,1029,2881
23224,14,State - MANIPUR,Urban,65-69,Secondary,1321,512,1833
23225,14,State - MANIPUR,Urban,70-74,Secondary,803,211,1014
23226,14,State - MANIPUR,Urban,75-79,Secondary,503,102,605
23227,14,State - MANIPUR,Urban,80+,Secondary,448,116,564
23228,14,State - MANIPUR,Urban,Age not stated,Secondary,142,130,272
23229,15,State - MIZORAM,Total,All ages,Secondary,46235,41918,88153
23230,15,State - MIZORAM,Total,0-6,Secondary,0,0,0
23231,15,State - MIZORAM,Total,7,Secondary,0,0,0
23232,15,State - MIZORAM,Total,8,Secondary,0,0,0
23233,15,State - MIZORAM,Total,9,Secondary,0,0,0
23234,15,State - MIZORAM,Total,10,Secondary,0,0,0
23235,15,State - MIZORAM,Total,11,Secondary,0,0,0
23236,15,State - MIZORAM,Total,12,Secondary,0,0,0
23237,15,State - MIZORAM,Total,13,Secondary,0,0,0
23238,15,State - MIZORAM,Total,14,Secondary,0,0,0
23239,15,State - MIZORAM,Total,15,Secondary,1190,1454,2644
23240,15,State - MIZORAM,Total,16,Secondary,2487,2810,5297
23241,15,State - MIZORAM,Total,17,Secondary,3765,4287,8052
23242,15,State - MIZORAM,Total,18,Secondary,2979,3061,6040
23243,15,State - MIZORAM,Total,19,Secondary,2207,2098,4305
23244,15,State - MIZORAM,Total,20-24,Secondary,7286,7151,14437
23245,15,State - MIZORAM,Total,25-29,Secondary,6101,5775,11876
23246,15,State - MIZORAM,Total,30-34,Secondary,5341,4656,9997
23247,15,State - MIZORAM,Total,35-39,Secondary,4001,3435,7436
23248,15,State - MIZORAM,Total,40-44,Secondary,3464,2549,6013
23249,15,State - MIZORAM,Total,45-49,Secondary,2638,2033,4671
23250,15,State - MIZORAM,Total,50-54,Secondary,1920,1294,3214
23251,15,State - MIZORAM,Total,55-59,Secondary,1137,619,1756
23252,15,State - MIZORAM,Total,60-64,Secondary,699,330,1029
23253,15,State - MIZORAM,Total,65-69,Secondary,459,187,646
23254,15,State - MIZORAM,Total,70-74,Secondary,274,88,362
23255,15,State - MIZORAM,Total,75-79,Secondary,134,35,169
23256,15,State - MIZORAM,Total,80+,Secondary,124,42,166
23257,15,State - MIZORAM,Total,Age not stated,Secondary,29,14,43
23258,15,State - MIZORAM,Rural,All ages,Secondary,13465,10209,23674
23259,15,State - MIZORAM,Rural,0-6,Secondary,0,0,0
23260,15,State - MIZORAM,Rural,7,Secondary,0,0,0
23261,15,State - MIZORAM,Rural,8,Secondary,0,0,0
23262,15,State - MIZORAM,Rural,9,Secondary,0,0,0
23263,15,State - MIZORAM,Rural,10,Secondary,0,0,0
23264,15,State - MIZORAM,Rural,11,Secondary,0,0,0
23265,15,State - MIZORAM,Rural,12,Secondary,0,0,0
23266,15,State - MIZORAM,Rural,13,Secondary,0,0,0
23267,15,State - MIZORAM,Rural,14,Secondary,0,0,0
23268,15,State - MIZORAM,Rural,15,Secondary,324,420,744
23269,15,State - MIZORAM,Rural,16,Secondary,746,734,1480
23270,15,State - MIZORAM,Rural,17,Secondary,1024,1050,2074
23271,15,State - MIZORAM,Rural,18,Secondary,820,783,1603
23272,15,State - MIZORAM,Rural,19,Secondary,640,609,1249
23273,15,State - MIZORAM,Rural,20-24,Secondary,2367,2180,4547
23274,15,State - MIZORAM,Rural,25-29,Secondary,1875,1534,3409
23275,15,State - MIZORAM,Rural,30-34,Secondary,1545,1041,2586
23276,15,State - MIZORAM,Rural,35-39,Secondary,1189,716,1905
23277,15,State - MIZORAM,Rural,40-44,Secondary,981,473,1454
23278,15,State - MIZORAM,Rural,45-49,Secondary,674,298,972
23279,15,State - MIZORAM,Rural,50-54,Secondary,532,196,728
23280,15,State - MIZORAM,Rural,55-59,Secondary,306,81,387
23281,15,State - MIZORAM,Rural,60-64,Secondary,209,43,252
23282,15,State - MIZORAM,Rural,65-69,Secondary,117,28,145
23283,15,State - MIZORAM,Rural,70-74,Secondary,47,6,53
23284,15,State - MIZORAM,Rural,75-79,Secondary,27,4,31
23285,15,State - MIZORAM,Rural,80+,Secondary,32,7,39
23286,15,State - MIZORAM,Rural,Age not stated,Secondary,10,6,16
23287,15,State - MIZORAM,Urban,All ages,Secondary,32770,31709,64479
23288,15,State - MIZORAM,Urban,0-6,Secondary,0,0,0
23289,15,State - MIZORAM,Urban,7,Secondary,0,0,0
23290,15,State - MIZORAM,Urban,8,Secondary,0,0,0
23291,15,State - MIZORAM,Urban,9,Secondary,0,0,0
23292,15,State - MIZORAM,Urban,10,Secondary,0,0,0
23293,15,State - MIZORAM,Urban,11,Secondary,0,0,0
23294,15,State - MIZORAM,Urban,12,Secondary,0,0,0
23295,15,State - MIZORAM,Urban,13,Secondary,0,0,0
23296,15,State - MIZORAM,Urban,14,Secondary,0,0,0
23297,15,State - MIZORAM,Urban,15,Secondary,866,1034,1900
23298,15,State - MIZORAM,Urban,16,Secondary,1741,2076,3817
23299,15,State - MIZORAM,Urban,17,Secondary,2741,3237,5978
23300,15,State - MIZORAM,Urban,18,Secondary,2159,2278,4437
23301,15,State - MIZORAM,Urban,19,Secondary,1567,1489,3056
23302,15,State - MIZORAM,Urban,20-24,Secondary,4919,4971,9890
23303,15,State - MIZORAM,Urban,25-29,Secondary,4226,4241,8467
23304,15,State - MIZORAM,Urban,30-34,Secondary,3796,3615,7411
23305,15,State - MIZORAM,Urban,35-39,Secondary,2812,2719,5531
23306,15,State - MIZORAM,Urban,40-44,Secondary,2483,2076,4559
23307,15,State - MIZORAM,Urban,45-49,Secondary,1964,1735,3699
23308,15,State - MIZORAM,Urban,50-54,Secondary,1388,1098,2486
23309,15,State - MIZORAM,Urban,55-59,Secondary,831,538,1369
23310,15,State - MIZORAM,Urban,60-64,Secondary,490,287,777
23311,15,State - MIZORAM,Urban,65-69,Secondary,342,159,501
23312,15,State - MIZORAM,Urban,70-74,Secondary,227,82,309
23313,15,State - MIZORAM,Urban,75-79,Secondary,107,31,138
23314,15,State - MIZORAM,Urban,80+,Secondary,92,35,127
23315,15,State - MIZORAM,Urban,Age not stated,Secondary,19,8,27
23316,16,State - TRIPURA,Total,All ages,Secondary,117515,83314,200829
23317,16,State - TRIPURA,Total,0-6,Secondary,0,0,0
23318,16,State - TRIPURA,Total,7,Secondary,0,0,0
23319,16,State - TRIPURA,Total,8,Secondary,0,0,0
23320,16,State - TRIPURA,Total,9,Secondary,0,0,0
23321,16,State - TRIPURA,Total,10,Secondary,0,0,0
23322,16,State - TRIPURA,Total,11,Secondary,0,0,0
23323,16,State - TRIPURA,Total,12,Secondary,0,0,0
23324,16,State - TRIPURA,Total,13,Secondary,0,0,0
23325,16,State - TRIPURA,Total,14,Secondary,0,0,0
23326,16,State - TRIPURA,Total,15,Secondary,2718,2744,5462
23327,16,State - TRIPURA,Total,16,Secondary,6936,6605,13541
23328,16,State - TRIPURA,Total,17,Secondary,10926,9414,20340
23329,16,State - TRIPURA,Total,18,Secondary,6645,5704,12349
23330,16,State - TRIPURA,Total,19,Secondary,4897,4324,9221
23331,16,State - TRIPURA,Total,20-24,Secondary,17854,15687,33541
23332,16,State - TRIPURA,Total,25-29,Secondary,14390,10663,25053
23333,16,State - TRIPURA,Total,30-34,Secondary,12886,8554,21440
23334,16,State - TRIPURA,Total,35-39,Secondary,12802,7406,20208
23335,16,State - TRIPURA,Total,40-44,Secondary,10286,4766,15052
23336,16,State - TRIPURA,Total,45-49,Secondary,6025,2984,9009
23337,16,State - TRIPURA,Total,50-54,Secondary,3644,1785,5429
23338,16,State - TRIPURA,Total,55-59,Secondary,2345,1111,3456
23339,16,State - TRIPURA,Total,60-64,Secondary,1710,630,2340
23340,16,State - TRIPURA,Total,65-69,Secondary,1310,422,1732
23341,16,State - TRIPURA,Total,70-74,Secondary,854,199,1053
23342,16,State - TRIPURA,Total,75-79,Secondary,574,105,679
23343,16,State - TRIPURA,Total,80+,Secondary,660,174,834
23344,16,State - TRIPURA,Total,Age not stated,Secondary,53,37,90
23345,16,State - TRIPURA,Rural,All ages,Secondary,84042,55068,139110
23346,16,State - TRIPURA,Rural,0-6,Secondary,0,0,0
23347,16,State - TRIPURA,Rural,7,Secondary,0,0,0
23348,16,State - TRIPURA,Rural,8,Secondary,0,0,0
23349,16,State - TRIPURA,Rural,9,Secondary,0,0,0
23350,16,State - TRIPURA,Rural,10,Secondary,0,0,0
23351,16,State - TRIPURA,Rural,11,Secondary,0,0,0
23352,16,State - TRIPURA,Rural,12,Secondary,0,0,0
23353,16,State - TRIPURA,Rural,13,Secondary,0,0,0
23354,16,State - TRIPURA,Rural,14,Secondary,0,0,0
23355,16,State - TRIPURA,Rural,15,Secondary,1936,1937,3873
23356,16,State - TRIPURA,Rural,16,Secondary,4691,4416,9107
23357,16,State - TRIPURA,Rural,17,Secondary,7344,5939,13283
23358,16,State - TRIPURA,Rural,18,Secondary,4887,3990,8877
23359,16,State - TRIPURA,Rural,19,Secondary,3752,3264,7016
23360,16,State - TRIPURA,Rural,20-24,Secondary,14322,12149,26471
23361,16,State - TRIPURA,Rural,25-29,Secondary,11151,7649,18800
23362,16,State - TRIPURA,Rural,30-34,Secondary,9634,5668,15302
23363,16,State - TRIPURA,Rural,35-39,Secondary,9313,4575,13888
23364,16,State - TRIPURA,Rural,40-44,Secondary,7221,2585,9806
23365,16,State - TRIPURA,Rural,45-49,Secondary,3934,1386,5320
23366,16,State - TRIPURA,Rural,50-54,Secondary,2093,721,2814
23367,16,State - TRIPURA,Rural,55-59,Secondary,1313,371,1684
23368,16,State - TRIPURA,Rural,60-64,Secondary,868,156,1024
23369,16,State - TRIPURA,Rural,65-69,Secondary,632,93,725
23370,16,State - TRIPURA,Rural,70-74,Secondary,356,28,384
23371,16,State - TRIPURA,Rural,75-79,Secondary,230,27,257
23372,16,State - TRIPURA,Rural,80+,Secondary,330,92,422
23373,16,State - TRIPURA,Rural,Age not stated,Secondary,35,22,57
23374,16,State - TRIPURA,Urban,All ages,Secondary,33473,28246,61719
23375,16,State - TRIPURA,Urban,0-6,Secondary,0,0,0
23376,16,State - TRIPURA,Urban,7,Secondary,0,0,0
23377,16,State - TRIPURA,Urban,8,Secondary,0,0,0
23378,16,State - TRIPURA,Urban,9,Secondary,0,0,0
23379,16,State - TRIPURA,Urban,10,Secondary,0,0,0
23380,16,State - TRIPURA,Urban,11,Secondary,0,0,0
23381,16,State - TRIPURA,Urban,12,Secondary,0,0,0
23382,16,State - TRIPURA,Urban,13,Secondary,0,0,0
23383,16,State - TRIPURA,Urban,14,Secondary,0,0,0
23384,16,State - TRIPURA,Urban,15,Secondary,782,807,1589
23385,16,State - TRIPURA,Urban,16,Secondary,2245,2189,4434
23386,16,State - TRIPURA,Urban,17,Secondary,3582,3475,7057
23387,16,State - TRIPURA,Urban,18,Secondary,1758,1714,3472
23388,16,State - TRIPURA,Urban,19,Secondary,1145,1060,2205
23389,16,State - TRIPURA,Urban,20-24,Secondary,3532,3538,7070
23390,16,State - TRIPURA,Urban,25-29,Secondary,3239,3014,6253
23391,16,State - TRIPURA,Urban,30-34,Secondary,3252,2886,6138
23392,16,State - TRIPURA,Urban,35-39,Secondary,3489,2831,6320
23393,16,State - TRIPURA,Urban,40-44,Secondary,3065,2181,5246
23394,16,State - TRIPURA,Urban,45-49,Secondary,2091,1598,3689
23395,16,State - TRIPURA,Urban,50-54,Secondary,1551,1064,2615
23396,16,State - TRIPURA,Urban,55-59,Secondary,1032,740,1772
23397,16,State - TRIPURA,Urban,60-64,Secondary,842,474,1316
23398,16,State - TRIPURA,Urban,65-69,Secondary,678,329,1007
23399,16,State - TRIPURA,Urban,70-74,Secondary,498,171,669
23400,16,State - TRIPURA,Urban,75-79,Secondary,344,78,422
23401,16,State - TRIPURA,Urban,80+,Secondary,330,82,412
23402,16,State - TRIPURA,Urban,Age not stated,Secondary,18,15,33
23403,17,State - MEGHALAYA,Total,All ages,Secondary,86803,73260,160063
23404,17,State - MEGHALAYA,Total,0-6,Secondary,0,0,0
23405,17,State - MEGHALAYA,Total,7,Secondary,0,0,0
23406,17,State - MEGHALAYA,Total,8,Secondary,0,0,0
23407,17,State - MEGHALAYA,Total,9,Secondary,0,0,0
23408,17,State - MEGHALAYA,Total,10,Secondary,0,0,0
23409,17,State - MEGHALAYA,Total,11,Secondary,0,0,0
23410,17,State - MEGHALAYA,Total,12,Secondary,0,0,0
23411,17,State - MEGHALAYA,Total,13,Secondary,0,0,0
23412,17,State - MEGHALAYA,Total,14,Secondary,0,0,0
23413,17,State - MEGHALAYA,Total,15,Secondary,2414,2971,5385
23414,17,State - MEGHALAYA,Total,16,Secondary,4544,5456,10000
23415,17,State - MEGHALAYA,Total,17,Secondary,6563,7401,13964
23416,17,State - MEGHALAYA,Total,18,Secondary,5266,5663,10929
23417,17,State - MEGHALAYA,Total,19,Secondary,4061,4164,8225
23418,17,State - MEGHALAYA,Total,20-24,Secondary,15303,14467,29770
23419,17,State - MEGHALAYA,Total,25-29,Secondary,11535,9133,20668
23420,17,State - MEGHALAYA,Total,30-34,Secondary,8614,6316,14930
23421,17,State - MEGHALAYA,Total,35-39,Secondary,8244,5770,14014
23422,17,State - MEGHALAYA,Total,40-44,Secondary,6796,4267,11063
23423,17,State - MEGHALAYA,Total,45-49,Secondary,5138,2882,8020
23424,17,State - MEGHALAYA,Total,50-54,Secondary,3061,1829,4890
23425,17,State - MEGHALAYA,Total,55-59,Secondary,1940,977,2917
23426,17,State - MEGHALAYA,Total,60-64,Secondary,1301,727,2028
23427,17,State - MEGHALAYA,Total,65-69,Secondary,797,451,1248
23428,17,State - MEGHALAYA,Total,70-74,Secondary,459,294,753
23429,17,State - MEGHALAYA,Total,75-79,Secondary,242,149,391
23430,17,State - MEGHALAYA,Total,80+,Secondary,314,232,546
23431,17,State - MEGHALAYA,Total,Age not stated,Secondary,211,111,322
23432,17,State - MEGHALAYA,Rural,All ages,Secondary,52135,43452,95587
23433,17,State - MEGHALAYA,Rural,0-6,Secondary,0,0,0
23434,17,State - MEGHALAYA,Rural,7,Secondary,0,0,0
23435,17,State - MEGHALAYA,Rural,8,Secondary,0,0,0
23436,17,State - MEGHALAYA,Rural,9,Secondary,0,0,0
23437,17,State - MEGHALAYA,Rural,10,Secondary,0,0,0
23438,17,State - MEGHALAYA,Rural,11,Secondary,0,0,0
23439,17,State - MEGHALAYA,Rural,12,Secondary,0,0,0
23440,17,State - MEGHALAYA,Rural,13,Secondary,0,0,0
23441,17,State - MEGHALAYA,Rural,14,Secondary,0,0,0
23442,17,State - MEGHALAYA,Rural,15,Secondary,1519,1943,3462
23443,17,State - MEGHALAYA,Rural,16,Secondary,2705,3279,5984
23444,17,State - MEGHALAYA,Rural,17,Secondary,3657,4183,7840
23445,17,State - MEGHALAYA,Rural,18,Secondary,2944,3333,6277
23446,17,State - MEGHALAYA,Rural,19,Secondary,2377,2663,5040
23447,17,State - MEGHALAYA,Rural,20-24,Secondary,10075,10150,20225
23448,17,State - MEGHALAYA,Rural,25-29,Secondary,7454,5861,13315
23449,17,State - MEGHALAYA,Rural,30-34,Secondary,5137,3800,8937
23450,17,State - MEGHALAYA,Rural,35-39,Secondary,5029,3177,8206
23451,17,State - MEGHALAYA,Rural,40-44,Secondary,3985,2143,6128
23452,17,State - MEGHALAYA,Rural,45-49,Secondary,2866,1268,4134
23453,17,State - MEGHALAYA,Rural,50-54,Secondary,1622,669,2291
23454,17,State - MEGHALAYA,Rural,55-59,Secondary,978,342,1320
23455,17,State - MEGHALAYA,Rural,60-64,Secondary,706,225,931
23456,17,State - MEGHALAYA,Rural,65-69,Secondary,438,154,592
23457,17,State - MEGHALAYA,Rural,70-74,Secondary,249,65,314
23458,17,State - MEGHALAYA,Rural,75-79,Secondary,105,29,134
23459,17,State - MEGHALAYA,Rural,80+,Secondary,157,83,240
23460,17,State - MEGHALAYA,Rural,Age not stated,Secondary,132,85,217
23461,17,State - MEGHALAYA,Urban,All ages,Secondary,34668,29808,64476
23462,17,State - MEGHALAYA,Urban,0-6,Secondary,0,0,0
23463,17,State - MEGHALAYA,Urban,7,Secondary,0,0,0
23464,17,State - MEGHALAYA,Urban,8,Secondary,0,0,0
23465,17,State - MEGHALAYA,Urban,9,Secondary,0,0,0
23466,17,State - MEGHALAYA,Urban,10,Secondary,0,0,0
23467,17,State - MEGHALAYA,Urban,11,Secondary,0,0,0
23468,17,State - MEGHALAYA,Urban,12,Secondary,0,0,0
23469,17,State - MEGHALAYA,Urban,13,Secondary,0,0,0
23470,17,State - MEGHALAYA,Urban,14,Secondary,0,0,0
23471,17,State - MEGHALAYA,Urban,15,Secondary,895,1028,1923
23472,17,State - MEGHALAYA,Urban,16,Secondary,1839,2177,4016
23473,17,State - MEGHALAYA,Urban,17,Secondary,2906,3218,6124
23474,17,State - MEGHALAYA,Urban,18,Secondary,2322,2330,4652
23475,17,State - MEGHALAYA,Urban,19,Secondary,1684,1501,3185
23476,17,State - MEGHALAYA,Urban,20-24,Secondary,5228,4317,9545
23477,17,State - MEGHALAYA,Urban,25-29,Secondary,4081,3272,7353
23478,17,State - MEGHALAYA,Urban,30-34,Secondary,3477,2516,5993
23479,17,State - MEGHALAYA,Urban,35-39,Secondary,3215,2593,5808
23480,17,State - MEGHALAYA,Urban,40-44,Secondary,2811,2124,4935
23481,17,State - MEGHALAYA,Urban,45-49,Secondary,2272,1614,3886
23482,17,State - MEGHALAYA,Urban,50-54,Secondary,1439,1160,2599
23483,17,State - MEGHALAYA,Urban,55-59,Secondary,962,635,1597
23484,17,State - MEGHALAYA,Urban,60-64,Secondary,595,502,1097
23485,17,State - MEGHALAYA,Urban,65-69,Secondary,359,297,656
23486,17,State - MEGHALAYA,Urban,70-74,Secondary,210,229,439
23487,17,State - MEGHALAYA,Urban,75-79,Secondary,137,120,257
23488,17,State - MEGHALAYA,Urban,80+,Secondary,157,149,306
23489,17,State - MEGHALAYA,Urban,Age not stated,Secondary,79,26,105
23490,18,State - ASSAM,Total,All ages,Secondary,802772,642743,1445515
23491,18,State - ASSAM,Total,0-6,Secondary,0,0,0
23492,18,State - ASSAM,Total,7,Secondary,0,0,0
23493,18,State - ASSAM,Total,8,Secondary,0,0,0
23494,18,State - ASSAM,Total,9,Secondary,0,0,0
23495,18,State - ASSAM,Total,10,Secondary,0,0,0
23496,18,State - ASSAM,Total,11,Secondary,0,0,0
23497,18,State - ASSAM,Total,12,Secondary,0,0,0
23498,18,State - ASSAM,Total,13,Secondary,0,0,0
23499,18,State - ASSAM,Total,14,Secondary,0,0,0
23500,18,State - ASSAM,Total,15,Secondary,34080,35816,69896
23501,18,State - ASSAM,Total,16,Secondary,63440,63601,127041
23502,18,State - ASSAM,Total,17,Secondary,84268,81236,165504
23503,18,State - ASSAM,Total,18,Secondary,36901,33830,70731
23504,18,State - ASSAM,Total,19,Secondary,24471,23770,48241
23505,18,State - ASSAM,Total,20-24,Secondary,100422,94847,195269
23506,18,State - ASSAM,Total,25-29,Secondary,96783,83175,179958
23507,18,State - ASSAM,Total,30-34,Secondary,82066,65461,147527
23508,18,State - ASSAM,Total,35-39,Secondary,75908,56182,132090
23509,18,State - ASSAM,Total,40-44,Secondary,59512,36461,95973
23510,18,State - ASSAM,Total,45-49,Secondary,46183,26892,73075
23511,18,State - ASSAM,Total,50-54,Secondary,33138,16207,49345
23512,18,State - ASSAM,Total,55-59,Secondary,22958,10279,33237
23513,18,State - ASSAM,Total,60-64,Secondary,16943,6786,23729
23514,18,State - ASSAM,Total,65-69,Secondary,11183,3826,15009
23515,18,State - ASSAM,Total,70-74,Secondary,6964,1772,8736
23516,18,State - ASSAM,Total,75-79,Secondary,3542,931,4473
23517,18,State - ASSAM,Total,80+,Secondary,3564,1371,4935
23518,18,State - ASSAM,Total,Age not stated,Secondary,446,300,746
23519,18,State - ASSAM,Rural,All ages,Secondary,632475,487512,1119987
23520,18,State - ASSAM,Rural,0-6,Secondary,0,0,0
23521,18,State - ASSAM,Rural,7,Secondary,0,0,0
23522,18,State - ASSAM,Rural,8,Secondary,0,0,0
23523,18,State - ASSAM,Rural,9,Secondary,0,0,0
23524,18,State - ASSAM,Rural,10,Secondary,0,0,0
23525,18,State - ASSAM,Rural,11,Secondary,0,0,0
23526,18,State - ASSAM,Rural,12,Secondary,0,0,0
23527,18,State - ASSAM,Rural,13,Secondary,0,0,0
23528,18,State - ASSAM,Rural,14,Secondary,0,0,0
23529,18,State - ASSAM,Rural,15,Secondary,27386,28662,56048
23530,18,State - ASSAM,Rural,16,Secondary,50149,50082,100231
23531,18,State - ASSAM,Rural,17,Secondary,65179,62163,127342
23532,18,State - ASSAM,Rural,18,Secondary,30836,28046,58882
23533,18,State - ASSAM,Rural,19,Secondary,20440,19916,40356
23534,18,State - ASSAM,Rural,20-24,Secondary,83911,78198,162109
23535,18,State - ASSAM,Rural,25-29,Secondary,79121,65802,144923
23536,18,State - ASSAM,Rural,30-34,Secondary,65832,49801,115633
23537,18,State - ASSAM,Rural,35-39,Secondary,59896,40911,100807
23538,18,State - ASSAM,Rural,40-44,Secondary,45327,24674,70001
23539,18,State - ASSAM,Rural,45-49,Secondary,34304,16997,51301
23540,18,State - ASSAM,Rural,50-54,Secondary,23631,9491,33122
23541,18,State - ASSAM,Rural,55-59,Secondary,16486,5607,22093
23542,18,State - ASSAM,Rural,60-64,Secondary,12157,3337,15494
23543,18,State - ASSAM,Rural,65-69,Secondary,7940,1812,9752
23544,18,State - ASSAM,Rural,70-74,Secondary,4851,738,5589
23545,18,State - ASSAM,Rural,75-79,Secondary,2354,332,2686
23546,18,State - ASSAM,Rural,80+,Secondary,2367,744,3111
23547,18,State - ASSAM,Rural,Age not stated,Secondary,308,199,507
23548,18,State - ASSAM,Urban,All ages,Secondary,170297,155231,325528
23549,18,State - ASSAM,Urban,0-6,Secondary,0,0,0
23550,18,State - ASSAM,Urban,7,Secondary,0,0,0
23551,18,State - ASSAM,Urban,8,Secondary,0,0,0
23552,18,State - ASSAM,Urban,9,Secondary,0,0,0
23553,18,State - ASSAM,Urban,10,Secondary,0,0,0
23554,18,State - ASSAM,Urban,11,Secondary,0,0,0
23555,18,State - ASSAM,Urban,12,Secondary,0,0,0
23556,18,State - ASSAM,Urban,13,Secondary,0,0,0
23557,18,State - ASSAM,Urban,14,Secondary,0,0,0
23558,18,State - ASSAM,Urban,15,Secondary,6694,7154,13848
23559,18,State - ASSAM,Urban,16,Secondary,13291,13519,26810
23560,18,State - ASSAM,Urban,17,Secondary,19089,19073,38162
23561,18,State - ASSAM,Urban,18,Secondary,6065,5784,11849
23562,18,State - ASSAM,Urban,19,Secondary,4031,3854,7885
23563,18,State - ASSAM,Urban,20-24,Secondary,16511,16649,33160
23564,18,State - ASSAM,Urban,25-29,Secondary,17662,17373,35035
23565,18,State - ASSAM,Urban,30-34,Secondary,16234,15660,31894
23566,18,State - ASSAM,Urban,35-39,Secondary,16012,15271,31283
23567,18,State - ASSAM,Urban,40-44,Secondary,14185,11787,25972
23568,18,State - ASSAM,Urban,45-49,Secondary,11879,9895,21774
23569,18,State - ASSAM,Urban,50-54,Secondary,9507,6716,16223
23570,18,State - ASSAM,Urban,55-59,Secondary,6472,4672,11144
23571,18,State - ASSAM,Urban,60-64,Secondary,4786,3449,8235
23572,18,State - ASSAM,Urban,65-69,Secondary,3243,2014,5257
23573,18,State - ASSAM,Urban,70-74,Secondary,2113,1034,3147
23574,18,State - ASSAM,Urban,75-79,Secondary,1188,599,1787
23575,18,State - ASSAM,Urban,80+,Secondary,1197,627,1824
23576,18,State - ASSAM,Urban,Age not stated,Secondary,138,101,239
23577,19,State - WEST BENGAL,Total,All ages,Secondary,3151360,2279494,5430854
23578,19,State - WEST BENGAL,Total,0-6,Secondary,0,0,0
23579,19,State - WEST BENGAL,Total,7,Secondary,0,0,0
23580,19,State - WEST BENGAL,Total,8,Secondary,0,0,0
23581,19,State - WEST BENGAL,Total,9,Secondary,0,0,0
23582,19,State - WEST BENGAL,Total,10,Secondary,0,0,0
23583,19,State - WEST BENGAL,Total,11,Secondary,0,0,0
23584,19,State - WEST BENGAL,Total,12,Secondary,0,0,0
23585,19,State - WEST BENGAL,Total,13,Secondary,0,0,0
23586,19,State - WEST BENGAL,Total,14,Secondary,0,0,0
23587,19,State - WEST BENGAL,Total,15,Secondary,129148,130384,259532
23588,19,State - WEST BENGAL,Total,16,Secondary,238611,231942,470553
23589,19,State - WEST BENGAL,Total,17,Secondary,313136,283142,596278
23590,19,State - WEST BENGAL,Total,18,Secondary,188463,162992,351455
23591,19,State - WEST BENGAL,Total,19,Secondary,133377,116729,250106
23592,19,State - WEST BENGAL,Total,20-24,Secondary,430414,353060,783474
23593,19,State - WEST BENGAL,Total,25-29,Secondary,317650,235591,553241
23594,19,State - WEST BENGAL,Total,30-34,Secondary,261479,178962,440441
23595,19,State - WEST BENGAL,Total,35-39,Secondary,237974,152908,390882
23596,19,State - WEST BENGAL,Total,40-44,Secondary,207107,117254,324361
23597,19,State - WEST BENGAL,Total,45-49,Secondary,174564,97049,271613
23598,19,State - WEST BENGAL,Total,50-54,Secondary,157466,76892,234358
23599,19,State - WEST BENGAL,Total,55-59,Secondary,131211,54626,185837
23600,19,State - WEST BENGAL,Total,60-64,Secondary,83028,33907,116935
23601,19,State - WEST BENGAL,Total,65-69,Secondary,54621,20817,75438
23602,19,State - WEST BENGAL,Total,70-74,Secondary,37402,12690,50092
23603,19,State - WEST BENGAL,Total,75-79,Secondary,23807,7427,31234
23604,19,State - WEST BENGAL,Total,80+,Secondary,28655,10676,39331
23605,19,State - WEST BENGAL,Total,Age not stated,Secondary,3247,2446,5693
23606,19,State - WEST BENGAL,Rural,All ages,Secondary,1690072,1078845,2768917
23607,19,State - WEST BENGAL,Rural,0-6,Secondary,0,0,0
23608,19,State - WEST BENGAL,Rural,7,Secondary,0,0,0
23609,19,State - WEST BENGAL,Rural,8,Secondary,0,0,0
23610,19,State - WEST BENGAL,Rural,9,Secondary,0,0,0
23611,19,State - WEST BENGAL,Rural,10,Secondary,0,0,0
23612,19,State - WEST BENGAL,Rural,11,Secondary,0,0,0
23613,19,State - WEST BENGAL,Rural,12,Secondary,0,0,0
23614,19,State - WEST BENGAL,Rural,13,Secondary,0,0,0
23615,19,State - WEST BENGAL,Rural,14,Secondary,0,0,0
23616,19,State - WEST BENGAL,Rural,15,Secondary,78796,80360,159156
23617,19,State - WEST BENGAL,Rural,16,Secondary,149814,144422,294236
23618,19,State - WEST BENGAL,Rural,17,Secondary,195895,172415,368310
23619,19,State - WEST BENGAL,Rural,18,Secondary,117861,97469,215330
23620,19,State - WEST BENGAL,Rural,19,Secondary,83331,69524,152855
23621,19,State - WEST BENGAL,Rural,20-24,Secondary,266406,195786,462192
23622,19,State - WEST BENGAL,Rural,25-29,Secondary,177758,108102,285860
23623,19,State - WEST BENGAL,Rural,30-34,Secondary,131246,67931,199177
23624,19,State - WEST BENGAL,Rural,35-39,Secondary,112425,49187,161612
23625,19,State - WEST BENGAL,Rural,40-44,Secondary,94136,32325,126461
23626,19,State - WEST BENGAL,Rural,45-49,Secondary,73379,22464,95843
23627,19,State - WEST BENGAL,Rural,50-54,Secondary,66741,17322,84063
23628,19,State - WEST BENGAL,Rural,55-59,Secondary,60037,10983,71020
23629,19,State - WEST BENGAL,Rural,60-64,Secondary,34797,4425,39222
23630,19,State - WEST BENGAL,Rural,65-69,Secondary,19769,2123,21892
23631,19,State - WEST BENGAL,Rural,70-74,Secondary,11046,972,12018
23632,19,State - WEST BENGAL,Rural,75-79,Secondary,6744,581,7325
23633,19,State - WEST BENGAL,Rural,80+,Secondary,8647,1870,10517
23634,19,State - WEST BENGAL,Rural,Age not stated,Secondary,1244,584,1828
23635,19,State - WEST BENGAL,Urban,All ages,Secondary,1461288,1200649,2661937
23636,19,State - WEST BENGAL,Urban,0-6,Secondary,0,0,0
23637,19,State - WEST BENGAL,Urban,7,Secondary,0,0,0
23638,19,State - WEST BENGAL,Urban,8,Secondary,0,0,0
23639,19,State - WEST BENGAL,Urban,9,Secondary,0,0,0
23640,19,State - WEST BENGAL,Urban,10,Secondary,0,0,0
23641,19,State - WEST BENGAL,Urban,11,Secondary,0,0,0
23642,19,State - WEST BENGAL,Urban,12,Secondary,0,0,0
23643,19,State - WEST BENGAL,Urban,13,Secondary,0,0,0
23644,19,State - WEST BENGAL,Urban,14,Secondary,0,0,0
23645,19,State - WEST BENGAL,Urban,15,Secondary,50352,50024,100376
23646,19,State - WEST BENGAL,Urban,16,Secondary,88797,87520,176317
23647,19,State - WEST BENGAL,Urban,17,Secondary,117241,110727,227968
23648,19,State - WEST BENGAL,Urban,18,Secondary,70602,65523,136125
23649,19,State - WEST BENGAL,Urban,19,Secondary,50046,47205,97251
23650,19,State - WEST BENGAL,Urban,20-24,Secondary,164008,157274,321282
23651,19,State - WEST BENGAL,Urban,25-29,Secondary,139892,127489,267381
23652,19,State - WEST BENGAL,Urban,30-34,Secondary,130233,111031,241264
23653,19,State - WEST BENGAL,Urban,35-39,Secondary,125549,103721,229270
23654,19,State - WEST BENGAL,Urban,40-44,Secondary,112971,84929,197900
23655,19,State - WEST BENGAL,Urban,45-49,Secondary,101185,74585,175770
23656,19,State - WEST BENGAL,Urban,50-54,Secondary,90725,59570,150295
23657,19,State - WEST BENGAL,Urban,55-59,Secondary,71174,43643,114817
23658,19,State - WEST BENGAL,Urban,60-64,Secondary,48231,29482,77713
23659,19,State - WEST BENGAL,Urban,65-69,Secondary,34852,18694,53546
23660,19,State - WEST BENGAL,Urban,70-74,Secondary,26356,11718,38074
23661,19,State - WEST BENGAL,Urban,75-79,Secondary,17063,6846,23909
23662,19,State - WEST BENGAL,Urban,80+,Secondary,20008,8806,28814
23663,19,State - WEST BENGAL,Urban,Age not stated,Secondary,2003,1862,3865
23664,20,State - JHARKHAND,Total,All ages,Secondary,1569270,904555,2473825
23665,20,State - JHARKHAND,Total,0-6,Secondary,0,0,0
23666,20,State - JHARKHAND,Total,7,Secondary,0,0,0
23667,20,State - JHARKHAND,Total,8,Secondary,0,0,0
23668,20,State - JHARKHAND,Total,9,Secondary,0,0,0
23669,20,State - JHARKHAND,Total,10,Secondary,0,0,0
23670,20,State - JHARKHAND,Total,11,Secondary,0,0,0
23671,20,State - JHARKHAND,Total,12,Secondary,0,0,0
23672,20,State - JHARKHAND,Total,13,Secondary,0,0,0
23673,20,State - JHARKHAND,Total,14,Secondary,0,0,0
23674,20,State - JHARKHAND,Total,15,Secondary,64017,53666,117683
23675,20,State - JHARKHAND,Total,16,Secondary,113307,92238,205545
23676,20,State - JHARKHAND,Total,17,Secondary,127594,98041,225635
23677,20,State - JHARKHAND,Total,18,Secondary,88947,59243,148190
23678,20,State - JHARKHAND,Total,19,Secondary,48392,34458,82850
23679,20,State - JHARKHAND,Total,20-24,Secondary,200457,139716,340173
23680,20,State - JHARKHAND,Total,25-29,Secondary,177317,113547,290864
23681,20,State - JHARKHAND,Total,30-34,Secondary,158967,87823,246790
23682,20,State - JHARKHAND,Total,35-39,Secondary,141157,69566,210723
23683,20,State - JHARKHAND,Total,40-44,Secondary,112470,47894,160364
23684,20,State - JHARKHAND,Total,45-49,Secondary,87725,36197,123922
23685,20,State - JHARKHAND,Total,50-54,Secondary,69344,25325,94669
23686,20,State - JHARKHAND,Total,55-59,Secondary,59868,17540,77408
23687,20,State - JHARKHAND,Total,60-64,Secondary,47005,11947,58952
23688,20,State - JHARKHAND,Total,65-69,Secondary,32204,6797,39001
23689,20,State - JHARKHAND,Total,70-74,Secondary,18906,3252,22158
23690,20,State - JHARKHAND,Total,75-79,Secondary,8320,1598,9918
23691,20,State - JHARKHAND,Total,80+,Secondary,7200,1935,9135
23692,20,State - JHARKHAND,Total,Age not stated,Secondary,6073,3772,9845
23693,20,State - JHARKHAND,Rural,All ages,Secondary,972816,457478,1430294
23694,20,State - JHARKHAND,Rural,0-6,Secondary,0,0,0
23695,20,State - JHARKHAND,Rural,7,Secondary,0,0,0
23696,20,State - JHARKHAND,Rural,8,Secondary,0,0,0
23697,20,State - JHARKHAND,Rural,9,Secondary,0,0,0
23698,20,State - JHARKHAND,Rural,10,Secondary,0,0,0
23699,20,State - JHARKHAND,Rural,11,Secondary,0,0,0
23700,20,State - JHARKHAND,Rural,12,Secondary,0,0,0
23701,20,State - JHARKHAND,Rural,13,Secondary,0,0,0
23702,20,State - JHARKHAND,Rural,14,Secondary,0,0,0
23703,20,State - JHARKHAND,Rural,15,Secondary,40411,30710,71121
23704,20,State - JHARKHAND,Rural,16,Secondary,70970,52326,123296
23705,20,State - JHARKHAND,Rural,17,Secondary,77392,53017,130409
23706,20,State - JHARKHAND,Rural,18,Secondary,62062,37442,99504
23707,20,State - JHARKHAND,Rural,19,Secondary,33286,21982,55268
23708,20,State - JHARKHAND,Rural,20-24,Secondary,137042,83480,220522
23709,20,State - JHARKHAND,Rural,25-29,Secondary,114446,58396,172842
23710,20,State - JHARKHAND,Rural,30-34,Secondary,101894,41933,143827
23711,20,State - JHARKHAND,Rural,35-39,Secondary,89899,29706,119605
23712,20,State - JHARKHAND,Rural,40-44,Secondary,67588,17971,85559
23713,20,State - JHARKHAND,Rural,45-49,Secondary,49773,11322,61095
23714,20,State - JHARKHAND,Rural,50-54,Secondary,36672,6899,43571
23715,20,State - JHARKHAND,Rural,55-59,Secondary,30514,4893,35407
23716,20,State - JHARKHAND,Rural,60-64,Secondary,25110,2923,28033
23717,20,State - JHARKHAND,Rural,65-69,Secondary,17233,1835,19068
23718,20,State - JHARKHAND,Rural,70-74,Secondary,9301,726,10027
23719,20,State - JHARKHAND,Rural,75-79,Secondary,3787,336,4123
23720,20,State - JHARKHAND,Rural,80+,Secondary,3220,612,3832
23721,20,State - JHARKHAND,Rural,Age not stated,Secondary,2216,969,3185
23722,20,State - JHARKHAND,Urban,All ages,Secondary,596454,447077,1043531
23723,20,State - JHARKHAND,Urban,0-6,Secondary,0,0,0
23724,20,State - JHARKHAND,Urban,7,Secondary,0,0,0
23725,20,State - JHARKHAND,Urban,8,Secondary,0,0,0
23726,20,State - JHARKHAND,Urban,9,Secondary,0,0,0
23727,20,State - JHARKHAND,Urban,10,Secondary,0,0,0
23728,20,State - JHARKHAND,Urban,11,Secondary,0,0,0
23729,20,State - JHARKHAND,Urban,12,Secondary,0,0,0
23730,20,State - JHARKHAND,Urban,13,Secondary,0,0,0
23731,20,State - JHARKHAND,Urban,14,Secondary,0,0,0
23732,20,State - JHARKHAND,Urban,15,Secondary,23606,22956,46562
23733,20,State - JHARKHAND,Urban,16,Secondary,42337,39912,82249
23734,20,State - JHARKHAND,Urban,17,Secondary,50202,45024,95226
23735,20,State - JHARKHAND,Urban,18,Secondary,26885,21801,48686
23736,20,State - JHARKHAND,Urban,19,Secondary,15106,12476,27582
23737,20,State - JHARKHAND,Urban,20-24,Secondary,63415,56236,119651
23738,20,State - JHARKHAND,Urban,25-29,Secondary,62871,55151,118022
23739,20,State - JHARKHAND,Urban,30-34,Secondary,57073,45890,102963
23740,20,State - JHARKHAND,Urban,35-39,Secondary,51258,39860,91118
23741,20,State - JHARKHAND,Urban,40-44,Secondary,44882,29923,74805
23742,20,State - JHARKHAND,Urban,45-49,Secondary,37952,24875,62827
23743,20,State - JHARKHAND,Urban,50-54,Secondary,32672,18426,51098
23744,20,State - JHARKHAND,Urban,55-59,Secondary,29354,12647,42001
23745,20,State - JHARKHAND,Urban,60-64,Secondary,21895,9024,30919
23746,20,State - JHARKHAND,Urban,65-69,Secondary,14971,4962,19933
23747,20,State - JHARKHAND,Urban,70-74,Secondary,9605,2526,12131
23748,20,State - JHARKHAND,Urban,75-79,Secondary,4533,1262,5795
23749,20,State - JHARKHAND,Urban,80+,Secondary,3980,1323,5303
23750,20,State - JHARKHAND,Urban,Age not stated,Secondary,3857,2803,6660
23751,21,State - ODISHA,Total,All ages,Secondary,1885832,1331523,3217355
23752,21,State - ODISHA,Total,0-6,Secondary,0,0,0
23753,21,State - ODISHA,Total,7,Secondary,0,0,0
23754,21,State - ODISHA,Total,8,Secondary,0,0,0
23755,21,State - ODISHA,Total,9,Secondary,0,0,0
23756,21,State - ODISHA,Total,10,Secondary,0,0,0
23757,21,State - ODISHA,Total,11,Secondary,0,0,0
23758,21,State - ODISHA,Total,12,Secondary,0,0,0
23759,21,State - ODISHA,Total,13,Secondary,0,0,0
23760,21,State - ODISHA,Total,14,Secondary,0,0,0
23761,21,State - ODISHA,Total,15,Secondary,84077,82838,166915
23762,21,State - ODISHA,Total,16,Secondary,127232,119803,247035
23763,21,State - ODISHA,Total,17,Secondary,141723,126517,268240
23764,21,State - ODISHA,Total,18,Secondary,64508,57621,122129
23765,21,State - ODISHA,Total,19,Secondary,45068,42585,87653
23766,21,State - ODISHA,Total,20-24,Secondary,227424,219339,446763
23767,21,State - ODISHA,Total,25-29,Secondary,230209,203209,433418
23768,21,State - ODISHA,Total,30-34,Secondary,184239,139629,323868
23769,21,State - ODISHA,Total,35-39,Secondary,160617,109861,270478
23770,21,State - ODISHA,Total,40-44,Secondary,144926,84832,229758
23771,21,State - ODISHA,Total,45-49,Secondary,126007,59668,185675
23772,21,State - ODISHA,Total,50-54,Secondary,103284,37056,140340
23773,21,State - ODISHA,Total,55-59,Secondary,92826,22963,115789
23774,21,State - ODISHA,Total,60-64,Secondary,70841,11686,82527
23775,21,State - ODISHA,Total,65-69,Secondary,37804,5049,42853
23776,21,State - ODISHA,Total,70-74,Secondary,21229,2668,23897
23777,21,State - ODISHA,Total,75-79,Secondary,10703,1245,11948
23778,21,State - ODISHA,Total,80+,Secondary,8856,1874,10730
23779,21,State - ODISHA,Total,Age not stated,Secondary,4259,3080,7339
23780,21,State - ODISHA,Rural,All ages,Secondary,1400990,932570,2333560
23781,21,State - ODISHA,Rural,0-6,Secondary,0,0,0
23782,21,State - ODISHA,Rural,7,Secondary,0,0,0
23783,21,State - ODISHA,Rural,8,Secondary,0,0,0
23784,21,State - ODISHA,Rural,9,Secondary,0,0,0
23785,21,State - ODISHA,Rural,10,Secondary,0,0,0
23786,21,State - ODISHA,Rural,11,Secondary,0,0,0
23787,21,State - ODISHA,Rural,12,Secondary,0,0,0
23788,21,State - ODISHA,Rural,13,Secondary,0,0,0
23789,21,State - ODISHA,Rural,14,Secondary,0,0,0
23790,21,State - ODISHA,Rural,15,Secondary,63403,62038,125441
23791,21,State - ODISHA,Rural,16,Secondary,93957,88083,182040
23792,21,State - ODISHA,Rural,17,Secondary,103085,91091,194176
23793,21,State - ODISHA,Rural,18,Secondary,52429,46343,98772
23794,21,State - ODISHA,Rural,19,Secondary,36713,34302,71015
23795,21,State - ODISHA,Rural,20-24,Secondary,182003,171834,353837
23796,21,State - ODISHA,Rural,25-29,Secondary,181030,153352,334382
23797,21,State - ODISHA,Rural,30-34,Secondary,140338,99058,239396
23798,21,State - ODISHA,Rural,35-39,Secondary,117940,70082,188022
23799,21,State - ODISHA,Rural,40-44,Secondary,102445,48899,151344
23800,21,State - ODISHA,Rural,45-49,Secondary,87020,30289,117309
23801,21,State - ODISHA,Rural,50-54,Secondary,69705,16839,86544
23802,21,State - ODISHA,Rural,55-59,Secondary,65279,9964,75243
23803,21,State - ODISHA,Rural,60-64,Secondary,51450,4497,55947
23804,21,State - ODISHA,Rural,65-69,Secondary,26445,1808,28253
23805,21,State - ODISHA,Rural,70-74,Secondary,13390,857,14247
23806,21,State - ODISHA,Rural,75-79,Secondary,6369,384,6753
23807,21,State - ODISHA,Rural,80+,Secondary,5015,887,5902
23808,21,State - ODISHA,Rural,Age not stated,Secondary,2974,1963,4937
23809,21,State - ODISHA,Urban,All ages,Secondary,484842,398953,883795
23810,21,State - ODISHA,Urban,0-6,Secondary,0,0,0
23811,21,State - ODISHA,Urban,7,Secondary,0,0,0
23812,21,State - ODISHA,Urban,8,Secondary,0,0,0
23813,21,State - ODISHA,Urban,9,Secondary,0,0,0
23814,21,State - ODISHA,Urban,10,Secondary,0,0,0
23815,21,State - ODISHA,Urban,11,Secondary,0,0,0
23816,21,State - ODISHA,Urban,12,Secondary,0,0,0
23817,21,State - ODISHA,Urban,13,Secondary,0,0,0
23818,21,State - ODISHA,Urban,14,Secondary,0,0,0
23819,21,State - ODISHA,Urban,15,Secondary,20674,20800,41474
23820,21,State - ODISHA,Urban,16,Secondary,33275,31720,64995
23821,21,State - ODISHA,Urban,17,Secondary,38638,35426,74064
23822,21,State - ODISHA,Urban,18,Secondary,12079,11278,23357
23823,21,State - ODISHA,Urban,19,Secondary,8355,8283,16638
23824,21,State - ODISHA,Urban,20-24,Secondary,45421,47505,92926
23825,21,State - ODISHA,Urban,25-29,Secondary,49179,49857,99036
23826,21,State - ODISHA,Urban,30-34,Secondary,43901,40571,84472
23827,21,State - ODISHA,Urban,35-39,Secondary,42677,39779,82456
23828,21,State - ODISHA,Urban,40-44,Secondary,42481,35933,78414
23829,21,State - ODISHA,Urban,45-49,Secondary,38987,29379,68366
23830,21,State - ODISHA,Urban,50-54,Secondary,33579,20217,53796
23831,21,State - ODISHA,Urban,55-59,Secondary,27547,12999,40546
23832,21,State - ODISHA,Urban,60-64,Secondary,19391,7189,26580
23833,21,State - ODISHA,Urban,65-69,Secondary,11359,3241,14600
23834,21,State - ODISHA,Urban,70-74,Secondary,7839,1811,9650
23835,21,State - ODISHA,Urban,75-79,Secondary,4334,861,5195
23836,21,State - ODISHA,Urban,80+,Secondary,3841,987,4828
23837,21,State - ODISHA,Urban,Age not stated,Secondary,1285,1117,2402
23838,22,State - CHHATTISGARH,Total,All ages,Secondary,1003394,625093,1628487
23839,22,State - CHHATTISGARH,Total,0-6,Secondary,0,0,0
23840,22,State - CHHATTISGARH,Total,7,Secondary,0,0,0
23841,22,State - CHHATTISGARH,Total,8,Secondary,0,0,0
23842,22,State - CHHATTISGARH,Total,9,Secondary,0,0,0
23843,22,State - CHHATTISGARH,Total,10,Secondary,0,0,0
23844,22,State - CHHATTISGARH,Total,11,Secondary,0,0,0
23845,22,State - CHHATTISGARH,Total,12,Secondary,0,0,0
23846,22,State - CHHATTISGARH,Total,13,Secondary,0,0,0
23847,22,State - CHHATTISGARH,Total,14,Secondary,0,0,0
23848,22,State - CHHATTISGARH,Total,15,Secondary,23885,24591,48476
23849,22,State - CHHATTISGARH,Total,16,Secondary,64048,63974,128022
23850,22,State - CHHATTISGARH,Total,17,Secondary,86849,82074,168923
23851,22,State - CHHATTISGARH,Total,18,Secondary,68768,56349,125117
23852,22,State - CHHATTISGARH,Total,19,Secondary,40935,33132,74067
23853,22,State - CHHATTISGARH,Total,20-24,Secondary,141359,108247,249606
23854,22,State - CHHATTISGARH,Total,25-29,Secondary,107085,70917,178002
23855,22,State - CHHATTISGARH,Total,30-34,Secondary,96342,53900,150242
23856,22,State - CHHATTISGARH,Total,35-39,Secondary,85442,40322,125764
23857,22,State - CHHATTISGARH,Total,40-44,Secondary,78833,30004,108837
23858,22,State - CHHATTISGARH,Total,45-49,Secondary,64450,21308,85758
23859,22,State - CHHATTISGARH,Total,50-54,Secondary,43677,14606,58283
23860,22,State - CHHATTISGARH,Total,55-59,Secondary,38355,10312,48667
23861,22,State - CHHATTISGARH,Total,60-64,Secondary,30631,6733,37364
23862,22,State - CHHATTISGARH,Total,65-69,Secondary,16670,4178,20848
23863,22,State - CHHATTISGARH,Total,70-74,Secondary,8524,1826,10350
23864,22,State - CHHATTISGARH,Total,75-79,Secondary,3650,845,4495
23865,22,State - CHHATTISGARH,Total,80+,Secondary,3098,1223,4321
23866,22,State - CHHATTISGARH,Total,Age not stated,Secondary,793,552,1345
23867,22,State - CHHATTISGARH,Rural,All ages,Secondary,629827,344037,973864
23868,22,State - CHHATTISGARH,Rural,0-6,Secondary,0,0,0
23869,22,State - CHHATTISGARH,Rural,7,Secondary,0,0,0
23870,22,State - CHHATTISGARH,Rural,8,Secondary,0,0,0
23871,22,State - CHHATTISGARH,Rural,9,Secondary,0,0,0
23872,22,State - CHHATTISGARH,Rural,10,Secondary,0,0,0
23873,22,State - CHHATTISGARH,Rural,11,Secondary,0,0,0
23874,22,State - CHHATTISGARH,Rural,12,Secondary,0,0,0
23875,22,State - CHHATTISGARH,Rural,13,Secondary,0,0,0
23876,22,State - CHHATTISGARH,Rural,14,Secondary,0,0,0
23877,22,State - CHHATTISGARH,Rural,15,Secondary,13799,13553,27352
23878,22,State - CHHATTISGARH,Rural,16,Secondary,41113,39424,80537
23879,22,State - CHHATTISGARH,Rural,17,Secondary,57708,51663,109371
23880,22,State - CHHATTISGARH,Rural,18,Secondary,50839,40115,90954
23881,22,State - CHHATTISGARH,Rural,19,Secondary,30278,23670,53948
23882,22,State - CHHATTISGARH,Rural,20-24,Secondary,99062,69899,168961
23883,22,State - CHHATTISGARH,Rural,25-29,Secondary,69362,39241,108603
23884,22,State - CHHATTISGARH,Rural,30-34,Secondary,60554,27112,87666
23885,22,State - CHHATTISGARH,Rural,35-39,Secondary,53730,16699,70429
23886,22,State - CHHATTISGARH,Rural,40-44,Secondary,47088,9358,56446
23887,22,State - CHHATTISGARH,Rural,45-49,Secondary,35396,5179,40575
23888,22,State - CHHATTISGARH,Rural,50-54,Secondary,20943,3038,23981
23889,22,State - CHHATTISGARH,Rural,55-59,Secondary,19299,2153,21452
23890,22,State - CHHATTISGARH,Rural,60-64,Secondary,16613,1103,17716
23891,22,State - CHHATTISGARH,Rural,65-69,Secondary,8310,842,9152
23892,22,State - CHHATTISGARH,Rural,70-74,Secondary,3213,251,3464
23893,22,State - CHHATTISGARH,Rural,75-79,Secondary,1042,111,1153
23894,22,State - CHHATTISGARH,Rural,80+,Secondary,1147,434,1581
23895,22,State - CHHATTISGARH,Rural,Age not stated,Secondary,331,192,523
23896,22,State - CHHATTISGARH,Urban,All ages,Secondary,373567,281056,654623
23897,22,State - CHHATTISGARH,Urban,0-6,Secondary,0,0,0
23898,22,State - CHHATTISGARH,Urban,7,Secondary,0,0,0
23899,22,State - CHHATTISGARH,Urban,8,Secondary,0,0,0
23900,22,State - CHHATTISGARH,Urban,9,Secondary,0,0,0
23901,22,State - CHHATTISGARH,Urban,10,Secondary,0,0,0
23902,22,State - CHHATTISGARH,Urban,11,Secondary,0,0,0
23903,22,State - CHHATTISGARH,Urban,12,Secondary,0,0,0
23904,22,State - CHHATTISGARH,Urban,13,Secondary,0,0,0
23905,22,State - CHHATTISGARH,Urban,14,Secondary,0,0,0
23906,22,State - CHHATTISGARH,Urban,15,Secondary,10086,11038,21124
23907,22,State - CHHATTISGARH,Urban,16,Secondary,22935,24550,47485
23908,22,State - CHHATTISGARH,Urban,17,Secondary,29141,30411,59552
23909,22,State - CHHATTISGARH,Urban,18,Secondary,17929,16234,34163
23910,22,State - CHHATTISGARH,Urban,19,Secondary,10657,9462,20119
23911,22,State - CHHATTISGARH,Urban,20-24,Secondary,42297,38348,80645
23912,22,State - CHHATTISGARH,Urban,25-29,Secondary,37723,31676,69399
23913,22,State - CHHATTISGARH,Urban,30-34,Secondary,35788,26788,62576
23914,22,State - CHHATTISGARH,Urban,35-39,Secondary,31712,23623,55335
23915,22,State - CHHATTISGARH,Urban,40-44,Secondary,31745,20646,52391
23916,22,State - CHHATTISGARH,Urban,45-49,Secondary,29054,16129,45183
23917,22,State - CHHATTISGARH,Urban,50-54,Secondary,22734,11568,34302
23918,22,State - CHHATTISGARH,Urban,55-59,Secondary,19056,8159,27215
23919,22,State - CHHATTISGARH,Urban,60-64,Secondary,14018,5630,19648
23920,22,State - CHHATTISGARH,Urban,65-69,Secondary,8360,3336,11696
23921,22,State - CHHATTISGARH,Urban,70-74,Secondary,5311,1575,6886
23922,22,State - CHHATTISGARH,Urban,75-79,Secondary,2608,734,3342
23923,22,State - CHHATTISGARH,Urban,80+,Secondary,1951,789,2740
23924,22,State - CHHATTISGARH,Urban,Age not stated,Secondary,462,360,822
23925,23,State - MADHYA PRADESH,Total,All ages,Secondary,2819198,1622068,4441266
23926,23,State - MADHYA PRADESH,Total,0-6,Secondary,0,0,0
23927,23,State - MADHYA PRADESH,Total,7,Secondary,0,0,0
23928,23,State - MADHYA PRADESH,Total,8,Secondary,0,0,0
23929,23,State - MADHYA PRADESH,Total,9,Secondary,0,0,0
23930,23,State - MADHYA PRADESH,Total,10,Secondary,0,0,0
23931,23,State - MADHYA PRADESH,Total,11,Secondary,0,0,0
23932,23,State - MADHYA PRADESH,Total,12,Secondary,0,0,0
23933,23,State - MADHYA PRADESH,Total,13,Secondary,0,0,0
23934,23,State - MADHYA PRADESH,Total,14,Secondary,0,0,0
23935,23,State - MADHYA PRADESH,Total,15,Secondary,99241,82450,181691
23936,23,State - MADHYA PRADESH,Total,16,Secondary,201506,163434,364940
23937,23,State - MADHYA PRADESH,Total,17,Secondary,245949,196418,442367
23938,23,State - MADHYA PRADESH,Total,18,Secondary,191116,126773,317889
23939,23,State - MADHYA PRADESH,Total,19,Secondary,113771,78274,192045
23940,23,State - MADHYA PRADESH,Total,20-24,Secondary,443961,277334,721295
23941,23,State - MADHYA PRADESH,Total,25-29,Secondary,323618,192549,516167
23942,23,State - MADHYA PRADESH,Total,30-34,Secondary,270687,143736,414423
23943,23,State - MADHYA PRADESH,Total,35-39,Secondary,231271,109910,341181
23944,23,State - MADHYA PRADESH,Total,40-44,Secondary,193496,79488,272984
23945,23,State - MADHYA PRADESH,Total,45-49,Secondary,149015,57264,206279
23946,23,State - MADHYA PRADESH,Total,50-54,Secondary,107200,39948,147148
23947,23,State - MADHYA PRADESH,Total,55-59,Secondary,89012,27761,116773
23948,23,State - MADHYA PRADESH,Total,60-64,Secondary,68431,19022,87453
23949,23,State - MADHYA PRADESH,Total,65-69,Secondary,41170,11937,53107
23950,23,State - MADHYA PRADESH,Total,70-74,Secondary,24064,5984,30048
23951,23,State - MADHYA PRADESH,Total,75-79,Secondary,11140,3267,14407
23952,23,State - MADHYA PRADESH,Total,80+,Secondary,11655,4562,16217
23953,23,State - MADHYA PRADESH,Total,Age not stated,Secondary,2895,1957,4852
23954,23,State - MADHYA PRADESH,Rural,All ages,Secondary,1632081,740755,2372836
23955,23,State - MADHYA PRADESH,Rural,0-6,Secondary,0,0,0
23956,23,State - MADHYA PRADESH,Rural,7,Secondary,0,0,0
23957,23,State - MADHYA PRADESH,Rural,8,Secondary,0,0,0
23958,23,State - MADHYA PRADESH,Rural,9,Secondary,0,0,0
23959,23,State - MADHYA PRADESH,Rural,10,Secondary,0,0,0
23960,23,State - MADHYA PRADESH,Rural,11,Secondary,0,0,0
23961,23,State - MADHYA PRADESH,Rural,12,Secondary,0,0,0
23962,23,State - MADHYA PRADESH,Rural,13,Secondary,0,0,0
23963,23,State - MADHYA PRADESH,Rural,14,Secondary,0,0,0
23964,23,State - MADHYA PRADESH,Rural,15,Secondary,52922,37741,90663
23965,23,State - MADHYA PRADESH,Rural,16,Secondary,114318,81227,195545
23966,23,State - MADHYA PRADESH,Rural,17,Secondary,140035,97622,237657
23967,23,State - MADHYA PRADESH,Rural,18,Secondary,128636,77623,206259
23968,23,State - MADHYA PRADESH,Rural,19,Secondary,77419,48818,126237
23969,23,State - MADHYA PRADESH,Rural,20-24,Secondary,295779,155119,450898
23970,23,State - MADHYA PRADESH,Rural,25-29,Secondary,194383,88821,283204
23971,23,State - MADHYA PRADESH,Rural,30-34,Secondary,154679,59586,214265
23972,23,State - MADHYA PRADESH,Rural,35-39,Secondary,131435,38337,169772
23973,23,State - MADHYA PRADESH,Rural,40-44,Secondary,106036,22665,128701
23974,23,State - MADHYA PRADESH,Rural,45-49,Secondary,76406,12727,89133
23975,23,State - MADHYA PRADESH,Rural,50-54,Secondary,49302,7435,56737
23976,23,State - MADHYA PRADESH,Rural,55-59,Secondary,41593,4886,46479
23977,23,State - MADHYA PRADESH,Rural,60-64,Secondary,32749,2787,35536
23978,23,State - MADHYA PRADESH,Rural,65-69,Secondary,18600,2147,20747
23979,23,State - MADHYA PRADESH,Rural,70-74,Secondary,9052,818,9870
23980,23,State - MADHYA PRADESH,Rural,75-79,Secondary,3376,506,3882
23981,23,State - MADHYA PRADESH,Rural,80+,Secondary,4168,1311,5479
23982,23,State - MADHYA PRADESH,Rural,Age not stated,Secondary,1193,579,1772
23983,23,State - MADHYA PRADESH,Urban,All ages,Secondary,1187117,881313,2068430
23984,23,State - MADHYA PRADESH,Urban,0-6,Secondary,0,0,0
23985,23,State - MADHYA PRADESH,Urban,7,Secondary,0,0,0
23986,23,State - MADHYA PRADESH,Urban,8,Secondary,0,0,0
23987,23,State - MADHYA PRADESH,Urban,9,Secondary,0,0,0
23988,23,State - MADHYA PRADESH,Urban,10,Secondary,0,0,0
23989,23,State - MADHYA PRADESH,Urban,11,Secondary,0,0,0
23990,23,State - MADHYA PRADESH,Urban,12,Secondary,0,0,0
23991,23,State - MADHYA PRADESH,Urban,13,Secondary,0,0,0
23992,23,State - MADHYA PRADESH,Urban,14,Secondary,0,0,0
23993,23,State - MADHYA PRADESH,Urban,15,Secondary,46319,44709,91028
23994,23,State - MADHYA PRADESH,Urban,16,Secondary,87188,82207,169395
23995,23,State - MADHYA PRADESH,Urban,17,Secondary,105914,98796,204710
23996,23,State - MADHYA PRADESH,Urban,18,Secondary,62480,49150,111630
23997,23,State - MADHYA PRADESH,Urban,19,Secondary,36352,29456,65808
23998,23,State - MADHYA PRADESH,Urban,20-24,Secondary,148182,122215,270397
23999,23,State - MADHYA PRADESH,Urban,25-29,Secondary,129235,103728,232963
24000,23,State - MADHYA PRADESH,Urban,30-34,Secondary,116008,84150,200158
24001,23,State - MADHYA PRADESH,Urban,35-39,Secondary,99836,71573,171409
24002,23,State - MADHYA PRADESH,Urban,40-44,Secondary,87460,56823,144283
24003,23,State - MADHYA PRADESH,Urban,45-49,Secondary,72609,44537,117146
24004,23,State - MADHYA PRADESH,Urban,50-54,Secondary,57898,32513,90411
24005,23,State - MADHYA PRADESH,Urban,55-59,Secondary,47419,22875,70294
24006,23,State - MADHYA PRADESH,Urban,60-64,Secondary,35682,16235,51917
24007,23,State - MADHYA PRADESH,Urban,65-69,Secondary,22570,9790,32360
24008,23,State - MADHYA PRADESH,Urban,70-74,Secondary,15012,5166,20178
24009,23,State - MADHYA PRADESH,Urban,75-79,Secondary,7764,2761,10525
24010,23,State - MADHYA PRADESH,Urban,80+,Secondary,7487,3251,10738
24011,23,State - MADHYA PRADESH,Urban,Age not stated,Secondary,1702,1378,3080
24012,24,State - GUJARAT,Total,All ages,Secondary,3788353,2343644,6131997
24013,24,State - GUJARAT,Total,0-6,Secondary,0,0,0
24014,24,State - GUJARAT,Total,7,Secondary,0,0,0
24015,24,State - GUJARAT,Total,8,Secondary,0,0,0
24016,24,State - GUJARAT,Total,9,Secondary,0,0,0
24017,24,State - GUJARAT,Total,10,Secondary,0,0,0
24018,24,State - GUJARAT,Total,11,Secondary,0,0,0
24019,24,State - GUJARAT,Total,12,Secondary,0,0,0
24020,24,State - GUJARAT,Total,13,Secondary,0,0,0
24021,24,State - GUJARAT,Total,14,Secondary,0,0,0
24022,24,State - GUJARAT,Total,15,Secondary,152018,114962,266980
24023,24,State - GUJARAT,Total,16,Secondary,245176,182898,428074
24024,24,State - GUJARAT,Total,17,Secondary,282290,203486,485776
24025,24,State - GUJARAT,Total,18,Secondary,139110,87753,226863
24026,24,State - GUJARAT,Total,19,Secondary,95100,61889,156989
24027,24,State - GUJARAT,Total,20-24,Secondary,469516,320108,789624
24028,24,State - GUJARAT,Total,25-29,Secondary,457966,301121,759087
24029,24,State - GUJARAT,Total,30-34,Secondary,425929,263182,689111
24030,24,State - GUJARAT,Total,35-39,Secondary,355830,205620,561450
24031,24,State - GUJARAT,Total,40-44,Secondary,304414,170536,474950
24032,24,State - GUJARAT,Total,45-49,Secondary,240004,138179,378183
24033,24,State - GUJARAT,Total,50-54,Secondary,201782,108782,310564
24034,24,State - GUJARAT,Total,55-59,Secondary,156571,77754,234325
24035,24,State - GUJARAT,Total,60-64,Secondary,112281,47877,160158
24036,24,State - GUJARAT,Total,65-69,Secondary,64683,24877,89560
24037,24,State - GUJARAT,Total,70-74,Secondary,35969,12325,48294
24038,24,State - GUJARAT,Total,75-79,Secondary,18467,5851,24318
24039,24,State - GUJARAT,Total,80+,Secondary,16573,6781,23354
24040,24,State - GUJARAT,Total,Age not stated,Secondary,14674,9663,24337
24041,24,State - GUJARAT,Rural,All ages,Secondary,1708455,904873,2613328
24042,24,State - GUJARAT,Rural,0-6,Secondary,0,0,0
24043,24,State - GUJARAT,Rural,7,Secondary,0,0,0
24044,24,State - GUJARAT,Rural,8,Secondary,0,0,0
24045,24,State - GUJARAT,Rural,9,Secondary,0,0,0
24046,24,State - GUJARAT,Rural,10,Secondary,0,0,0
24047,24,State - GUJARAT,Rural,11,Secondary,0,0,0
24048,24,State - GUJARAT,Rural,12,Secondary,0,0,0
24049,24,State - GUJARAT,Rural,13,Secondary,0,0,0
24050,24,State - GUJARAT,Rural,14,Secondary,0,0,0
24051,24,State - GUJARAT,Rural,15,Secondary,75723,53616,129339
24052,24,State - GUJARAT,Rural,16,Secondary,123024,85477,208501
24053,24,State - GUJARAT,Rural,17,Secondary,139600,94378,233978
24054,24,State - GUJARAT,Rural,18,Secondary,74298,45669,119967
24055,24,State - GUJARAT,Rural,19,Secondary,48227,31376,79603
24056,24,State - GUJARAT,Rural,20-24,Secondary,222291,148161,370452
24057,24,State - GUJARAT,Rural,25-29,Secondary,202040,118977,321017
24058,24,State - GUJARAT,Rural,30-34,Secondary,193225,102123,295348
24059,24,State - GUJARAT,Rural,35-39,Secondary,165111,75671,240782
24060,24,State - GUJARAT,Rural,40-44,Secondary,135698,54326,190024
24061,24,State - GUJARAT,Rural,45-49,Secondary,100439,36592,137031
24062,24,State - GUJARAT,Rural,50-54,Secondary,80229,25112,105341
24063,24,State - GUJARAT,Rural,55-59,Secondary,60934,15574,76508
24064,24,State - GUJARAT,Rural,60-64,Secondary,43061,8057,51118
24065,24,State - GUJARAT,Rural,65-69,Secondary,21391,3507,24898
24066,24,State - GUJARAT,Rural,70-74,Secondary,9695,1228,10923
24067,24,State - GUJARAT,Rural,75-79,Secondary,3929,549,4478
24068,24,State - GUJARAT,Rural,80+,Secondary,4070,1273,5343
24069,24,State - GUJARAT,Rural,Age not stated,Secondary,5470,3207,8677
24070,24,State - GUJARAT,Urban,All ages,Secondary,2079898,1438771,3518669
24071,24,State - GUJARAT,Urban,0-6,Secondary,0,0,0
24072,24,State - GUJARAT,Urban,7,Secondary,0,0,0
24073,24,State - GUJARAT,Urban,8,Secondary,0,0,0
24074,24,State - GUJARAT,Urban,9,Secondary,0,0,0
24075,24,State - GUJARAT,Urban,10,Secondary,0,0,0
24076,24,State - GUJARAT,Urban,11,Secondary,0,0,0
24077,24,State - GUJARAT,Urban,12,Secondary,0,0,0
24078,24,State - GUJARAT,Urban,13,Secondary,0,0,0
24079,24,State - GUJARAT,Urban,14,Secondary,0,0,0
24080,24,State - GUJARAT,Urban,15,Secondary,76295,61346,137641
24081,24,State - GUJARAT,Urban,16,Secondary,122152,97421,219573
24082,24,State - GUJARAT,Urban,17,Secondary,142690,109108,251798
24083,24,State - GUJARAT,Urban,18,Secondary,64812,42084,106896
24084,24,State - GUJARAT,Urban,19,Secondary,46873,30513,77386
24085,24,State - GUJARAT,Urban,20-24,Secondary,247225,171947,419172
24086,24,State - GUJARAT,Urban,25-29,Secondary,255926,182144,438070
24087,24,State - GUJARAT,Urban,30-34,Secondary,232704,161059,393763
24088,24,State - GUJARAT,Urban,35-39,Secondary,190719,129949,320668
24089,24,State - GUJARAT,Urban,40-44,Secondary,168716,116210,284926
24090,24,State - GUJARAT,Urban,45-49,Secondary,139565,101587,241152
24091,24,State - GUJARAT,Urban,50-54,Secondary,121553,83670,205223
24092,24,State - GUJARAT,Urban,55-59,Secondary,95637,62180,157817
24093,24,State - GUJARAT,Urban,60-64,Secondary,69220,39820,109040
24094,24,State - GUJARAT,Urban,65-69,Secondary,43292,21370,64662
24095,24,State - GUJARAT,Urban,70-74,Secondary,26274,11097,37371
24096,24,State - GUJARAT,Urban,75-79,Secondary,14538,5302,19840
24097,24,State - GUJARAT,Urban,80+,Secondary,12503,5508,18011
24098,24,State - GUJARAT,Urban,Age not stated,Secondary,9204,6456,15660
24099,25,State - DAMAN & DIU,Total,All ages,Secondary,27874,11615,39489
24100,25,State - DAMAN & DIU,Total,0-6,Secondary,0,0,0
24101,25,State - DAMAN & DIU,Total,7,Secondary,0,0,0
24102,25,State - DAMAN & DIU,Total,8,Secondary,0,0,0
24103,25,State - DAMAN & DIU,Total,9,Secondary,0,0,0
24104,25,State - DAMAN & DIU,Total,10,Secondary,0,0,0
24105,25,State - DAMAN & DIU,Total,11,Secondary,0,0,0
24106,25,State - DAMAN & DIU,Total,12,Secondary,0,0,0
24107,25,State - DAMAN & DIU,Total,13,Secondary,0,0,0
24108,25,State - DAMAN & DIU,Total,14,Secondary,0,0,0
24109,25,State - DAMAN & DIU,Total,15,Secondary,516,464,980
24110,25,State - DAMAN & DIU,Total,16,Secondary,908,819,1727
24111,25,State - DAMAN & DIU,Total,17,Secondary,1231,922,2153
24112,25,State - DAMAN & DIU,Total,18,Secondary,1167,446,1613
24113,25,State - DAMAN & DIU,Total,19,Secondary,1008,391,1399
24114,25,State - DAMAN & DIU,Total,20-24,Secondary,6279,2027,8306
24115,25,State - DAMAN & DIU,Total,25-29,Secondary,5386,2209,7595
24116,25,State - DAMAN & DIU,Total,30-34,Secondary,3849,1643,5492
24117,25,State - DAMAN & DIU,Total,35-39,Secondary,2822,1091,3913
24118,25,State - DAMAN & DIU,Total,40-44,Secondary,1776,624,2400
24119,25,State - DAMAN & DIU,Total,45-49,Secondary,1140,368,1508
24120,25,State - DAMAN & DIU,Total,50-54,Secondary,710,240,950
24121,25,State - DAMAN & DIU,Total,55-59,Secondary,479,162,641
24122,25,State - DAMAN & DIU,Total,60-64,Secondary,289,105,394
24123,25,State - DAMAN & DIU,Total,65-69,Secondary,136,57,193
24124,25,State - DAMAN & DIU,Total,70-74,Secondary,70,19,89
24125,25,State - DAMAN & DIU,Total,75-79,Secondary,32,9,41
24126,25,State - DAMAN & DIU,Total,80+,Secondary,45,10,55
24127,25,State - DAMAN & DIU,Total,Age not stated,Secondary,31,9,40
24128,25,State - DAMAN & DIU,Rural,All ages,Secondary,4455,2946,7401
24129,25,State - DAMAN & DIU,Rural,0-6,Secondary,0,0,0
24130,25,State - DAMAN & DIU,Rural,7,Secondary,0,0,0
24131,25,State - DAMAN & DIU,Rural,8,Secondary,0,0,0
24132,25,State - DAMAN & DIU,Rural,9,Secondary,0,0,0
24133,25,State - DAMAN & DIU,Rural,10,Secondary,0,0,0
24134,25,State - DAMAN & DIU,Rural,11,Secondary,0,0,0
24135,25,State - DAMAN & DIU,Rural,12,Secondary,0,0,0
24136,25,State - DAMAN & DIU,Rural,13,Secondary,0,0,0
24137,25,State - DAMAN & DIU,Rural,14,Secondary,0,0,0
24138,25,State - DAMAN & DIU,Rural,15,Secondary,215,226,441
24139,25,State - DAMAN & DIU,Rural,16,Secondary,331,306,637
24140,25,State - DAMAN & DIU,Rural,17,Secondary,373,374,747
24141,25,State - DAMAN & DIU,Rural,18,Secondary,209,160,369
24142,25,State - DAMAN & DIU,Rural,19,Secondary,175,131,306
24143,25,State - DAMAN & DIU,Rural,20-24,Secondary,777,517,1294
24144,25,State - DAMAN & DIU,Rural,25-29,Secondary,672,541,1213
24145,25,State - DAMAN & DIU,Rural,30-34,Secondary,563,331,894
24146,25,State - DAMAN & DIU,Rural,35-39,Secondary,419,172,591
24147,25,State - DAMAN & DIU,Rural,40-44,Secondary,267,85,352
24148,25,State - DAMAN & DIU,Rural,45-49,Secondary,186,44,230
24149,25,State - DAMAN & DIU,Rural,50-54,Secondary,120,28,148
24150,25,State - DAMAN & DIU,Rural,55-59,Secondary,69,9,78
24151,25,State - DAMAN & DIU,Rural,60-64,Secondary,35,9,44
24152,25,State - DAMAN & DIU,Rural,65-69,Secondary,23,4,27
24153,25,State - DAMAN & DIU,Rural,70-74,Secondary,7,0,7
24154,25,State - DAMAN & DIU,Rural,75-79,Secondary,1,3,4
24155,25,State - DAMAN & DIU,Rural,80+,Secondary,6,2,8
24156,25,State - DAMAN & DIU,Rural,Age not stated,Secondary,7,4,11
24157,25,State - DAMAN & DIU,Urban,All ages,Secondary,23419,8669,32088
24158,25,State - DAMAN & DIU,Urban,0-6,Secondary,0,0,0
24159,25,State - DAMAN & DIU,Urban,7,Secondary,0,0,0
24160,25,State - DAMAN & DIU,Urban,8,Secondary,0,0,0
24161,25,State - DAMAN & DIU,Urban,9,Secondary,0,0,0
24162,25,State - DAMAN & DIU,Urban,10,Secondary,0,0,0
24163,25,State - DAMAN & DIU,Urban,11,Secondary,0,0,0
24164,25,State - DAMAN & DIU,Urban,12,Secondary,0,0,0
24165,25,State - DAMAN & DIU,Urban,13,Secondary,0,0,0
24166,25,State - DAMAN & DIU,Urban,14,Secondary,0,0,0
24167,25,State - DAMAN & DIU,Urban,15,Secondary,301,238,539
24168,25,State - DAMAN & DIU,Urban,16,Secondary,577,513,1090
24169,25,State - DAMAN & DIU,Urban,17,Secondary,858,548,1406
24170,25,State - DAMAN & DIU,Urban,18,Secondary,958,286,1244
24171,25,State - DAMAN & DIU,Urban,19,Secondary,833,260,1093
24172,25,State - DAMAN & DIU,Urban,20-24,Secondary,5502,1510,7012
24173,25,State - DAMAN & DIU,Urban,25-29,Secondary,4714,1668,6382
24174,25,State - DAMAN & DIU,Urban,30-34,Secondary,3286,1312,4598
24175,25,State - DAMAN & DIU,Urban,35-39,Secondary,2403,919,3322
24176,25,State - DAMAN & DIU,Urban,40-44,Secondary,1509,539,2048
24177,25,State - DAMAN & DIU,Urban,45-49,Secondary,954,324,1278
24178,25,State - DAMAN & DIU,Urban,50-54,Secondary,590,212,802
24179,25,State - DAMAN & DIU,Urban,55-59,Secondary,410,153,563
24180,25,State - DAMAN & DIU,Urban,60-64,Secondary,254,96,350
24181,25,State - DAMAN & DIU,Urban,65-69,Secondary,113,53,166
24182,25,State - DAMAN & DIU,Urban,70-74,Secondary,63,19,82
24183,25,State - DAMAN & DIU,Urban,75-79,Secondary,31,6,37
24184,25,State - DAMAN & DIU,Urban,80+,Secondary,39,8,47
24185,25,State - DAMAN & DIU,Urban,Age not stated,Secondary,24,5,29
24186,26,State - DADRA & NAGAR HAVELI,Total,All ages,Secondary,24529,9726,34255
24187,26,State - DADRA & NAGAR HAVELI,Total,0-6,Secondary,0,0,0
24188,26,State - DADRA & NAGAR HAVELI,Total,7,Secondary,0,0,0
24189,26,State - DADRA & NAGAR HAVELI,Total,8,Secondary,0,0,0
24190,26,State - DADRA & NAGAR HAVELI,Total,9,Secondary,0,0,0
24191,26,State - DADRA & NAGAR HAVELI,Total,10,Secondary,0,0,0
24192,26,State - DADRA & NAGAR HAVELI,Total,11,Secondary,0,0,0
24193,26,State - DADRA & NAGAR HAVELI,Total,12,Secondary,0,0,0
24194,26,State - DADRA & NAGAR HAVELI,Total,13,Secondary,0,0,0
24195,26,State - DADRA & NAGAR HAVELI,Total,14,Secondary,0,0,0
24196,26,State - DADRA & NAGAR HAVELI,Total,15,Secondary,521,391,912
24197,26,State - DADRA & NAGAR HAVELI,Total,16,Secondary,881,658,1539
24198,26,State - DADRA & NAGAR HAVELI,Total,17,Secondary,1249,774,2023
24199,26,State - DADRA & NAGAR HAVELI,Total,18,Secondary,1128,472,1600
24200,26,State - DADRA & NAGAR HAVELI,Total,19,Secondary,1023,377,1400
24201,26,State - DADRA & NAGAR HAVELI,Total,20-24,Secondary,5876,1908,7784
24202,26,State - DADRA & NAGAR HAVELI,Total,25-29,Secondary,4708,1848,6556
24203,26,State - DADRA & NAGAR HAVELI,Total,30-34,Secondary,3373,1294,4667
24204,26,State - DADRA & NAGAR HAVELI,Total,35-39,Secondary,2288,798,3086
24205,26,State - DADRA & NAGAR HAVELI,Total,40-44,Secondary,1350,411,1761
24206,26,State - DADRA & NAGAR HAVELI,Total,45-49,Secondary,830,284,1114
24207,26,State - DADRA & NAGAR HAVELI,Total,50-54,Secondary,509,174,683
24208,26,State - DADRA & NAGAR HAVELI,Total,55-59,Secondary,343,163,506
24209,26,State - DADRA & NAGAR HAVELI,Total,60-64,Secondary,206,77,283
24210,26,State - DADRA & NAGAR HAVELI,Total,65-69,Secondary,119,38,157
24211,26,State - DADRA & NAGAR HAVELI,Total,70-74,Secondary,42,19,61
24212,26,State - DADRA & NAGAR HAVELI,Total,75-79,Secondary,32,8,40
24213,26,State - DADRA & NAGAR HAVELI,Total,80+,Secondary,30,24,54
24214,26,State - DADRA & NAGAR HAVELI,Total,Age not stated,Secondary,21,8,29
24215,26,State - DADRA & NAGAR HAVELI,Rural,All ages,Secondary,8772,2664,11436
24216,26,State - DADRA & NAGAR HAVELI,Rural,0-6,Secondary,0,0,0
24217,26,State - DADRA & NAGAR HAVELI,Rural,7,Secondary,0,0,0
24218,26,State - DADRA & NAGAR HAVELI,Rural,8,Secondary,0,0,0
24219,26,State - DADRA & NAGAR HAVELI,Rural,9,Secondary,0,0,0
24220,26,State - DADRA & NAGAR HAVELI,Rural,10,Secondary,0,0,0
24221,26,State - DADRA & NAGAR HAVELI,Rural,11,Secondary,0,0,0
24222,26,State - DADRA & NAGAR HAVELI,Rural,12,Secondary,0,0,0
24223,26,State - DADRA & NAGAR HAVELI,Rural,13,Secondary,0,0,0
24224,26,State - DADRA & NAGAR HAVELI,Rural,14,Secondary,0,0,0
24225,26,State - DADRA & NAGAR HAVELI,Rural,15,Secondary,212,129,341
24226,26,State - DADRA & NAGAR HAVELI,Rural,16,Secondary,381,235,616
24227,26,State - DADRA & NAGAR HAVELI,Rural,17,Secondary,540,282,822
24228,26,State - DADRA & NAGAR HAVELI,Rural,18,Secondary,522,229,751
24229,26,State - DADRA & NAGAR HAVELI,Rural,19,Secondary,513,168,681
24230,26,State - DADRA & NAGAR HAVELI,Rural,20-24,Secondary,2417,606,3023
24231,26,State - DADRA & NAGAR HAVELI,Rural,25-29,Secondary,1668,424,2092
24232,26,State - DADRA & NAGAR HAVELI,Rural,30-34,Secondary,979,265,1244
24233,26,State - DADRA & NAGAR HAVELI,Rural,35-39,Secondary,648,162,810
24234,26,State - DADRA & NAGAR HAVELI,Rural,40-44,Secondary,365,74,439
24235,26,State - DADRA & NAGAR HAVELI,Rural,45-49,Secondary,242,37,279
24236,26,State - DADRA & NAGAR HAVELI,Rural,50-54,Secondary,146,20,166
24237,26,State - DADRA & NAGAR HAVELI,Rural,55-59,Secondary,75,10,85
24238,26,State - DADRA & NAGAR HAVELI,Rural,60-64,Secondary,33,8,41
24239,26,State - DADRA & NAGAR HAVELI,Rural,65-69,Secondary,15,6,21
24240,26,State - DADRA & NAGAR HAVELI,Rural,70-74,Secondary,6,5,11
24241,26,State - DADRA & NAGAR HAVELI,Rural,75-79,Secondary,2,1,3
24242,26,State - DADRA & NAGAR HAVELI,Rural,80+,Secondary,2,1,3
24243,26,State - DADRA & NAGAR HAVELI,Rural,Age not stated,Secondary,6,2,8
24244,26,State - DADRA & NAGAR HAVELI,Urban,All ages,Secondary,15757,7062,22819
24245,26,State - DADRA & NAGAR HAVELI,Urban,0-6,Secondary,0,0,0
24246,26,State - DADRA & NAGAR HAVELI,Urban,7,Secondary,0,0,0
24247,26,State - DADRA & NAGAR HAVELI,Urban,8,Secondary,0,0,0
24248,26,State - DADRA & NAGAR HAVELI,Urban,9,Secondary,0,0,0
24249,26,State - DADRA & NAGAR HAVELI,Urban,10,Secondary,0,0,0
24250,26,State - DADRA & NAGAR HAVELI,Urban,11,Secondary,0,0,0
24251,26,State - DADRA & NAGAR HAVELI,Urban,12,Secondary,0,0,0
24252,26,State - DADRA & NAGAR HAVELI,Urban,13,Secondary,0,0,0
24253,26,State - DADRA & NAGAR HAVELI,Urban,14,Secondary,0,0,0
24254,26,State - DADRA & NAGAR HAVELI,Urban,15,Secondary,309,262,571
24255,26,State - DADRA & NAGAR HAVELI,Urban,16,Secondary,500,423,923
24256,26,State - DADRA & NAGAR HAVELI,Urban,17,Secondary,709,492,1201
24257,26,State - DADRA & NAGAR HAVELI,Urban,18,Secondary,606,243,849
24258,26,State - DADRA & NAGAR HAVELI,Urban,19,Secondary,510,209,719
24259,26,State - DADRA & NAGAR HAVELI,Urban,20-24,Secondary,3459,1302,4761
24260,26,State - DADRA & NAGAR HAVELI,Urban,25-29,Secondary,3040,1424,4464
24261,26,State - DADRA & NAGAR HAVELI,Urban,30-34,Secondary,2394,1029,3423
24262,26,State - DADRA & NAGAR HAVELI,Urban,35-39,Secondary,1640,636,2276
24263,26,State - DADRA & NAGAR HAVELI,Urban,40-44,Secondary,985,337,1322
24264,26,State - DADRA & NAGAR HAVELI,Urban,45-49,Secondary,588,247,835
24265,26,State - DADRA & NAGAR HAVELI,Urban,50-54,Secondary,363,154,517
24266,26,State - DADRA & NAGAR HAVELI,Urban,55-59,Secondary,268,153,421
24267,26,State - DADRA & NAGAR HAVELI,Urban,60-64,Secondary,173,69,242
24268,26,State - DADRA & NAGAR HAVELI,Urban,65-69,Secondary,104,32,136
24269,26,State - DADRA & NAGAR HAVELI,Urban,70-74,Secondary,36,14,50
24270,26,State - DADRA & NAGAR HAVELI,Urban,75-79,Secondary,30,7,37
24271,26,State - DADRA & NAGAR HAVELI,Urban,80+,Secondary,28,23,51
24272,26,State - DADRA & NAGAR HAVELI,Urban,Age not stated,Secondary,15,6,21
24273,27,State - MAHARASHTRA,Total,All ages,Secondary,7914102,5645739,13559841
24274,27,State - MAHARASHTRA,Total,0-6,Secondary,0,0,0
24275,27,State - MAHARASHTRA,Total,7,Secondary,0,0,0
24276,27,State - MAHARASHTRA,Total,8,Secondary,0,0,0
24277,27,State - MAHARASHTRA,Total,9,Secondary,0,0,0
24278,27,State - MAHARASHTRA,Total,10,Secondary,0,0,0
24279,27,State - MAHARASHTRA,Total,11,Secondary,0,0,0
24280,27,State - MAHARASHTRA,Total,12,Secondary,0,0,0
24281,27,State - MAHARASHTRA,Total,13,Secondary,0,0,0
24282,27,State - MAHARASHTRA,Total,14,Secondary,0,0,0
24283,27,State - MAHARASHTRA,Total,15,Secondary,214572,206821,421393
24284,27,State - MAHARASHTRA,Total,16,Secondary,500700,464959,965659
24285,27,State - MAHARASHTRA,Total,17,Secondary,639585,564438,1204023
24286,27,State - MAHARASHTRA,Total,18,Secondary,340797,261334,602131
24287,27,State - MAHARASHTRA,Total,19,Secondary,212346,172806,385152
24288,27,State - MAHARASHTRA,Total,20-24,Secondary,959877,863511,1823388
24289,27,State - MAHARASHTRA,Total,25-29,Secondary,926141,783448,1709589
24290,27,State - MAHARASHTRA,Total,30-34,Secondary,825777,600076,1425853
24291,27,State - MAHARASHTRA,Total,35-39,Secondary,747819,488458,1236277
24292,27,State - MAHARASHTRA,Total,40-44,Secondary,618257,349435,967692
24293,27,State - MAHARASHTRA,Total,45-49,Secondary,484270,264485,748755
24294,27,State - MAHARASHTRA,Total,50-54,Secondary,432602,211508,644110
24295,27,State - MAHARASHTRA,Total,55-59,Secondary,356795,157955,514750
24296,27,State - MAHARASHTRA,Total,60-64,Secondary,268024,104991,373015
24297,27,State - MAHARASHTRA,Total,65-69,Secondary,178554,62789,241343
24298,27,State - MAHARASHTRA,Total,70-74,Secondary,92152,31650,123802
24299,27,State - MAHARASHTRA,Total,75-79,Secondary,47319,18669,65988
24300,27,State - MAHARASHTRA,Total,80+,Secondary,44106,21810,65916
24301,27,State - MAHARASHTRA,Total,Age not stated,Secondary,24409,16596,41005
24302,27,State - MAHARASHTRA,Rural,All ages,Secondary,3852750,2540108,6392858
24303,27,State - MAHARASHTRA,Rural,0-6,Secondary,0,0,0
24304,27,State - MAHARASHTRA,Rural,7,Secondary,0,0,0
24305,27,State - MAHARASHTRA,Rural,8,Secondary,0,0,0
24306,27,State - MAHARASHTRA,Rural,9,Secondary,0,0,0
24307,27,State - MAHARASHTRA,Rural,10,Secondary,0,0,0
24308,27,State - MAHARASHTRA,Rural,11,Secondary,0,0,0
24309,27,State - MAHARASHTRA,Rural,12,Secondary,0,0,0
24310,27,State - MAHARASHTRA,Rural,13,Secondary,0,0,0
24311,27,State - MAHARASHTRA,Rural,14,Secondary,0,0,0
24312,27,State - MAHARASHTRA,Rural,15,Secondary,98756,90013,188769
24313,27,State - MAHARASHTRA,Rural,16,Secondary,262160,233212,495372
24314,27,State - MAHARASHTRA,Rural,17,Secondary,344107,289487,633594
24315,27,State - MAHARASHTRA,Rural,18,Secondary,200469,152432,352901
24316,27,State - MAHARASHTRA,Rural,19,Secondary,118590,99813,218403
24317,27,State - MAHARASHTRA,Rural,20-24,Secondary,522161,481657,1003818
24318,27,State - MAHARASHTRA,Rural,25-29,Secondary,473446,397602,871048
24319,27,State - MAHARASHTRA,Rural,30-34,Secondary,404649,275840,680489
24320,27,State - MAHARASHTRA,Rural,35-39,Secondary,358089,196879,554968
24321,27,State - MAHARASHTRA,Rural,40-44,Secondary,283113,115122,398235
24322,27,State - MAHARASHTRA,Rural,45-49,Secondary,203659,72458,276117
24323,27,State - MAHARASHTRA,Rural,50-54,Secondary,179229,52610,231839
24324,27,State - MAHARASHTRA,Rural,55-59,Secondary,149386,34496,183882
24325,27,State - MAHARASHTRA,Rural,60-64,Secondary,110889,18922,129811
24326,27,State - MAHARASHTRA,Rural,65-69,Secondary,74385,11244,85629
24327,27,State - MAHARASHTRA,Rural,70-74,Secondary,31781,3902,35683
24328,27,State - MAHARASHTRA,Rural,75-79,Secondary,13689,2185,15874
24329,27,State - MAHARASHTRA,Rural,80+,Secondary,13501,5337,18838
24330,27,State - MAHARASHTRA,Rural,Age not stated,Secondary,10691,6897,17588
24331,27,State - MAHARASHTRA,Urban,All ages,Secondary,4061352,3105631,7166983
24332,27,State - MAHARASHTRA,Urban,0-6,Secondary,0,0,0
24333,27,State - MAHARASHTRA,Urban,7,Secondary,0,0,0
24334,27,State - MAHARASHTRA,Urban,8,Secondary,0,0,0
24335,27,State - MAHARASHTRA,Urban,9,Secondary,0,0,0
24336,27,State - MAHARASHTRA,Urban,10,Secondary,0,0,0
24337,27,State - MAHARASHTRA,Urban,11,Secondary,0,0,0
24338,27,State - MAHARASHTRA,Urban,12,Secondary,0,0,0
24339,27,State - MAHARASHTRA,Urban,13,Secondary,0,0,0
24340,27,State - MAHARASHTRA,Urban,14,Secondary,0,0,0
24341,27,State - MAHARASHTRA,Urban,15,Secondary,115816,116808,232624
24342,27,State - MAHARASHTRA,Urban,16,Secondary,238540,231747,470287
24343,27,State - MAHARASHTRA,Urban,17,Secondary,295478,274951,570429
24344,27,State - MAHARASHTRA,Urban,18,Secondary,140328,108902,249230
24345,27,State - MAHARASHTRA,Urban,19,Secondary,93756,72993,166749
24346,27,State - MAHARASHTRA,Urban,20-24,Secondary,437716,381854,819570
24347,27,State - MAHARASHTRA,Urban,25-29,Secondary,452695,385846,838541
24348,27,State - MAHARASHTRA,Urban,30-34,Secondary,421128,324236,745364
24349,27,State - MAHARASHTRA,Urban,35-39,Secondary,389730,291579,681309
24350,27,State - MAHARASHTRA,Urban,40-44,Secondary,335144,234313,569457
24351,27,State - MAHARASHTRA,Urban,45-49,Secondary,280611,192027,472638
24352,27,State - MAHARASHTRA,Urban,50-54,Secondary,253373,158898,412271
24353,27,State - MAHARASHTRA,Urban,55-59,Secondary,207409,123459,330868
24354,27,State - MAHARASHTRA,Urban,60-64,Secondary,157135,86069,243204
24355,27,State - MAHARASHTRA,Urban,65-69,Secondary,104169,51545,155714
24356,27,State - MAHARASHTRA,Urban,70-74,Secondary,60371,27748,88119
24357,27,State - MAHARASHTRA,Urban,75-79,Secondary,33630,16484,50114
24358,27,State - MAHARASHTRA,Urban,80+,Secondary,30605,16473,47078
24359,27,State - MAHARASHTRA,Urban,Age not stated,Secondary,13718,9699,23417
24360,28,State - ANDHRA PRADESH,Total,All ages,Secondary,4842743,3742738,8585481
24361,28,State - ANDHRA PRADESH,Total,0-6,Secondary,0,0,0
24362,28,State - ANDHRA PRADESH,Total,7,Secondary,0,0,0
24363,28,State - ANDHRA PRADESH,Total,8,Secondary,0,0,0
24364,28,State - ANDHRA PRADESH,Total,9,Secondary,0,0,0
24365,28,State - ANDHRA PRADESH,Total,10,Secondary,0,0,0
24366,28,State - ANDHRA PRADESH,Total,11,Secondary,0,0,0
24367,28,State - ANDHRA PRADESH,Total,12,Secondary,0,0,0
24368,28,State - ANDHRA PRADESH,Total,13,Secondary,0,0,0
24369,28,State - ANDHRA PRADESH,Total,14,Secondary,0,0,0
24370,28,State - ANDHRA PRADESH,Total,15,Secondary,336761,333285,670046
24371,28,State - ANDHRA PRADESH,Total,16,Secondary,485840,455529,941369
24372,28,State - ANDHRA PRADESH,Total,17,Secondary,526324,456770,983094
24373,28,State - ANDHRA PRADESH,Total,18,Secondary,149208,155816,305024
24374,28,State - ANDHRA PRADESH,Total,19,Secondary,108388,122846,231234
24375,28,State - ANDHRA PRADESH,Total,20-24,Secondary,600385,615368,1215753
24376,28,State - ANDHRA PRADESH,Total,25-29,Secondary,601858,505370,1107228
24377,28,State - ANDHRA PRADESH,Total,30-34,Secondary,521180,346675,867855
24378,28,State - ANDHRA PRADESH,Total,35-39,Secondary,477036,273964,751000
24379,28,State - ANDHRA PRADESH,Total,40-44,Secondary,333847,163588,497435
24380,28,State - ANDHRA PRADESH,Total,45-49,Secondary,227044,109965,337009
24381,28,State - ANDHRA PRADESH,Total,50-54,Secondary,165219,73615,238834
24382,28,State - ANDHRA PRADESH,Total,55-59,Secondary,109577,46446,156023
24383,28,State - ANDHRA PRADESH,Total,60-64,Secondary,73741,25066,98807
24384,28,State - ANDHRA PRADESH,Total,65-69,Secondary,42493,14267,56760
24385,28,State - ANDHRA PRADESH,Total,70-74,Secondary,26382,7332,33714
24386,28,State - ANDHRA PRADESH,Total,75-79,Secondary,11735,3564,15299
24387,28,State - ANDHRA PRADESH,Total,80+,Secondary,14067,7179,21246
24388,28,State - ANDHRA PRADESH,Total,Age not stated,Secondary,31658,26093,57751
24389,28,State - ANDHRA PRADESH,Rural,All ages,Secondary,3001888,2086076,5087964
24390,28,State - ANDHRA PRADESH,Rural,0-6,Secondary,0,0,0
24391,28,State - ANDHRA PRADESH,Rural,7,Secondary,0,0,0
24392,28,State - ANDHRA PRADESH,Rural,8,Secondary,0,0,0
24393,28,State - ANDHRA PRADESH,Rural,9,Secondary,0,0,0
24394,28,State - ANDHRA PRADESH,Rural,10,Secondary,0,0,0
24395,28,State - ANDHRA PRADESH,Rural,11,Secondary,0,0,0
24396,28,State - ANDHRA PRADESH,Rural,12,Secondary,0,0,0
24397,28,State - ANDHRA PRADESH,Rural,13,Secondary,0,0,0
24398,28,State - ANDHRA PRADESH,Rural,14,Secondary,0,0,0
24399,28,State - ANDHRA PRADESH,Rural,15,Secondary,210793,201147,411940
24400,28,State - ANDHRA PRADESH,Rural,16,Secondary,303790,272603,576393
24401,28,State - ANDHRA PRADESH,Rural,17,Secondary,331931,270261,602192
24402,28,State - ANDHRA PRADESH,Rural,18,Secondary,111083,112289,223372
24403,28,State - ANDHRA PRADESH,Rural,19,Secondary,78509,84486,162995
24404,28,State - ANDHRA PRADESH,Rural,20-24,Secondary,423217,393223,816440
24405,28,State - ANDHRA PRADESH,Rural,25-29,Secondary,389810,283027,672837
24406,28,State - ANDHRA PRADESH,Rural,30-34,Secondary,324578,175483,500061
24407,28,State - ANDHRA PRADESH,Rural,35-39,Secondary,288180,126211,414391
24408,28,State - ANDHRA PRADESH,Rural,40-44,Secondary,190324,65113,255437
24409,28,State - ANDHRA PRADESH,Rural,45-49,Secondary,117988,37664,155652
24410,28,State - ANDHRA PRADESH,Rural,50-54,Secondary,80049,22383,102432
24411,28,State - ANDHRA PRADESH,Rural,55-59,Secondary,52633,13881,66514
24412,28,State - ANDHRA PRADESH,Rural,60-64,Secondary,36937,7210,44147
24413,28,State - ANDHRA PRADESH,Rural,65-69,Secondary,21603,4414,26017
24414,28,State - ANDHRA PRADESH,Rural,70-74,Secondary,12868,2095,14963
24415,28,State - ANDHRA PRADESH,Rural,75-79,Secondary,5411,970,6381
24416,28,State - ANDHRA PRADESH,Rural,80+,Secondary,6532,2549,9081
24417,28,State - ANDHRA PRADESH,Rural,Age not stated,Secondary,15652,11067,26719
24418,28,State - ANDHRA PRADESH,Urban,All ages,Secondary,1840855,1656662,3497517
24419,28,State - ANDHRA PRADESH,Urban,0-6,Secondary,0,0,0
24420,28,State - ANDHRA PRADESH,Urban,7,Secondary,0,0,0
24421,28,State - ANDHRA PRADESH,Urban,8,Secondary,0,0,0
24422,28,State - ANDHRA PRADESH,Urban,9,Secondary,0,0,0
24423,28,State - ANDHRA PRADESH,Urban,10,Secondary,0,0,0
24424,28,State - ANDHRA PRADESH,Urban,11,Secondary,0,0,0
24425,28,State - ANDHRA PRADESH,Urban,12,Secondary,0,0,0
24426,28,State - ANDHRA PRADESH,Urban,13,Secondary,0,0,0
24427,28,State - ANDHRA PRADESH,Urban,14,Secondary,0,0,0
24428,28,State - ANDHRA PRADESH,Urban,15,Secondary,125968,132138,258106
24429,28,State - ANDHRA PRADESH,Urban,16,Secondary,182050,182926,364976
24430,28,State - ANDHRA PRADESH,Urban,17,Secondary,194393,186509,380902
24431,28,State - ANDHRA PRADESH,Urban,18,Secondary,38125,43527,81652
24432,28,State - ANDHRA PRADESH,Urban,19,Secondary,29879,38360,68239
24433,28,State - ANDHRA PRADESH,Urban,20-24,Secondary,177168,222145,399313
24434,28,State - ANDHRA PRADESH,Urban,25-29,Secondary,212048,222343,434391
24435,28,State - ANDHRA PRADESH,Urban,30-34,Secondary,196602,171192,367794
24436,28,State - ANDHRA PRADESH,Urban,35-39,Secondary,188856,147753,336609
24437,28,State - ANDHRA PRADESH,Urban,40-44,Secondary,143523,98475,241998
24438,28,State - ANDHRA PRADESH,Urban,45-49,Secondary,109056,72301,181357
24439,28,State - ANDHRA PRADESH,Urban,50-54,Secondary,85170,51232,136402
24440,28,State - ANDHRA PRADESH,Urban,55-59,Secondary,56944,32565,89509
24441,28,State - ANDHRA PRADESH,Urban,60-64,Secondary,36804,17856,54660
24442,28,State - ANDHRA PRADESH,Urban,65-69,Secondary,20890,9853,30743
24443,28,State - ANDHRA PRADESH,Urban,70-74,Secondary,13514,5237,18751
24444,28,State - ANDHRA PRADESH,Urban,75-79,Secondary,6324,2594,8918
24445,28,State - ANDHRA PRADESH,Urban,80+,Secondary,7535,4630,12165
24446,28,State - ANDHRA PRADESH,Urban,Age not stated,Secondary,16006,15026,31032
24447,29,State - KARNATAKA,Total,All ages,Secondary,2784883,2297524,5082407
24448,29,State - KARNATAKA,Total,0-6,Secondary,0,0,0
24449,29,State - KARNATAKA,Total,7,Secondary,0,0,0
24450,29,State - KARNATAKA,Total,8,Secondary,0,0,0
24451,29,State - KARNATAKA,Total,9,Secondary,0,0,0
24452,29,State - KARNATAKA,Total,10,Secondary,0,0,0
24453,29,State - KARNATAKA,Total,11,Secondary,0,0,0
24454,29,State - KARNATAKA,Total,12,Secondary,0,0,0
24455,29,State - KARNATAKA,Total,13,Secondary,0,0,0
24456,29,State - KARNATAKA,Total,14,Secondary,0,0,0
24457,29,State - KARNATAKA,Total,15,Secondary,122610,125709,248319
24458,29,State - KARNATAKA,Total,16,Secondary,274373,274551,548924
24459,29,State - KARNATAKA,Total,17,Secondary,340310,323148,663458
24460,29,State - KARNATAKA,Total,18,Secondary,84031,81508,165539
24461,29,State - KARNATAKA,Total,19,Secondary,58874,63530,122404
24462,29,State - KARNATAKA,Total,20-24,Secondary,333391,338907,672298
24463,29,State - KARNATAKA,Total,25-29,Secondary,341504,313120,654624
24464,29,State - KARNATAKA,Total,30-34,Secondary,281965,215346,497311
24465,29,State - KARNATAKA,Total,35-39,Secondary,238756,176869,415625
24466,29,State - KARNATAKA,Total,40-44,Secondary,182912,115670,298582
24467,29,State - KARNATAKA,Total,45-49,Secondary,152346,90963,243309
24468,29,State - KARNATAKA,Total,50-54,Secondary,115406,63450,178856
24469,29,State - KARNATAKA,Total,55-59,Secondary,90211,46780,136991
24470,29,State - KARNATAKA,Total,60-64,Secondary,70099,30324,100423
24471,29,State - KARNATAKA,Total,65-69,Secondary,42118,16842,58960
24472,29,State - KARNATAKA,Total,70-74,Secondary,26425,9319,35744
24473,29,State - KARNATAKA,Total,75-79,Secondary,14564,4925,19489
24474,29,State - KARNATAKA,Total,80+,Secondary,13872,5748,19620
24475,29,State - KARNATAKA,Total,Age not stated,Secondary,1116,815,1931
24476,29,State - KARNATAKA,Rural,All ages,Secondary,1517040,1148604,2665644
24477,29,State - KARNATAKA,Rural,0-6,Secondary,0,0,0
24478,29,State - KARNATAKA,Rural,7,Secondary,0,0,0
24479,29,State - KARNATAKA,Rural,8,Secondary,0,0,0
24480,29,State - KARNATAKA,Rural,9,Secondary,0,0,0
24481,29,State - KARNATAKA,Rural,10,Secondary,0,0,0
24482,29,State - KARNATAKA,Rural,11,Secondary,0,0,0
24483,29,State - KARNATAKA,Rural,12,Secondary,0,0,0
24484,29,State - KARNATAKA,Rural,13,Secondary,0,0,0
24485,29,State - KARNATAKA,Rural,14,Secondary,0,0,0
24486,29,State - KARNATAKA,Rural,15,Secondary,65333,63085,128418
24487,29,State - KARNATAKA,Rural,16,Secondary,158340,151341,309681
24488,29,State - KARNATAKA,Rural,17,Secondary,199202,177486,376688
24489,29,State - KARNATAKA,Rural,18,Secondary,55136,52243,107379
24490,29,State - KARNATAKA,Rural,19,Secondary,36256,38928,75184
24491,29,State - KARNATAKA,Rural,20-24,Secondary,198527,195472,393999
24492,29,State - KARNATAKA,Rural,25-29,Secondary,190710,163400,354110
24493,29,State - KARNATAKA,Rural,30-34,Secondary,149351,104311,253662
24494,29,State - KARNATAKA,Rural,35-39,Secondary,122520,78713,201233
24495,29,State - KARNATAKA,Rural,40-44,Secondary,91343,44435,135778
24496,29,State - KARNATAKA,Rural,45-49,Secondary,75600,31551,107151
24497,29,State - KARNATAKA,Rural,50-54,Secondary,55734,19295,75029
24498,29,State - KARNATAKA,Rural,55-59,Secondary,42661,13022,55683
24499,29,State - KARNATAKA,Rural,60-64,Secondary,32800,6995,39795
24500,29,State - KARNATAKA,Rural,65-69,Secondary,19748,3810,23558
24501,29,State - KARNATAKA,Rural,70-74,Secondary,11601,1781,13382
24502,29,State - KARNATAKA,Rural,75-79,Secondary,6054,900,6954
24503,29,State - KARNATAKA,Rural,80+,Secondary,5550,1452,7002
24504,29,State - KARNATAKA,Rural,Age not stated,Secondary,574,384,958
24505,29,State - KARNATAKA,Urban,All ages,Secondary,1267843,1148920,2416763
24506,29,State - KARNATAKA,Urban,0-6,Secondary,0,0,0
24507,29,State - KARNATAKA,Urban,7,Secondary,0,0,0
24508,29,State - KARNATAKA,Urban,8,Secondary,0,0,0
24509,29,State - KARNATAKA,Urban,9,Secondary,0,0,0
24510,29,State - KARNATAKA,Urban,10,Secondary,0,0,0
24511,29,State - KARNATAKA,Urban,11,Secondary,0,0,0
24512,29,State - KARNATAKA,Urban,12,Secondary,0,0,0
24513,29,State - KARNATAKA,Urban,13,Secondary,0,0,0
24514,29,State - KARNATAKA,Urban,14,Secondary,0,0,0
24515,29,State - KARNATAKA,Urban,15,Secondary,57277,62624,119901
24516,29,State - KARNATAKA,Urban,16,Secondary,116033,123210,239243
24517,29,State - KARNATAKA,Urban,17,Secondary,141108,145662,286770
24518,29,State - KARNATAKA,Urban,18,Secondary,28895,29265,58160
24519,29,State - KARNATAKA,Urban,19,Secondary,22618,24602,47220
24520,29,State - KARNATAKA,Urban,20-24,Secondary,134864,143435,278299
24521,29,State - KARNATAKA,Urban,25-29,Secondary,150794,149720,300514
24522,29,State - KARNATAKA,Urban,30-34,Secondary,132614,111035,243649
24523,29,State - KARNATAKA,Urban,35-39,Secondary,116236,98156,214392
24524,29,State - KARNATAKA,Urban,40-44,Secondary,91569,71235,162804
24525,29,State - KARNATAKA,Urban,45-49,Secondary,76746,59412,136158
24526,29,State - KARNATAKA,Urban,50-54,Secondary,59672,44155,103827
24527,29,State - KARNATAKA,Urban,55-59,Secondary,47550,33758,81308
24528,29,State - KARNATAKA,Urban,60-64,Secondary,37299,23329,60628
24529,29,State - KARNATAKA,Urban,65-69,Secondary,22370,13032,35402
24530,29,State - KARNATAKA,Urban,70-74,Secondary,14824,7538,22362
24531,29,State - KARNATAKA,Urban,75-79,Secondary,8510,4025,12535
24532,29,State - KARNATAKA,Urban,80+,Secondary,8322,4296,12618
24533,29,State - KARNATAKA,Urban,Age not stated,Secondary,542,431,973
24534,30,State - GOA,Total,All ages,Secondary,102298,83080,185378
24535,30,State - GOA,Total,0-6,Secondary,0,0,0
24536,30,State - GOA,Total,7,Secondary,0,0,0
24537,30,State - GOA,Total,8,Secondary,0,0,0
24538,30,State - GOA,Total,9,Secondary,0,0,0
24539,30,State - GOA,Total,10,Secondary,0,0,0
24540,30,State - GOA,Total,11,Secondary,0,0,0
24541,30,State - GOA,Total,12,Secondary,0,0,0
24542,30,State - GOA,Total,13,Secondary,0,0,0
24543,30,State - GOA,Total,14,Secondary,0,0,0
24544,30,State - GOA,Total,15,Secondary,3082,3462,6544
24545,30,State - GOA,Total,16,Secondary,5602,5741,11343
24546,30,State - GOA,Total,17,Secondary,6585,6824,13409
24547,30,State - GOA,Total,18,Secondary,2983,2278,5261
24548,30,State - GOA,Total,19,Secondary,2301,1679,3980
24549,30,State - GOA,Total,20-24,Secondary,10579,7932,18511
24550,30,State - GOA,Total,25-29,Secondary,10696,9296,19992
24551,30,State - GOA,Total,30-34,Secondary,11125,9646,20771
24552,30,State - GOA,Total,35-39,Secondary,11494,9544,21038
24553,30,State - GOA,Total,40-44,Secondary,9871,7599,17470
24554,30,State - GOA,Total,45-49,Secondary,8109,6004,14113
24555,30,State - GOA,Total,50-54,Secondary,6494,4555,11049
24556,30,State - GOA,Total,55-59,Secondary,5284,3589,8873
24557,30,State - GOA,Total,60-64,Secondary,3662,2270,5932
24558,30,State - GOA,Total,65-69,Secondary,1960,1110,3070
24559,30,State - GOA,Total,70-74,Secondary,1129,674,1803
24560,30,State - GOA,Total,75-79,Secondary,696,425,1121
24561,30,State - GOA,Total,80+,Secondary,547,385,932
24562,30,State - GOA,Total,Age not stated,Secondary,99,67,166
24563,30,State - GOA,Rural,All ages,Secondary,38987,30675,69662
24564,30,State - GOA,Rural,0-6,Secondary,0,0,0
24565,30,State - GOA,Rural,7,Secondary,0,0,0
24566,30,State - GOA,Rural,8,Secondary,0,0,0
24567,30,State - GOA,Rural,9,Secondary,0,0,0
24568,30,State - GOA,Rural,10,Secondary,0,0,0
24569,30,State - GOA,Rural,11,Secondary,0,0,0
24570,30,State - GOA,Rural,12,Secondary,0,0,0
24571,30,State - GOA,Rural,13,Secondary,0,0,0
24572,30,State - GOA,Rural,14,Secondary,0,0,0
24573,30,State - GOA,Rural,15,Secondary,995,1169,2164
24574,30,State - GOA,Rural,16,Secondary,1928,1964,3892
24575,30,State - GOA,Rural,17,Secondary,2300,2386,4686
24576,30,State - GOA,Rural,18,Secondary,1153,928,2081
24577,30,State - GOA,Rural,19,Secondary,953,680,1633
24578,30,State - GOA,Rural,20-24,Secondary,4140,3247,7387
24579,30,State - GOA,Rural,25-29,Secondary,4301,3826,8127
24580,30,State - GOA,Rural,30-34,Secondary,4641,3907,8548
24581,30,State - GOA,Rural,35-39,Secondary,4722,3696,8418
24582,30,State - GOA,Rural,40-44,Secondary,3748,2720,6468
24583,30,State - GOA,Rural,45-49,Secondary,3048,2071,5119
24584,30,State - GOA,Rural,50-54,Secondary,2316,1545,3861
24585,30,State - GOA,Rural,55-59,Secondary,1944,1110,3054
24586,30,State - GOA,Rural,60-64,Secondary,1366,651,2017
24587,30,State - GOA,Rural,65-69,Secondary,645,315,960
24588,30,State - GOA,Rural,70-74,Secondary,371,202,573
24589,30,State - GOA,Rural,75-79,Secondary,211,114,325
24590,30,State - GOA,Rural,80+,Secondary,162,129,291
24591,30,State - GOA,Rural,Age not stated,Secondary,43,15,58
24592,30,State - GOA,Urban,All ages,Secondary,63311,52405,115716
24593,30,State - GOA,Urban,0-6,Secondary,0,0,0
24594,30,State - GOA,Urban,7,Secondary,0,0,0
24595,30,State - GOA,Urban,8,Secondary,0,0,0
24596,30,State - GOA,Urban,9,Secondary,0,0,0
24597,30,State - GOA,Urban,10,Secondary,0,0,0
24598,30,State - GOA,Urban,11,Secondary,0,0,0
24599,30,State - GOA,Urban,12,Secondary,0,0,0
24600,30,State - GOA,Urban,13,Secondary,0,0,0
24601,30,State - GOA,Urban,14,Secondary,0,0,0
24602,30,State - GOA,Urban,15,Secondary,2087,2293,4380
24603,30,State - GOA,Urban,16,Secondary,3674,3777,7451
24604,30,State - GOA,Urban,17,Secondary,4285,4438,8723
24605,30,State - GOA,Urban,18,Secondary,1830,1350,3180
24606,30,State - GOA,Urban,19,Secondary,1348,999,2347
24607,30,State - GOA,Urban,20-24,Secondary,6439,4685,11124
24608,30,State - GOA,Urban,25-29,Secondary,6395,5470,11865
24609,30,State - GOA,Urban,30-34,Secondary,6484,5739,12223
24610,30,State - GOA,Urban,35-39,Secondary,6772,5848,12620
24611,30,State - GOA,Urban,40-44,Secondary,6123,4879,11002
24612,30,State - GOA,Urban,45-49,Secondary,5061,3933,8994
24613,30,State - GOA,Urban,50-54,Secondary,4178,3010,7188
24614,30,State - GOA,Urban,55-59,Secondary,3340,2479,5819
24615,30,State - GOA,Urban,60-64,Secondary,2296,1619,3915
24616,30,State - GOA,Urban,65-69,Secondary,1315,795,2110
24617,30,State - GOA,Urban,70-74,Secondary,758,472,1230
24618,30,State - GOA,Urban,75-79,Secondary,485,311,796
24619,30,State - GOA,Urban,80+,Secondary,385,256,641
24620,30,State - GOA,Urban,Age not stated,Secondary,56,52,108
24621,31,State - LAKSHADWEEP,Total,All ages,Secondary,3252,2523,5775
24622,31,State - LAKSHADWEEP,Total,0-6,Secondary,0,0,0
24623,31,State - LAKSHADWEEP,Total,7,Secondary,0,0,0
24624,31,State - LAKSHADWEEP,Total,8,Secondary,0,0,0
24625,31,State - LAKSHADWEEP,Total,9,Secondary,0,0,0
24626,31,State - LAKSHADWEEP,Total,10,Secondary,0,0,0
24627,31,State - LAKSHADWEEP,Total,11,Secondary,0,0,0
24628,31,State - LAKSHADWEEP,Total,12,Secondary,0,0,0
24629,31,State - LAKSHADWEEP,Total,13,Secondary,0,0,0
24630,31,State - LAKSHADWEEP,Total,14,Secondary,0,0,0
24631,31,State - LAKSHADWEEP,Total,15,Secondary,30,41,71
24632,31,State - LAKSHADWEEP,Total,16,Secondary,168,240,408
24633,31,State - LAKSHADWEEP,Total,17,Secondary,323,424,747
24634,31,State - LAKSHADWEEP,Total,18,Secondary,212,238,450
24635,31,State - LAKSHADWEEP,Total,19,Secondary,163,144,307
24636,31,State - LAKSHADWEEP,Total,20-24,Secondary,597,431,1028
24637,31,State - LAKSHADWEEP,Total,25-29,Secondary,363,263,626
24638,31,State - LAKSHADWEEP,Total,30-34,Secondary,325,220,545
24639,31,State - LAKSHADWEEP,Total,35-39,Secondary,285,211,496
24640,31,State - LAKSHADWEEP,Total,40-44,Secondary,261,139,400
24641,31,State - LAKSHADWEEP,Total,45-49,Secondary,181,92,273
24642,31,State - LAKSHADWEEP,Total,50-54,Secondary,154,42,196
24643,31,State - LAKSHADWEEP,Total,55-59,Secondary,94,25,119
24644,31,State - LAKSHADWEEP,Total,60-64,Secondary,48,7,55
24645,31,State - LAKSHADWEEP,Total,65-69,Secondary,33,1,34
24646,31,State - LAKSHADWEEP,Total,70-74,Secondary,7,1,8
24647,31,State - LAKSHADWEEP,Total,75-79,Secondary,1,1,2
24648,31,State - LAKSHADWEEP,Total,80+,Secondary,5,1,6
24649,31,State - LAKSHADWEEP,Total,Age not stated,Secondary,2,2,4
24650,31,State - LAKSHADWEEP,Rural,All ages,Secondary,795,618,1413
24651,31,State - LAKSHADWEEP,Rural,0-6,Secondary,0,0,0
24652,31,State - LAKSHADWEEP,Rural,7,Secondary,0,0,0
24653,31,State - LAKSHADWEEP,Rural,8,Secondary,0,0,0
24654,31,State - LAKSHADWEEP,Rural,9,Secondary,0,0,0
24655,31,State - LAKSHADWEEP,Rural,10,Secondary,0,0,0
24656,31,State - LAKSHADWEEP,Rural,11,Secondary,0,0,0
24657,31,State - LAKSHADWEEP,Rural,12,Secondary,0,0,0
24658,31,State - LAKSHADWEEP,Rural,13,Secondary,0,0,0
24659,31,State - LAKSHADWEEP,Rural,14,Secondary,0,0,0
24660,31,State - LAKSHADWEEP,Rural,15,Secondary,1,3,4
24661,31,State - LAKSHADWEEP,Rural,16,Secondary,18,50,68
24662,31,State - LAKSHADWEEP,Rural,17,Secondary,57,77,134
24663,31,State - LAKSHADWEEP,Rural,18,Secondary,44,56,100
24664,31,State - LAKSHADWEEP,Rural,19,Secondary,34,39,73
24665,31,State - LAKSHADWEEP,Rural,20-24,Secondary,153,130,283
24666,31,State - LAKSHADWEEP,Rural,25-29,Secondary,126,82,208
24667,31,State - LAKSHADWEEP,Rural,30-34,Secondary,101,61,162
24668,31,State - LAKSHADWEEP,Rural,35-39,Secondary,70,44,114
24669,31,State - LAKSHADWEEP,Rural,40-44,Secondary,57,46,103
24670,31,State - LAKSHADWEEP,Rural,45-49,Secondary,50,18,68
24671,31,State - LAKSHADWEEP,Rural,50-54,Secondary,41,8,49
24672,31,State - LAKSHADWEEP,Rural,55-59,Secondary,23,3,26
24673,31,State - LAKSHADWEEP,Rural,60-64,Secondary,7,1,8
24674,31,State - LAKSHADWEEP,Rural,65-69,Secondary,6,0,6
24675,31,State - LAKSHADWEEP,Rural,70-74,Secondary,1,0,1
24676,31,State - LAKSHADWEEP,Rural,75-79,Secondary,1,0,1
24677,31,State - LAKSHADWEEP,Rural,80+,Secondary,3,0,3
24678,31,State - LAKSHADWEEP,Rural,Age not stated,Secondary,2,0,2
24679,31,State - LAKSHADWEEP,Urban,All ages,Secondary,2457,1905,4362
24680,31,State - LAKSHADWEEP,Urban,0-6,Secondary,0,0,0
24681,31,State - LAKSHADWEEP,Urban,7,Secondary,0,0,0
24682,31,State - LAKSHADWEEP,Urban,8,Secondary,0,0,0
24683,31,State - LAKSHADWEEP,Urban,9,Secondary,0,0,0
24684,31,State - LAKSHADWEEP,Urban,10,Secondary,0,0,0
24685,31,State - LAKSHADWEEP,Urban,11,Secondary,0,0,0
24686,31,State - LAKSHADWEEP,Urban,12,Secondary,0,0,0
24687,31,State - LAKSHADWEEP,Urban,13,Secondary,0,0,0
24688,31,State - LAKSHADWEEP,Urban,14,Secondary,0,0,0
24689,31,State - LAKSHADWEEP,Urban,15,Secondary,29,38,67
24690,31,State - LAKSHADWEEP,Urban,16,Secondary,150,190,340
24691,31,State - LAKSHADWEEP,Urban,17,Secondary,266,347,613
24692,31,State - LAKSHADWEEP,Urban,18,Secondary,168,182,350
24693,31,State - LAKSHADWEEP,Urban,19,Secondary,129,105,234
24694,31,State - LAKSHADWEEP,Urban,20-24,Secondary,444,301,745
24695,31,State - LAKSHADWEEP,Urban,25-29,Secondary,237,181,418
24696,31,State - LAKSHADWEEP,Urban,30-34,Secondary,224,159,383
24697,31,State - LAKSHADWEEP,Urban,35-39,Secondary,215,167,382
24698,31,State - LAKSHADWEEP,Urban,40-44,Secondary,204,93,297
24699,31,State - LAKSHADWEEP,Urban,45-49,Secondary,131,74,205
24700,31,State - LAKSHADWEEP,Urban,50-54,Secondary,113,34,147
24701,31,State - LAKSHADWEEP,Urban,55-59,Secondary,71,22,93
24702,31,State - LAKSHADWEEP,Urban,60-64,Secondary,41,6,47
24703,31,State - LAKSHADWEEP,Urban,65-69,Secondary,27,1,28
24704,31,State - LAKSHADWEEP,Urban,70-74,Secondary,6,1,7
24705,31,State - LAKSHADWEEP,Urban,75-79,Secondary,0,1,1
24706,31,State - LAKSHADWEEP,Urban,80+,Secondary,2,1,3
24707,31,State - LAKSHADWEEP,Urban,Age not stated,Secondary,0,2,2
24708,32,State - KERALA,Total,All ages,Secondary,1906020,1946369,3852389
24709,32,State - KERALA,Total,0-6,Secondary,0,0,0
24710,32,State - KERALA,Total,7,Secondary,0,0,0
24711,32,State - KERALA,Total,8,Secondary,0,0,0
24712,32,State - KERALA,Total,9,Secondary,0,0,0
24713,32,State - KERALA,Total,10,Secondary,0,0,0
24714,32,State - KERALA,Total,11,Secondary,0,0,0
24715,32,State - KERALA,Total,12,Secondary,0,0,0
24716,32,State - KERALA,Total,13,Secondary,0,0,0
24717,32,State - KERALA,Total,14,Secondary,0,0,0
24718,32,State - KERALA,Total,15,Secondary,66327,79173,145500
24719,32,State - KERALA,Total,16,Secondary,151765,169604,321369
24720,32,State - KERALA,Total,17,Secondary,189967,198901,388868
24721,32,State - KERALA,Total,18,Secondary,55308,41104,96412
24722,32,State - KERALA,Total,19,Secondary,36323,26759,63082
24723,32,State - KERALA,Total,20-24,Secondary,181363,172598,353961
24724,32,State - KERALA,Total,25-29,Secondary,203461,229998,433459
24725,32,State - KERALA,Total,30-34,Secondary,195468,223524,418992
24726,32,State - KERALA,Total,35-39,Secondary,179698,210936,390634
24727,32,State - KERALA,Total,40-44,Secondary,157663,175734,333397
24728,32,State - KERALA,Total,45-49,Secondary,141696,141587,283283
24729,32,State - KERALA,Total,50-54,Secondary,108339,100418,208757
24730,32,State - KERALA,Total,55-59,Secondary,90991,76019,167010
24731,32,State - KERALA,Total,60-64,Secondary,64047,47620,111667
24732,32,State - KERALA,Total,65-69,Secondary,37851,24660,62511
24733,32,State - KERALA,Total,70-74,Secondary,23682,14193,37875
24734,32,State - KERALA,Total,75-79,Secondary,12406,7112,19518
24735,32,State - KERALA,Total,80+,Secondary,8493,5322,13815
24736,32,State - KERALA,Total,Age not stated,Secondary,1172,1107,2279
24737,32,State - KERALA,Rural,All ages,Secondary,1003965,1022819,2026784
24738,32,State - KERALA,Rural,0-6,Secondary,0,0,0
24739,32,State - KERALA,Rural,7,Secondary,0,0,0
24740,32,State - KERALA,Rural,8,Secondary,0,0,0
24741,32,State - KERALA,Rural,9,Secondary,0,0,0
24742,32,State - KERALA,Rural,10,Secondary,0,0,0
24743,32,State - KERALA,Rural,11,Secondary,0,0,0
24744,32,State - KERALA,Rural,12,Secondary,0,0,0
24745,32,State - KERALA,Rural,13,Secondary,0,0,0
24746,32,State - KERALA,Rural,14,Secondary,0,0,0
24747,32,State - KERALA,Rural,15,Secondary,34081,41052,75133
24748,32,State - KERALA,Rural,16,Secondary,78170,87798,165968
24749,32,State - KERALA,Rural,17,Secondary,97517,101957,199474
24750,32,State - KERALA,Rural,18,Secondary,29680,22658,52338
24751,32,State - KERALA,Rural,19,Secondary,19879,15309,35188
24752,32,State - KERALA,Rural,20-24,Secondary,99910,96481,196391
24753,32,State - KERALA,Rural,25-29,Secondary,111262,125109,236371
24754,32,State - KERALA,Rural,30-34,Secondary,105428,119370,224798
24755,32,State - KERALA,Rural,35-39,Secondary,95727,112481,208208
24756,32,State - KERALA,Rural,40-44,Secondary,82471,92007,174478
24757,32,State - KERALA,Rural,45-49,Secondary,73769,73608,147377
24758,32,State - KERALA,Rural,50-54,Secondary,56155,51225,107380
24759,32,State - KERALA,Rural,55-59,Secondary,46848,38109,84957
24760,32,State - KERALA,Rural,60-64,Secondary,32364,22691,55055
24761,32,State - KERALA,Rural,65-69,Secondary,18884,11274,30158
24762,32,State - KERALA,Rural,70-74,Secondary,11594,6231,17825
24763,32,State - KERALA,Rural,75-79,Secondary,5809,2927,8736
24764,32,State - KERALA,Rural,80+,Secondary,3810,1983,5793
24765,32,State - KERALA,Rural,Age not stated,Secondary,607,549,1156
24766,32,State - KERALA,Urban,All ages,Secondary,902055,923550,1825605
24767,32,State - KERALA,Urban,0-6,Secondary,0,0,0
24768,32,State - KERALA,Urban,7,Secondary,0,0,0
24769,32,State - KERALA,Urban,8,Secondary,0,0,0
24770,32,State - KERALA,Urban,9,Secondary,0,0,0
24771,32,State - KERALA,Urban,10,Secondary,0,0,0
24772,32,State - KERALA,Urban,11,Secondary,0,0,0
24773,32,State - KERALA,Urban,12,Secondary,0,0,0
24774,32,State - KERALA,Urban,13,Secondary,0,0,0
24775,32,State - KERALA,Urban,14,Secondary,0,0,0
24776,32,State - KERALA,Urban,15,Secondary,32246,38121,70367
24777,32,State - KERALA,Urban,16,Secondary,73595,81806,155401
24778,32,State - KERALA,Urban,17,Secondary,92450,96944,189394
24779,32,State - KERALA,Urban,18,Secondary,25628,18446,44074
24780,32,State - KERALA,Urban,19,Secondary,16444,11450,27894
24781,32,State - KERALA,Urban,20-24,Secondary,81453,76117,157570
24782,32,State - KERALA,Urban,25-29,Secondary,92199,104889,197088
24783,32,State - KERALA,Urban,30-34,Secondary,90040,104154,194194
24784,32,State - KERALA,Urban,35-39,Secondary,83971,98455,182426
24785,32,State - KERALA,Urban,40-44,Secondary,75192,83727,158919
24786,32,State - KERALA,Urban,45-49,Secondary,67927,67979,135906
24787,32,State - KERALA,Urban,50-54,Secondary,52184,49193,101377
24788,32,State - KERALA,Urban,55-59,Secondary,44143,37910,82053
24789,32,State - KERALA,Urban,60-64,Secondary,31683,24929,56612
24790,32,State - KERALA,Urban,65-69,Secondary,18967,13386,32353
24791,32,State - KERALA,Urban,70-74,Secondary,12088,7962,20050
24792,32,State - KERALA,Urban,75-79,Secondary,6597,4185,10782
24793,32,State - KERALA,Urban,80+,Secondary,4683,3339,8022
24794,32,State - KERALA,Urban,Age not stated,Secondary,565,558,1123
24795,33,State - TAMIL NADU,Total,All ages,Secondary,4540573,3652651,8193224
24796,33,State - TAMIL NADU,Total,0-6,Secondary,0,0,0
24797,33,State - TAMIL NADU,Total,7,Secondary,0,0,0
24798,33,State - TAMIL NADU,Total,8,Secondary,0,0,0
24799,33,State - TAMIL NADU,Total,9,Secondary,0,0,0
24800,33,State - TAMIL NADU,Total,10,Secondary,0,0,0
24801,33,State - TAMIL NADU,Total,11,Secondary,0,0,0
24802,33,State - TAMIL NADU,Total,12,Secondary,0,0,0
24803,33,State - TAMIL NADU,Total,13,Secondary,0,0,0
24804,33,State - TAMIL NADU,Total,14,Secondary,0,0,0
24805,33,State - TAMIL NADU,Total,15,Secondary,308475,325385,633860
24806,33,State - TAMIL NADU,Total,16,Secondary,416585,418602,835187
24807,33,State - TAMIL NADU,Total,17,Secondary,454982,441408,896390
24808,33,State - TAMIL NADU,Total,18,Secondary,130464,119311,249775
24809,33,State - TAMIL NADU,Total,19,Secondary,95786,95970,191756
24810,33,State - TAMIL NADU,Total,20-24,Secondary,470342,512399,982741
24811,33,State - TAMIL NADU,Total,25-29,Secondary,518596,494487,1013083
24812,33,State - TAMIL NADU,Total,30-34,Secondary,486033,354283,840316
24813,33,State - TAMIL NADU,Total,35-39,Secondary,431503,274144,705647
24814,33,State - TAMIL NADU,Total,40-44,Secondary,350690,193919,544609
24815,33,State - TAMIL NADU,Total,45-49,Secondary,281623,147571,429194
24816,33,State - TAMIL NADU,Total,50-54,Secondary,202647,105763,308410
24817,33,State - TAMIL NADU,Total,55-59,Secondary,154300,76508,230808
24818,33,State - TAMIL NADU,Total,60-64,Secondary,111913,46188,158101
24819,33,State - TAMIL NADU,Total,65-69,Secondary,56119,21574,77693
24820,33,State - TAMIL NADU,Total,70-74,Secondary,36646,11916,48562
24821,33,State - TAMIL NADU,Total,75-79,Secondary,17427,5629,23056
24822,33,State - TAMIL NADU,Total,80+,Secondary,13944,5613,19557
24823,33,State - TAMIL NADU,Total,Age not stated,Secondary,2498,1981,4479
24824,33,State - TAMIL NADU,Rural,All ages,Secondary,2211721,1683578,3895299
24825,33,State - TAMIL NADU,Rural,0-6,Secondary,0,0,0
24826,33,State - TAMIL NADU,Rural,7,Secondary,0,0,0
24827,33,State - TAMIL NADU,Rural,8,Secondary,0,0,0
24828,33,State - TAMIL NADU,Rural,9,Secondary,0,0,0
24829,33,State - TAMIL NADU,Rural,10,Secondary,0,0,0
24830,33,State - TAMIL NADU,Rural,11,Secondary,0,0,0
24831,33,State - TAMIL NADU,Rural,12,Secondary,0,0,0
24832,33,State - TAMIL NADU,Rural,13,Secondary,0,0,0
24833,33,State - TAMIL NADU,Rural,14,Secondary,0,0,0
24834,33,State - TAMIL NADU,Rural,15,Secondary,162940,168545,331485
24835,33,State - TAMIL NADU,Rural,16,Secondary,218177,212210,430387
24836,33,State - TAMIL NADU,Rural,17,Secondary,238368,221474,459842
24837,33,State - TAMIL NADU,Rural,18,Secondary,76684,70224,146908
24838,33,State - TAMIL NADU,Rural,19,Secondary,55978,56568,112546
24839,33,State - TAMIL NADU,Rural,20-24,Secondary,264814,283800,548614
24840,33,State - TAMIL NADU,Rural,25-29,Secondary,271851,245462,517313
24841,33,State - TAMIL NADU,Rural,30-34,Secondary,236862,152250,389112
24842,33,State - TAMIL NADU,Rural,35-39,Secondary,198426,103001,301427
24843,33,State - TAMIL NADU,Rural,40-44,Secondary,147102,59586,206688
24844,33,State - TAMIL NADU,Rural,45-49,Secondary,112339,41458,153797
24845,33,State - TAMIL NADU,Rural,50-54,Secondary,79283,28608,107891
24846,33,State - TAMIL NADU,Rural,55-59,Secondary,61711,20596,82307
24847,33,State - TAMIL NADU,Rural,60-64,Secondary,43661,10394,54055
24848,33,State - TAMIL NADU,Rural,65-69,Secondary,20170,4282,24452
24849,33,State - TAMIL NADU,Rural,70-74,Secondary,12429,2046,14475
24850,33,State - TAMIL NADU,Rural,75-79,Secondary,5280,895,6175
24851,33,State - TAMIL NADU,Rural,80+,Secondary,4404,1222,5626
24852,33,State - TAMIL NADU,Rural,Age not stated,Secondary,1242,957,2199
24853,33,State - TAMIL NADU,Urban,All ages,Secondary,2328852,1969073,4297925
24854,33,State - TAMIL NADU,Urban,0-6,Secondary,0,0,0
24855,33,State - TAMIL NADU,Urban,7,Secondary,0,0,0
24856,33,State - TAMIL NADU,Urban,8,Secondary,0,0,0
24857,33,State - TAMIL NADU,Urban,9,Secondary,0,0,0
24858,33,State - TAMIL NADU,Urban,10,Secondary,0,0,0
24859,33,State - TAMIL NADU,Urban,11,Secondary,0,0,0
24860,33,State - TAMIL NADU,Urban,12,Secondary,0,0,0
24861,33,State - TAMIL NADU,Urban,13,Secondary,0,0,0
24862,33,State - TAMIL NADU,Urban,14,Secondary,0,0,0
24863,33,State - TAMIL NADU,Urban,15,Secondary,145535,156840,302375
24864,33,State - TAMIL NADU,Urban,16,Secondary,198408,206392,404800
24865,33,State - TAMIL NADU,Urban,17,Secondary,216614,219934,436548
24866,33,State - TAMIL NADU,Urban,18,Secondary,53780,49087,102867
24867,33,State - TAMIL NADU,Urban,19,Secondary,39808,39402,79210
24868,33,State - TAMIL NADU,Urban,20-24,Secondary,205528,228599,434127
24869,33,State - TAMIL NADU,Urban,25-29,Secondary,246745,249025,495770
24870,33,State - TAMIL NADU,Urban,30-34,Secondary,249171,202033,451204
24871,33,State - TAMIL NADU,Urban,35-39,Secondary,233077,171143,404220
24872,33,State - TAMIL NADU,Urban,40-44,Secondary,203588,134333,337921
24873,33,State - TAMIL NADU,Urban,45-49,Secondary,169284,106113,275397
24874,33,State - TAMIL NADU,Urban,50-54,Secondary,123364,77155,200519
24875,33,State - TAMIL NADU,Urban,55-59,Secondary,92589,55912,148501
24876,33,State - TAMIL NADU,Urban,60-64,Secondary,68252,35794,104046
24877,33,State - TAMIL NADU,Urban,65-69,Secondary,35949,17292,53241
24878,33,State - TAMIL NADU,Urban,70-74,Secondary,24217,9870,34087
24879,33,State - TAMIL NADU,Urban,75-79,Secondary,12147,4734,16881
24880,33,State - TAMIL NADU,Urban,80+,Secondary,9540,4391,13931
24881,33,State - TAMIL NADU,Urban,Age not stated,Secondary,1256,1024,2280
24882,34,State - PUDUCHERRY,Total,All ages,Secondary,87749,74077,161826
24883,34,State - PUDUCHERRY,Total,0-6,Secondary,0,0,0
24884,34,State - PUDUCHERRY,Total,7,Secondary,0,0,0
24885,34,State - PUDUCHERRY,Total,8,Secondary,0,0,0
24886,34,State - PUDUCHERRY,Total,9,Secondary,0,0,0
24887,34,State - PUDUCHERRY,Total,10,Secondary,0,0,0
24888,34,State - PUDUCHERRY,Total,11,Secondary,0,0,0
24889,34,State - PUDUCHERRY,Total,12,Secondary,0,0,0
24890,34,State - PUDUCHERRY,Total,13,Secondary,0,0,0
24891,34,State - PUDUCHERRY,Total,14,Secondary,0,0,0
24892,34,State - PUDUCHERRY,Total,15,Secondary,4147,4489,8636
24893,34,State - PUDUCHERRY,Total,16,Secondary,6886,7267,14153
24894,34,State - PUDUCHERRY,Total,17,Secondary,8099,7835,15934
24895,34,State - PUDUCHERRY,Total,18,Secondary,2181,2092,4273
24896,34,State - PUDUCHERRY,Total,19,Secondary,1681,1676,3357
24897,34,State - PUDUCHERRY,Total,20-24,Secondary,7907,9484,17391
24898,34,State - PUDUCHERRY,Total,25-29,Secondary,9482,10194,19676
24899,34,State - PUDUCHERRY,Total,30-34,Secondary,9596,8593,18189
24900,34,State - PUDUCHERRY,Total,35-39,Secondary,8565,6614,15179
24901,34,State - PUDUCHERRY,Total,40-44,Secondary,7603,4869,12472
24902,34,State - PUDUCHERRY,Total,45-49,Secondary,6660,3647,10307
24903,34,State - PUDUCHERRY,Total,50-54,Secondary,4859,2775,7634
24904,34,State - PUDUCHERRY,Total,55-59,Secondary,3732,1935,5667
24905,34,State - PUDUCHERRY,Total,60-64,Secondary,2884,1263,4147
24906,34,State - PUDUCHERRY,Total,65-69,Secondary,1422,549,1971
24907,34,State - PUDUCHERRY,Total,70-74,Secondary,1021,380,1401
24908,34,State - PUDUCHERRY,Total,75-79,Secondary,515,201,716
24909,34,State - PUDUCHERRY,Total,80+,Secondary,461,177,638
24910,34,State - PUDUCHERRY,Total,Age not stated,Secondary,48,37,85
24911,34,State - PUDUCHERRY,Rural,All ages,Secondary,28303,21997,50300
24912,34,State - PUDUCHERRY,Rural,0-6,Secondary,0,0,0
24913,34,State - PUDUCHERRY,Rural,7,Secondary,0,0,0
24914,34,State - PUDUCHERRY,Rural,8,Secondary,0,0,0
24915,34,State - PUDUCHERRY,Rural,9,Secondary,0,0,0
24916,34,State - PUDUCHERRY,Rural,10,Secondary,0,0,0
24917,34,State - PUDUCHERRY,Rural,11,Secondary,0,0,0
24918,34,State - PUDUCHERRY,Rural,12,Secondary,0,0,0
24919,34,State - PUDUCHERRY,Rural,13,Secondary,0,0,0
24920,34,State - PUDUCHERRY,Rural,14,Secondary,0,0,0
24921,34,State - PUDUCHERRY,Rural,15,Secondary,1414,1564,2978
24922,34,State - PUDUCHERRY,Rural,16,Secondary,2163,2353,4516
24923,34,State - PUDUCHERRY,Rural,17,Secondary,2581,2444,5025
24924,34,State - PUDUCHERRY,Rural,18,Secondary,750,751,1501
24925,34,State - PUDUCHERRY,Rural,19,Secondary,674,693,1367
24926,34,State - PUDUCHERRY,Rural,20-24,Secondary,3091,3794,6885
24927,34,State - PUDUCHERRY,Rural,25-29,Secondary,3724,3603,7327
24928,34,State - PUDUCHERRY,Rural,30-34,Secondary,3510,2620,6130
24929,34,State - PUDUCHERRY,Rural,35-39,Secondary,2868,1711,4579
24930,34,State - PUDUCHERRY,Rural,40-44,Secondary,2298,933,3231
24931,34,State - PUDUCHERRY,Rural,45-49,Secondary,1921,628,2549
24932,34,State - PUDUCHERRY,Rural,50-54,Secondary,1226,384,1610
24933,34,State - PUDUCHERRY,Rural,55-59,Secondary,870,269,1139
24934,34,State - PUDUCHERRY,Rural,60-64,Secondary,612,135,747
24935,34,State - PUDUCHERRY,Rural,65-69,Secondary,266,41,307
24936,34,State - PUDUCHERRY,Rural,70-74,Secondary,176,27,203
24937,34,State - PUDUCHERRY,Rural,75-79,Secondary,73,20,93
24938,34,State - PUDUCHERRY,Rural,80+,Secondary,65,13,78
24939,34,State - PUDUCHERRY,Rural,Age not stated,Secondary,21,14,35
24940,34,State - PUDUCHERRY,Urban,All ages,Secondary,59446,52080,111526
24941,34,State - PUDUCHERRY,Urban,0-6,Secondary,0,0,0
24942,34,State - PUDUCHERRY,Urban,7,Secondary,0,0,0
24943,34,State - PUDUCHERRY,Urban,8,Secondary,0,0,0
24944,34,State - PUDUCHERRY,Urban,9,Secondary,0,0,0
24945,34,State - PUDUCHERRY,Urban,10,Secondary,0,0,0
24946,34,State - PUDUCHERRY,Urban,11,Secondary,0,0,0
24947,34,State - PUDUCHERRY,Urban,12,Secondary,0,0,0
24948,34,State - PUDUCHERRY,Urban,13,Secondary,0,0,0
24949,34,State - PUDUCHERRY,Urban,14,Secondary,0,0,0
24950,34,State - PUDUCHERRY,Urban,15,Secondary,2733,2925,5658
24951,34,State - PUDUCHERRY,Urban,16,Secondary,4723,4914,9637
24952,34,State - PUDUCHERRY,Urban,17,Secondary,5518,5391,10909
24953,34,State - PUDUCHERRY,Urban,18,Secondary,1431,1341,2772
24954,34,State - PUDUCHERRY,Urban,19,Secondary,1007,983,1990
24955,34,State - PUDUCHERRY,Urban,20-24,Secondary,4816,5690,10506
24956,34,State - PUDUCHERRY,Urban,25-29,Secondary,5758,6591,12349
24957,34,State - PUDUCHERRY,Urban,30-34,Secondary,6086,5973,12059
24958,34,State - PUDUCHERRY,Urban,35-39,Secondary,5697,4903,10600
24959,34,State - PUDUCHERRY,Urban,40-44,Secondary,5305,3936,9241
24960,34,State - PUDUCHERRY,Urban,45-49,Secondary,4739,3019,7758
24961,34,State - PUDUCHERRY,Urban,50-54,Secondary,3633,2391,6024
24962,34,State - PUDUCHERRY,Urban,55-59,Secondary,2862,1666,4528
24963,34,State - PUDUCHERRY,Urban,60-64,Secondary,2272,1128,3400
24964,34,State - PUDUCHERRY,Urban,65-69,Secondary,1156,508,1664
24965,34,State - PUDUCHERRY,Urban,70-74,Secondary,845,353,1198
24966,34,State - PUDUCHERRY,Urban,75-79,Secondary,442,181,623
24967,34,State - PUDUCHERRY,Urban,80+,Secondary,396,164,560
24968,34,State - PUDUCHERRY,Urban,Age not stated,Secondary,27,23,50
24969,35,State - ANDAMAN & NICOBAR ISLANDS,Total,All ages,Secondary,26053,19051,45104
24970,35,State - ANDAMAN & NICOBAR ISLANDS,Total,0-6,Secondary,0,0,0
24971,35,State - ANDAMAN & NICOBAR ISLANDS,Total,7,Secondary,0,0,0
24972,35,State - ANDAMAN & NICOBAR ISLANDS,Total,8,Secondary,0,0,0
24973,35,State - ANDAMAN & NICOBAR ISLANDS,Total,9,Secondary,0,0,0
24974,35,State - ANDAMAN & NICOBAR ISLANDS,Total,10,Secondary,0,0,0
24975,35,State - ANDAMAN & NICOBAR ISLANDS,Total,11,Secondary,0,0,0
24976,35,State - ANDAMAN & NICOBAR ISLANDS,Total,12,Secondary,0,0,0
24977,35,State - ANDAMAN & NICOBAR ISLANDS,Total,13,Secondary,0,0,0
24978,35,State - ANDAMAN & NICOBAR ISLANDS,Total,14,Secondary,0,0,0
24979,35,State - ANDAMAN & NICOBAR ISLANDS,Total,15,Secondary,661,757,1418
24980,35,State - ANDAMAN & NICOBAR ISLANDS,Total,16,Secondary,1413,1592,3005
24981,35,State - ANDAMAN & NICOBAR ISLANDS,Total,17,Secondary,1839,1933,3772
24982,35,State - ANDAMAN & NICOBAR ISLANDS,Total,18,Secondary,1150,1037,2187
24983,35,State - ANDAMAN & NICOBAR ISLANDS,Total,19,Secondary,830,717,1547
24984,35,State - ANDAMAN & NICOBAR ISLANDS,Total,20-24,Secondary,3179,2796,5975
24985,35,State - ANDAMAN & NICOBAR ISLANDS,Total,25-29,Secondary,3423,2555,5978
24986,35,State - ANDAMAN & NICOBAR ISLANDS,Total,30-34,Secondary,3174,2208,5382
24987,35,State - ANDAMAN & NICOBAR ISLANDS,Total,35-39,Secondary,2650,1888,4538
24988,35,State - ANDAMAN & NICOBAR ISLANDS,Total,40-44,Secondary,2163,1160,3323
24989,35,State - ANDAMAN & NICOBAR ISLANDS,Total,45-49,Secondary,1632,857,2489
24990,35,State - ANDAMAN & NICOBAR ISLANDS,Total,50-54,Secondary,1338,662,2000
24991,35,State - ANDAMAN & NICOBAR ISLANDS,Total,55-59,Secondary,1208,473,1681
24992,35,State - ANDAMAN & NICOBAR ISLANDS,Total,60-64,Secondary,667,217,884
24993,35,State - ANDAMAN & NICOBAR ISLANDS,Total,65-69,Secondary,321,106,427
24994,35,State - ANDAMAN & NICOBAR ISLANDS,Total,70-74,Secondary,193,44,237
24995,35,State - ANDAMAN & NICOBAR ISLANDS,Total,75-79,Secondary,93,21,114
24996,35,State - ANDAMAN & NICOBAR ISLANDS,Total,80+,Secondary,93,17,110
24997,35,State - ANDAMAN & NICOBAR ISLANDS,Total,Age not stated,Secondary,26,11,37
24998,35,State - ANDAMAN & NICOBAR ISLANDS,Rural,All ages,Secondary,14448,10219,24667
24999,35,State - ANDAMAN & NICOBAR ISLANDS,Rural,0-6,Secondary,0,0,0
25000,35,State - ANDAMAN & NICOBAR ISLANDS,Rural,7,Secondary,0,0,0
25001,35,State - ANDAMAN & NICOBAR ISLANDS,Rural,8,Secondary,0,0,0
25002,35,State - ANDAMAN & NICOBAR ISLANDS,Rural,9,Secondary,0,0,0
25003,35,State - ANDAMAN & NICOBAR ISLANDS,Rural,10,Secondary,0,0,0
25004,35,State - ANDAMAN & NICOBAR ISLANDS,Rural,11,Secondary,0,0,0
25005,35,State - ANDAMAN & NICOBAR ISLANDS,Rural,12,Secondary,0,0,0
25006,35,State - ANDAMAN & NICOBAR ISLANDS,Rural,13,Secondary,0,0,0
25007,35,State - ANDAMAN & NICOBAR ISLANDS,Rural,14,Secondary,0,0,0
25008,35,State - ANDAMAN & NICOBAR ISLANDS,Rural,15,Secondary,362,401,763
25009,35,State - ANDAMAN & NICOBAR ISLANDS,Rural,16,Secondary,793,889,1682
25010,35,State - ANDAMAN & NICOBAR ISLANDS,Rural,17,Secondary,1016,1080,2096
25011,35,State - ANDAMAN & NICOBAR ISLANDS,Rural,18,Secondary,703,666,1369
25012,35,State - ANDAMAN & NICOBAR ISLANDS,Rural,19,Secondary,527,450,977
25013,35,State - ANDAMAN & NICOBAR ISLANDS,Rural,20-24,Secondary,1933,1707,3640
25014,35,State - ANDAMAN & NICOBAR ISLANDS,Rural,25-29,Secondary,2015,1420,3435
25015,35,State - ANDAMAN & NICOBAR ISLANDS,Rural,30-34,Secondary,1781,1155,2936
25016,35,State - ANDAMAN & NICOBAR ISLANDS,Rural,35-39,Secondary,1416,980,2396
25017,35,State - ANDAMAN & NICOBAR ISLANDS,Rural,40-44,Secondary,1140,551,1691
25018,35,State - ANDAMAN & NICOBAR ISLANDS,Rural,45-49,Secondary,798,341,1139
25019,35,State - ANDAMAN & NICOBAR ISLANDS,Rural,50-54,Secondary,644,275,919
25020,35,State - ANDAMAN & NICOBAR ISLANDS,Rural,55-59,Secondary,604,175,779
25021,35,State - ANDAMAN & NICOBAR ISLANDS,Rural,60-64,Secondary,375,71,446
25022,35,State - ANDAMAN & NICOBAR ISLANDS,Rural,65-69,Secondary,164,37,201
25023,35,State - ANDAMAN & NICOBAR ISLANDS,Rural,70-74,Secondary,79,10,89
25024,35,State - ANDAMAN & NICOBAR ISLANDS,Rural,75-79,Secondary,44,2,46
25025,35,State - ANDAMAN & NICOBAR ISLANDS,Rural,80+,Secondary,43,4,47
25026,35,State - ANDAMAN & NICOBAR ISLANDS,Rural,Age not stated,Secondary,11,5,16
25027,35,State - ANDAMAN & NICOBAR ISLANDS,Urban,All ages,Secondary,11605,8832,20437
25028,35,State - ANDAMAN & NICOBAR ISLANDS,Urban,0-6,Secondary,0,0,0
25029,35,State - ANDAMAN & NICOBAR ISLANDS,Urban,7,Secondary,0,0,0
25030,35,State - ANDAMAN & NICOBAR ISLANDS,Urban,8,Secondary,0,0,0
25031,35,State - ANDAMAN & NICOBAR ISLANDS,Urban,9,Secondary,0,0,0
25032,35,State - ANDAMAN & NICOBAR ISLANDS,Urban,10,Secondary,0,0,0
25033,35,State - ANDAMAN & NICOBAR ISLANDS,Urban,11,Secondary,0,0,0
25034,35,State - ANDAMAN & NICOBAR ISLANDS,Urban,12,Secondary,0,0,0
25035,35,State - ANDAMAN & NICOBAR ISLANDS,Urban,13,Secondary,0,0,0
25036,35,State - ANDAMAN & NICOBAR ISLANDS,Urban,14,Secondary,0,0,0
25037,35,State - ANDAMAN & NICOBAR ISLANDS,Urban,15,Secondary,299,356,655
25038,35,State - ANDAMAN & NICOBAR ISLANDS,Urban,16,Secondary,620,703,1323
25039,35,State - ANDAMAN & NICOBAR ISLANDS,Urban,17,Secondary,823,853,1676
25040,35,State - ANDAMAN & NICOBAR ISLANDS,Urban,18,Secondary,447,371,818
25041,35,State - ANDAMAN & NICOBAR ISLANDS,Urban,19,Secondary,303,267,570
25042,35,State - ANDAMAN & NICOBAR ISLANDS,Urban,20-24,Secondary,1246,1089,2335
25043,35,State - ANDAMAN & NICOBAR ISLANDS,Urban,25-29,Secondary,1408,1135,2543
25044,35,State - ANDAMAN & NICOBAR ISLANDS,Urban,30-34,Secondary,1393,1053,2446
25045,35,State - ANDAMAN & NICOBAR ISLANDS,Urban,35-39,Secondary,1234,908,2142
25046,35,State - ANDAMAN & NICOBAR ISLANDS,Urban,40-44,Secondary,1023,609,1632
25047,35,State - ANDAMAN & NICOBAR ISLANDS,Urban,45-49,Secondary,834,516,1350
25048,35,State - ANDAMAN & NICOBAR ISLANDS,Urban,50-54,Secondary,694,387,1081
25049,35,State - ANDAMAN & NICOBAR ISLANDS,Urban,55-59,Secondary,604,298,902
25050,35,State - ANDAMAN & NICOBAR ISLANDS,Urban,60-64,Secondary,292,146,438
25051,35,State - ANDAMAN & NICOBAR ISLANDS,Urban,65-69,Secondary,157,69,226
25052,35,State - ANDAMAN & NICOBAR ISLANDS,Urban,70-74,Secondary,114,34,148
25053,35,State - ANDAMAN & NICOBAR ISLANDS,Urban,75-79,Secondary,49,19,68
25054,35,State - ANDAMAN & NICOBAR ISLANDS,Urban,80+,Secondary,50,13,63
25055,35,State - ANDAMAN & NICOBAR ISLANDS,Urban,Age not stated,Secondary,15,6,21
25056,0,INDIA,Total,All ages,Non-Technical Diploma,726565,345724,1072289
25057,0,INDIA,Total,0-6,Non-Technical Diploma,0,0,0
25058,0,INDIA,Total,7,Non-Technical Diploma,0,0,0
25059,0,INDIA,Total,8,Non-Technical Diploma,0,0,0
25060,0,INDIA,Total,9,Non-Technical Diploma,0,0,0
25061,0,INDIA,Total,10,Non-Technical Diploma,0,0,0
25062,0,INDIA,Total,11,Non-Technical Diploma,0,0,0
25063,0,INDIA,Total,12,Non-Technical Diploma,0,0,0
25064,0,INDIA,Total,13,Non-Technical Diploma,0,0,0
25065,0,INDIA,Total,14,Non-Technical Diploma,0,0,0
25066,0,INDIA,Total,15,Non-Technical Diploma,0,0,0
25067,0,INDIA,Total,16,Non-Technical Diploma,0,0,0
25068,0,INDIA,Total,17,Non-Technical Diploma,0,0,0
25069,0,INDIA,Total,18,Non-Technical Diploma,40027,19726,59753
25070,0,INDIA,Total,19,Non-Technical Diploma,37836,17178,55014
25071,0,INDIA,Total,20-24,Non-Technical Diploma,160093,76240,236333
25072,0,INDIA,Total,25-29,Non-Technical Diploma,101339,54424,155763
25073,0,INDIA,Total,30-34,Non-Technical Diploma,82426,41306,123732
25074,0,INDIA,Total,35-39,Non-Technical Diploma,72019,35083,107102
25075,0,INDIA,Total,40-44,Non-Technical Diploma,58197,26383,84580
25076,0,INDIA,Total,45-49,Non-Technical Diploma,43519,18919,62438
25077,0,INDIA,Total,50-54,Non-Technical Diploma,32887,14173,47060
25078,0,INDIA,Total,55-59,Non-Technical Diploma,26435,12659,39094
25079,0,INDIA,Total,60-64,Non-Technical Diploma,25473,10652,36125
25080,0,INDIA,Total,65-69,Non-Technical Diploma,19045,6974,26019
25081,0,INDIA,Total,70-74,Non-Technical Diploma,12084,4912,16996
25082,0,INDIA,Total,75-79,Non-Technical Diploma,5946,2671,8617
25083,0,INDIA,Total,80+,Non-Technical Diploma,6134,2798,8932
25084,0,INDIA,Total,Age not stated,Non-Technical Diploma,3105,1626,4731
25085,0,INDIA,Rural,All ages,Non-Technical Diploma,287418,146694,434112
25086,0,INDIA,Rural,0-6,Non-Technical Diploma,0,0,0
25087,0,INDIA,Rural,7,Non-Technical Diploma,0,0,0
25088,0,INDIA,Rural,8,Non-Technical Diploma,0,0,0
25089,0,INDIA,Rural,9,Non-Technical Diploma,0,0,0
25090,0,INDIA,Rural,10,Non-Technical Diploma,0,0,0
25091,0,INDIA,Rural,11,Non-Technical Diploma,0,0,0
25092,0,INDIA,Rural,12,Non-Technical Diploma,0,0,0
25093,0,INDIA,Rural,13,Non-Technical Diploma,0,0,0
25094,0,INDIA,Rural,14,Non-Technical Diploma,0,0,0
25095,0,INDIA,Rural,15,Non-Technical Diploma,0,0,0
25096,0,INDIA,Rural,16,Non-Technical Diploma,0,0,0
25097,0,INDIA,Rural,17,Non-Technical Diploma,0,0,0
25098,0,INDIA,Rural,18,Non-Technical Diploma,20341,10334,30675
25099,0,INDIA,Rural,19,Non-Technical Diploma,18633,8353,26986
25100,0,INDIA,Rural,20-24,Non-Technical Diploma,76245,35514,111759
25101,0,INDIA,Rural,25-29,Non-Technical Diploma,42383,23268,65651
25102,0,INDIA,Rural,30-34,Non-Technical Diploma,29894,17088,46982
25103,0,INDIA,Rural,35-39,Non-Technical Diploma,24676,14237,38913
25104,0,INDIA,Rural,40-44,Non-Technical Diploma,19145,10704,29849
25105,0,INDIA,Rural,45-49,Non-Technical Diploma,13947,7251,21198
25106,0,INDIA,Rural,50-54,Non-Technical Diploma,10425,5046,15471
25107,0,INDIA,Rural,55-59,Non-Technical Diploma,8584,4876,13460
25108,0,INDIA,Rural,60-64,Non-Technical Diploma,8331,4150,12481
25109,0,INDIA,Rural,65-69,Non-Technical Diploma,5821,2398,8219
25110,0,INDIA,Rural,70-74,Non-Technical Diploma,3768,1272,5040
25111,0,INDIA,Rural,75-79,Non-Technical Diploma,1866,632,2498
25112,0,INDIA,Rural,80+,Non-Technical Diploma,2288,785,3073
25113,0,INDIA,Rural,Age not stated,Non-Technical Diploma,1071,786,1857
25114,0,INDIA,Urban,All ages,Non-Technical Diploma,439147,199030,638177
25115,0,INDIA,Urban,0-6,Non-Technical Diploma,0,0,0
25116,0,INDIA,Urban,7,Non-Technical Diploma,0,0,0
25117,0,INDIA,Urban,8,Non-Technical Diploma,0,0,0
25118,0,INDIA,Urban,9,Non-Technical Diploma,0,0,0
25119,0,INDIA,Urban,10,Non-Technical Diploma,0,0,0
25120,0,INDIA,Urban,11,Non-Technical Diploma,0,0,0
25121,0,INDIA,Urban,12,Non-Technical Diploma,0,0,0
25122,0,INDIA,Urban,13,Non-Technical Diploma,0,0,0
25123,0,INDIA,Urban,14,Non-Technical Diploma,0,0,0
25124,0,INDIA,Urban,15,Non-Technical Diploma,0,0,0
25125,0,INDIA,Urban,16,Non-Technical Diploma,0,0,0
25126,0,INDIA,Urban,17,Non-Technical Diploma,0,0,0
25127,0,INDIA,Urban,18,Non-Technical Diploma,19686,9392,29078
25128,0,INDIA,Urban,19,Non-Technical Diploma,19203,8825,28028
25129,0,INDIA,Urban,20-24,Non-Technical Diploma,83848,40726,124574
25130,0,INDIA,Urban,25-29,Non-Technical Diploma,58956,31156,90112
25131,0,INDIA,Urban,30-34,Non-Technical Diploma,52532,24218,76750
25132,0,INDIA,Urban,35-39,Non-Technical Diploma,47343,20846,68189
25133,0,INDIA,Urban,40-44,Non-Technical Diploma,39052,15679,54731
25134,0,INDIA,Urban,45-49,Non-Technical Diploma,29572,11668,41240
25135,0,INDIA,Urban,50-54,Non-Technical Diploma,22462,9127,31589
25136,0,INDIA,Urban,55-59,Non-Technical Diploma,17851,7783,25634
25137,0,INDIA,Urban,60-64,Non-Technical Diploma,17142,6502,23644
25138,0,INDIA,Urban,65-69,Non-Technical Diploma,13224,4576,17800
25139,0,INDIA,Urban,70-74,Non-Technical Diploma,8316,3640,11956
25140,0,INDIA,Urban,75-79,Non-Technical Diploma,4080,2039,6119
25141,0,INDIA,Urban,80+,Non-Technical Diploma,3846,2013,5859
25142,0,INDIA,Urban,Age not stated,Non-Technical Diploma,2034,840,2874
25143,1,State - JAMMU & KASHMIR,Total,All ages,Non-Technical Diploma,3542,1239,4781
25144,1,State - JAMMU & KASHMIR,Total,0-6,Non-Technical Diploma,0,0,0
25145,1,State - JAMMU & KASHMIR,Total,7,Non-Technical Diploma,0,0,0
25146,1,State - JAMMU & KASHMIR,Total,8,Non-Technical Diploma,0,0,0
25147,1,State - JAMMU & KASHMIR,Total,9,Non-Technical Diploma,0,0,0
25148,1,State - JAMMU & KASHMIR,Total,10,Non-Technical Diploma,0,0,0
25149,1,State - JAMMU & KASHMIR,Total,11,Non-Technical Diploma,0,0,0
25150,1,State - JAMMU & KASHMIR,Total,12,Non-Technical Diploma,0,0,0
25151,1,State - JAMMU & KASHMIR,Total,13,Non-Technical Diploma,0,0,0
25152,1,State - JAMMU & KASHMIR,Total,14,Non-Technical Diploma,0,0,0
25153,1,State - JAMMU & KASHMIR,Total,15,Non-Technical Diploma,0,0,0
25154,1,State - JAMMU & KASHMIR,Total,16,Non-Technical Diploma,0,0,0
25155,1,State - JAMMU & KASHMIR,Total,17,Non-Technical Diploma,0,0,0
25156,1,State - JAMMU & KASHMIR,Total,18,Non-Technical Diploma,238,86,324
25157,1,State - JAMMU & KASHMIR,Total,19,Non-Technical Diploma,197,55,252
25158,1,State - JAMMU & KASHMIR,Total,20-24,Non-Technical Diploma,900,397,1297
25159,1,State - JAMMU & KASHMIR,Total,25-29,Non-Technical Diploma,583,221,804
25160,1,State - JAMMU & KASHMIR,Total,30-34,Non-Technical Diploma,416,139,555
25161,1,State - JAMMU & KASHMIR,Total,35-39,Non-Technical Diploma,269,80,349
25162,1,State - JAMMU & KASHMIR,Total,40-44,Non-Technical Diploma,219,53,272
25163,1,State - JAMMU & KASHMIR,Total,45-49,Non-Technical Diploma,188,34,222
25164,1,State - JAMMU & KASHMIR,Total,50-54,Non-Technical Diploma,133,23,156
25165,1,State - JAMMU & KASHMIR,Total,55-59,Non-Technical Diploma,110,16,126
25166,1,State - JAMMU & KASHMIR,Total,60-64,Non-Technical Diploma,79,30,109
25167,1,State - JAMMU & KASHMIR,Total,65-69,Non-Technical Diploma,63,17,80
25168,1,State - JAMMU & KASHMIR,Total,70-74,Non-Technical Diploma,55,46,101
25169,1,State - JAMMU & KASHMIR,Total,75-79,Non-Technical Diploma,27,18,45
25170,1,State - JAMMU & KASHMIR,Total,80+,Non-Technical Diploma,50,23,73
25171,1,State - JAMMU & KASHMIR,Total,Age not stated,Non-Technical Diploma,15,1,16
25172,1,State - JAMMU & KASHMIR,Rural,All ages,Non-Technical Diploma,2149,684,2833
25173,1,State - JAMMU & KASHMIR,Rural,0-6,Non-Technical Diploma,0,0,0
25174,1,State - JAMMU & KASHMIR,Rural,7,Non-Technical Diploma,0,0,0
25175,1,State - JAMMU & KASHMIR,Rural,8,Non-Technical Diploma,0,0,0
25176,1,State - JAMMU & KASHMIR,Rural,9,Non-Technical Diploma,0,0,0
25177,1,State - JAMMU & KASHMIR,Rural,10,Non-Technical Diploma,0,0,0
25178,1,State - JAMMU & KASHMIR,Rural,11,Non-Technical Diploma,0,0,0
25179,1,State - JAMMU & KASHMIR,Rural,12,Non-Technical Diploma,0,0,0
25180,1,State - JAMMU & KASHMIR,Rural,13,Non-Technical Diploma,0,0,0
25181,1,State - JAMMU & KASHMIR,Rural,14,Non-Technical Diploma,0,0,0
25182,1,State - JAMMU & KASHMIR,Rural,15,Non-Technical Diploma,0,0,0
25183,1,State - JAMMU & KASHMIR,Rural,16,Non-Technical Diploma,0,0,0
25184,1,State - JAMMU & KASHMIR,Rural,17,Non-Technical Diploma,0,0,0
25185,1,State - JAMMU & KASHMIR,Rural,18,Non-Technical Diploma,163,74,237
25186,1,State - JAMMU & KASHMIR,Rural,19,Non-Technical Diploma,131,42,173
25187,1,State - JAMMU & KASHMIR,Rural,20-24,Non-Technical Diploma,606,266,872
25188,1,State - JAMMU & KASHMIR,Rural,25-29,Non-Technical Diploma,382,130,512
25189,1,State - JAMMU & KASHMIR,Rural,30-34,Non-Technical Diploma,260,79,339
25190,1,State - JAMMU & KASHMIR,Rural,35-39,Non-Technical Diploma,162,38,200
25191,1,State - JAMMU & KASHMIR,Rural,40-44,Non-Technical Diploma,105,22,127
25192,1,State - JAMMU & KASHMIR,Rural,45-49,Non-Technical Diploma,92,9,101
25193,1,State - JAMMU & KASHMIR,Rural,50-54,Non-Technical Diploma,61,6,67
25194,1,State - JAMMU & KASHMIR,Rural,55-59,Non-Technical Diploma,49,3,52
25195,1,State - JAMMU & KASHMIR,Rural,60-64,Non-Technical Diploma,36,6,42
25196,1,State - JAMMU & KASHMIR,Rural,65-69,Non-Technical Diploma,32,1,33
25197,1,State - JAMMU & KASHMIR,Rural,70-74,Non-Technical Diploma,26,3,29
25198,1,State - JAMMU & KASHMIR,Rural,75-79,Non-Technical Diploma,11,2,13
25199,1,State - JAMMU & KASHMIR,Rural,80+,Non-Technical Diploma,31,2,33
25200,1,State - JAMMU & KASHMIR,Rural,Age not stated,Non-Technical Diploma,2,1,3
25201,1,State - JAMMU & KASHMIR,Urban,All ages,Non-Technical Diploma,1393,555,1948
25202,1,State - JAMMU & KASHMIR,Urban,0-6,Non-Technical Diploma,0,0,0
25203,1,State - JAMMU & KASHMIR,Urban,7,Non-Technical Diploma,0,0,0
25204,1,State - JAMMU & KASHMIR,Urban,8,Non-Technical Diploma,0,0,0
25205,1,State - JAMMU & KASHMIR,Urban,9,Non-Technical Diploma,0,0,0
25206,1,State - JAMMU & KASHMIR,Urban,10,Non-Technical Diploma,0,0,0
25207,1,State - JAMMU & KASHMIR,Urban,11,Non-Technical Diploma,0,0,0
25208,1,State - JAMMU & KASHMIR,Urban,12,Non-Technical Diploma,0,0,0
25209,1,State - JAMMU & KASHMIR,Urban,13,Non-Technical Diploma,0,0,0
25210,1,State - JAMMU & KASHMIR,Urban,14,Non-Technical Diploma,0,0,0
25211,1,State - JAMMU & KASHMIR,Urban,15,Non-Technical Diploma,0,0,0
25212,1,State - JAMMU & KASHMIR,Urban,16,Non-Technical Diploma,0,0,0
25213,1,State - JAMMU & KASHMIR,Urban,17,Non-Technical Diploma,0,0,0
25214,1,State - JAMMU & KASHMIR,Urban,18,Non-Technical Diploma,75,12,87
25215,1,State - JAMMU & KASHMIR,Urban,19,Non-Technical Diploma,66,13,79
25216,1,State - JAMMU & KASHMIR,Urban,20-24,Non-Technical Diploma,294,131,425
25217,1,State - JAMMU & KASHMIR,Urban,25-29,Non-Technical Diploma,201,91,292
25218,1,State - JAMMU & KASHMIR,Urban,30-34,Non-Technical Diploma,156,60,216
25219,1,State - JAMMU & KASHMIR,Urban,35-39,Non-Technical Diploma,107,42,149
25220,1,State - JAMMU & KASHMIR,Urban,40-44,Non-Technical Diploma,114,31,145
25221,1,State - JAMMU & KASHMIR,Urban,45-49,Non-Technical Diploma,96,25,121
25222,1,State - JAMMU & KASHMIR,Urban,50-54,Non-Technical Diploma,72,17,89
25223,1,State - JAMMU & KASHMIR,Urban,55-59,Non-Technical Diploma,61,13,74
25224,1,State - JAMMU & KASHMIR,Urban,60-64,Non-Technical Diploma,43,24,67
25225,1,State - JAMMU & KASHMIR,Urban,65-69,Non-Technical Diploma,31,16,47
25226,1,State - JAMMU & KASHMIR,Urban,70-74,Non-Technical Diploma,29,43,72
25227,1,State - JAMMU & KASHMIR,Urban,75-79,Non-Technical Diploma,16,16,32
25228,1,State - JAMMU & KASHMIR,Urban,80+,Non-Technical Diploma,19,21,40
25229,1,State - JAMMU & KASHMIR,Urban,Age not stated,Non-Technical Diploma,13,0,13
25230,2,State - HIMACHAL PRADESH,Total,All ages,Non-Technical Diploma,4077,4442,8519
25231,2,State - HIMACHAL PRADESH,Total,0-6,Non-Technical Diploma,0,0,0
25232,2,State - HIMACHAL PRADESH,Total,7,Non-Technical Diploma,0,0,0
25233,2,State - HIMACHAL PRADESH,Total,8,Non-Technical Diploma,0,0,0
25234,2,State - HIMACHAL PRADESH,Total,9,Non-Technical Diploma,0,0,0
25235,2,State - HIMACHAL PRADESH,Total,10,Non-Technical Diploma,0,0,0
25236,2,State - HIMACHAL PRADESH,Total,11,Non-Technical Diploma,0,0,0
25237,2,State - HIMACHAL PRADESH,Total,12,Non-Technical Diploma,0,0,0
25238,2,State - HIMACHAL PRADESH,Total,13,Non-Technical Diploma,0,0,0
25239,2,State - HIMACHAL PRADESH,Total,14,Non-Technical Diploma,0,0,0
25240,2,State - HIMACHAL PRADESH,Total,15,Non-Technical Diploma,0,0,0
25241,2,State - HIMACHAL PRADESH,Total,16,Non-Technical Diploma,0,0,0
25242,2,State - HIMACHAL PRADESH,Total,17,Non-Technical Diploma,0,0,0
25243,2,State - HIMACHAL PRADESH,Total,18,Non-Technical Diploma,48,28,76
25244,2,State - HIMACHAL PRADESH,Total,19,Non-Technical Diploma,51,52,103
25245,2,State - HIMACHAL PRADESH,Total,20-24,Non-Technical Diploma,534,438,972
25246,2,State - HIMACHAL PRADESH,Total,25-29,Non-Technical Diploma,569,371,940
25247,2,State - HIMACHAL PRADESH,Total,30-34,Non-Technical Diploma,445,423,868
25248,2,State - HIMACHAL PRADESH,Total,35-39,Non-Technical Diploma,328,499,827
25249,2,State - HIMACHAL PRADESH,Total,40-44,Non-Technical Diploma,370,650,1020
25250,2,State - HIMACHAL PRADESH,Total,45-49,Non-Technical Diploma,391,512,903
25251,2,State - HIMACHAL PRADESH,Total,50-54,Non-Technical Diploma,386,486,872
25252,2,State - HIMACHAL PRADESH,Total,55-59,Non-Technical Diploma,414,445,859
25253,2,State - HIMACHAL PRADESH,Total,60-64,Non-Technical Diploma,221,185,406
25254,2,State - HIMACHAL PRADESH,Total,65-69,Non-Technical Diploma,116,116,232
25255,2,State - HIMACHAL PRADESH,Total,70-74,Non-Technical Diploma,83,114,197
25256,2,State - HIMACHAL PRADESH,Total,75-79,Non-Technical Diploma,65,64,129
25257,2,State - HIMACHAL PRADESH,Total,80+,Non-Technical Diploma,54,55,109
25258,2,State - HIMACHAL PRADESH,Total,Age not stated,Non-Technical Diploma,2,4,6
25259,2,State - HIMACHAL PRADESH,Rural,All ages,Non-Technical Diploma,3407,3135,6542
25260,2,State - HIMACHAL PRADESH,Rural,0-6,Non-Technical Diploma,0,0,0
25261,2,State - HIMACHAL PRADESH,Rural,7,Non-Technical Diploma,0,0,0
25262,2,State - HIMACHAL PRADESH,Rural,8,Non-Technical Diploma,0,0,0
25263,2,State - HIMACHAL PRADESH,Rural,9,Non-Technical Diploma,0,0,0
25264,2,State - HIMACHAL PRADESH,Rural,10,Non-Technical Diploma,0,0,0
25265,2,State - HIMACHAL PRADESH,Rural,11,Non-Technical Diploma,0,0,0
25266,2,State - HIMACHAL PRADESH,Rural,12,Non-Technical Diploma,0,0,0
25267,2,State - HIMACHAL PRADESH,Rural,13,Non-Technical Diploma,0,0,0
25268,2,State - HIMACHAL PRADESH,Rural,14,Non-Technical Diploma,0,0,0
25269,2,State - HIMACHAL PRADESH,Rural,15,Non-Technical Diploma,0,0,0
25270,2,State - HIMACHAL PRADESH,Rural,16,Non-Technical Diploma,0,0,0
25271,2,State - HIMACHAL PRADESH,Rural,17,Non-Technical Diploma,0,0,0
25272,2,State - HIMACHAL PRADESH,Rural,18,Non-Technical Diploma,41,21,62
25273,2,State - HIMACHAL PRADESH,Rural,19,Non-Technical Diploma,43,40,83
25274,2,State - HIMACHAL PRADESH,Rural,20-24,Non-Technical Diploma,457,378,835
25275,2,State - HIMACHAL PRADESH,Rural,25-29,Non-Technical Diploma,500,314,814
25276,2,State - HIMACHAL PRADESH,Rural,30-34,Non-Technical Diploma,376,355,731
25277,2,State - HIMACHAL PRADESH,Rural,35-39,Non-Technical Diploma,283,373,656
25278,2,State - HIMACHAL PRADESH,Rural,40-44,Non-Technical Diploma,311,454,765
25279,2,State - HIMACHAL PRADESH,Rural,45-49,Non-Technical Diploma,317,343,660
25280,2,State - HIMACHAL PRADESH,Rural,50-54,Non-Technical Diploma,302,334,636
25281,2,State - HIMACHAL PRADESH,Rural,55-59,Non-Technical Diploma,358,297,655
25282,2,State - HIMACHAL PRADESH,Rural,60-64,Non-Technical Diploma,182,99,281
25283,2,State - HIMACHAL PRADESH,Rural,65-69,Non-Technical Diploma,87,50,137
25284,2,State - HIMACHAL PRADESH,Rural,70-74,Non-Technical Diploma,61,39,100
25285,2,State - HIMACHAL PRADESH,Rural,75-79,Non-Technical Diploma,48,13,61
25286,2,State - HIMACHAL PRADESH,Rural,80+,Non-Technical Diploma,39,24,63
25287,2,State - HIMACHAL PRADESH,Rural,Age not stated,Non-Technical Diploma,2,1,3
25288,2,State - HIMACHAL PRADESH,Urban,All ages,Non-Technical Diploma,670,1307,1977
25289,2,State - HIMACHAL PRADESH,Urban,0-6,Non-Technical Diploma,0,0,0
25290,2,State - HIMACHAL PRADESH,Urban,7,Non-Technical Diploma,0,0,0
25291,2,State - HIMACHAL PRADESH,Urban,8,Non-Technical Diploma,0,0,0
25292,2,State - HIMACHAL PRADESH,Urban,9,Non-Technical Diploma,0,0,0
25293,2,State - HIMACHAL PRADESH,Urban,10,Non-Technical Diploma,0,0,0
25294,2,State - HIMACHAL PRADESH,Urban,11,Non-Technical Diploma,0,0,0
25295,2,State - HIMACHAL PRADESH,Urban,12,Non-Technical Diploma,0,0,0
25296,2,State - HIMACHAL PRADESH,Urban,13,Non-Technical Diploma,0,0,0
25297,2,State - HIMACHAL PRADESH,Urban,14,Non-Technical Diploma,0,0,0
25298,2,State - HIMACHAL PRADESH,Urban,15,Non-Technical Diploma,0,0,0
25299,2,State - HIMACHAL PRADESH,Urban,16,Non-Technical Diploma,0,0,0
25300,2,State - HIMACHAL PRADESH,Urban,17,Non-Technical Diploma,0,0,0
25301,2,State - HIMACHAL PRADESH,Urban,18,Non-Technical Diploma,7,7,14
25302,2,State - HIMACHAL PRADESH,Urban,19,Non-Technical Diploma,8,12,20
25303,2,State - HIMACHAL PRADESH,Urban,20-24,Non-Technical Diploma,77,60,137
25304,2,State - HIMACHAL PRADESH,Urban,25-29,Non-Technical Diploma,69,57,126
25305,2,State - HIMACHAL PRADESH,Urban,30-34,Non-Technical Diploma,69,68,137
25306,2,State - HIMACHAL PRADESH,Urban,35-39,Non-Technical Diploma,45,126,171
25307,2,State - HIMACHAL PRADESH,Urban,40-44,Non-Technical Diploma,59,196,255
25308,2,State - HIMACHAL PRADESH,Urban,45-49,Non-Technical Diploma,74,169,243
25309,2,State - HIMACHAL PRADESH,Urban,50-54,Non-Technical Diploma,84,152,236
25310,2,State - HIMACHAL PRADESH,Urban,55-59,Non-Technical Diploma,56,148,204
25311,2,State - HIMACHAL PRADESH,Urban,60-64,Non-Technical Diploma,39,86,125
25312,2,State - HIMACHAL PRADESH,Urban,65-69,Non-Technical Diploma,29,66,95
25313,2,State - HIMACHAL PRADESH,Urban,70-74,Non-Technical Diploma,22,75,97
25314,2,State - HIMACHAL PRADESH,Urban,75-79,Non-Technical Diploma,17,51,68
25315,2,State - HIMACHAL PRADESH,Urban,80+,Non-Technical Diploma,15,31,46
25316,2,State - HIMACHAL PRADESH,Urban,Age not stated,Non-Technical Diploma,0,3,3
25317,3,State - PUNJAB,Total,All ages,Non-Technical Diploma,11117,13170,24287
25318,3,State - PUNJAB,Total,0-6,Non-Technical Diploma,0,0,0
25319,3,State - PUNJAB,Total,7,Non-Technical Diploma,0,0,0
25320,3,State - PUNJAB,Total,8,Non-Technical Diploma,0,0,0
25321,3,State - PUNJAB,Total,9,Non-Technical Diploma,0,0,0
25322,3,State - PUNJAB,Total,10,Non-Technical Diploma,0,0,0
25323,3,State - PUNJAB,Total,11,Non-Technical Diploma,0,0,0
25324,3,State - PUNJAB,Total,12,Non-Technical Diploma,0,0,0
25325,3,State - PUNJAB,Total,13,Non-Technical Diploma,0,0,0
25326,3,State - PUNJAB,Total,14,Non-Technical Diploma,0,0,0
25327,3,State - PUNJAB,Total,15,Non-Technical Diploma,0,0,0
25328,3,State - PUNJAB,Total,16,Non-Technical Diploma,0,0,0
25329,3,State - PUNJAB,Total,17,Non-Technical Diploma,0,0,0
25330,3,State - PUNJAB,Total,18,Non-Technical Diploma,604,265,869
25331,3,State - PUNJAB,Total,19,Non-Technical Diploma,655,295,950
25332,3,State - PUNJAB,Total,20-24,Non-Technical Diploma,2413,1273,3686
25333,3,State - PUNJAB,Total,25-29,Non-Technical Diploma,932,678,1610
25334,3,State - PUNJAB,Total,30-34,Non-Technical Diploma,605,567,1172
25335,3,State - PUNJAB,Total,35-39,Non-Technical Diploma,659,984,1643
25336,3,State - PUNJAB,Total,40-44,Non-Technical Diploma,731,1463,2194
25337,3,State - PUNJAB,Total,45-49,Non-Technical Diploma,761,1529,2290
25338,3,State - PUNJAB,Total,50-54,Non-Technical Diploma,779,1764,2543
25339,3,State - PUNJAB,Total,55-59,Non-Technical Diploma,736,1266,2002
25340,3,State - PUNJAB,Total,60-64,Non-Technical Diploma,714,979,1693
25341,3,State - PUNJAB,Total,65-69,Non-Technical Diploma,531,667,1198
25342,3,State - PUNJAB,Total,70-74,Non-Technical Diploma,431,725,1156
25343,3,State - PUNJAB,Total,75-79,Non-Technical Diploma,268,395,663
25344,3,State - PUNJAB,Total,80+,Non-Technical Diploma,277,311,588
25345,3,State - PUNJAB,Total,Age not stated,Non-Technical Diploma,21,9,30
25346,3,State - PUNJAB,Rural,All ages,Non-Technical Diploma,4430,4180,8610
25347,3,State - PUNJAB,Rural,0-6,Non-Technical Diploma,0,0,0
25348,3,State - PUNJAB,Rural,7,Non-Technical Diploma,0,0,0
25349,3,State - PUNJAB,Rural,8,Non-Technical Diploma,0,0,0
25350,3,State - PUNJAB,Rural,9,Non-Technical Diploma,0,0,0
25351,3,State - PUNJAB,Rural,10,Non-Technical Diploma,0,0,0
25352,3,State - PUNJAB,Rural,11,Non-Technical Diploma,0,0,0
25353,3,State - PUNJAB,Rural,12,Non-Technical Diploma,0,0,0
25354,3,State - PUNJAB,Rural,13,Non-Technical Diploma,0,0,0
25355,3,State - PUNJAB,Rural,14,Non-Technical Diploma,0,0,0
25356,3,State - PUNJAB,Rural,15,Non-Technical Diploma,0,0,0
25357,3,State - PUNJAB,Rural,16,Non-Technical Diploma,0,0,0
25358,3,State - PUNJAB,Rural,17,Non-Technical Diploma,0,0,0
25359,3,State - PUNJAB,Rural,18,Non-Technical Diploma,287,138,425
25360,3,State - PUNJAB,Rural,19,Non-Technical Diploma,337,162,499
25361,3,State - PUNJAB,Rural,20-24,Non-Technical Diploma,1180,650,1830
25362,3,State - PUNJAB,Rural,25-29,Non-Technical Diploma,359,294,653
25363,3,State - PUNJAB,Rural,30-34,Non-Technical Diploma,219,236,455
25364,3,State - PUNJAB,Rural,35-39,Non-Technical Diploma,245,382,627
25365,3,State - PUNJAB,Rural,40-44,Non-Technical Diploma,257,578,835
25366,3,State - PUNJAB,Rural,45-49,Non-Technical Diploma,261,508,769
25367,3,State - PUNJAB,Rural,50-54,Non-Technical Diploma,275,496,771
25368,3,State - PUNJAB,Rural,55-59,Non-Technical Diploma,244,304,548
25369,3,State - PUNJAB,Rural,60-64,Non-Technical Diploma,266,192,458
25370,3,State - PUNJAB,Rural,65-69,Non-Technical Diploma,173,82,255
25371,3,State - PUNJAB,Rural,70-74,Non-Technical Diploma,128,67,195
25372,3,State - PUNJAB,Rural,75-79,Non-Technical Diploma,92,44,136
25373,3,State - PUNJAB,Rural,80+,Non-Technical Diploma,92,44,136
25374,3,State - PUNJAB,Rural,Age not stated,Non-Technical Diploma,15,3,18
25375,3,State - PUNJAB,Urban,All ages,Non-Technical Diploma,6687,8990,15677
25376,3,State - PUNJAB,Urban,0-6,Non-Technical Diploma,0,0,0
25377,3,State - PUNJAB,Urban,7,Non-Technical Diploma,0,0,0
25378,3,State - PUNJAB,Urban,8,Non-Technical Diploma,0,0,0
25379,3,State - PUNJAB,Urban,9,Non-Technical Diploma,0,0,0
25380,3,State - PUNJAB,Urban,10,Non-Technical Diploma,0,0,0
25381,3,State - PUNJAB,Urban,11,Non-Technical Diploma,0,0,0
25382,3,State - PUNJAB,Urban,12,Non-Technical Diploma,0,0,0
25383,3,State - PUNJAB,Urban,13,Non-Technical Diploma,0,0,0
25384,3,State - PUNJAB,Urban,14,Non-Technical Diploma,0,0,0
25385,3,State - PUNJAB,Urban,15,Non-Technical Diploma,0,0,0
25386,3,State - PUNJAB,Urban,16,Non-Technical Diploma,0,0,0
25387,3,State - PUNJAB,Urban,17,Non-Technical Diploma,0,0,0
25388,3,State - PUNJAB,Urban,18,Non-Technical Diploma,317,127,444
25389,3,State - PUNJAB,Urban,19,Non-Technical Diploma,318,133,451
25390,3,State - PUNJAB,Urban,20-24,Non-Technical Diploma,1233,623,1856
25391,3,State - PUNJAB,Urban,25-29,Non-Technical Diploma,573,384,957
25392,3,State - PUNJAB,Urban,30-34,Non-Technical Diploma,386,331,717
25393,3,State - PUNJAB,Urban,35-39,Non-Technical Diploma,414,602,1016
25394,3,State - PUNJAB,Urban,40-44,Non-Technical Diploma,474,885,1359
25395,3,State - PUNJAB,Urban,45-49,Non-Technical Diploma,500,1021,1521
25396,3,State - PUNJAB,Urban,50-54,Non-Technical Diploma,504,1268,1772
25397,3,State - PUNJAB,Urban,55-59,Non-Technical Diploma,492,962,1454
25398,3,State - PUNJAB,Urban,60-64,Non-Technical Diploma,448,787,1235
25399,3,State - PUNJAB,Urban,65-69,Non-Technical Diploma,358,585,943
25400,3,State - PUNJAB,Urban,70-74,Non-Technical Diploma,303,658,961
25401,3,State - PUNJAB,Urban,75-79,Non-Technical Diploma,176,351,527
25402,3,State - PUNJAB,Urban,80+,Non-Technical Diploma,185,267,452
25403,3,State - PUNJAB,Urban,Age not stated,Non-Technical Diploma,6,6,12
25404,4,State - CHANDIGARH,Total,All ages,Non-Technical Diploma,510,996,1506
25405,4,State - CHANDIGARH,Total,0-6,Non-Technical Diploma,0,0,0
25406,4,State - CHANDIGARH,Total,7,Non-Technical Diploma,0,0,0
25407,4,State - CHANDIGARH,Total,8,Non-Technical Diploma,0,0,0
25408,4,State - CHANDIGARH,Total,9,Non-Technical Diploma,0,0,0
25409,4,State - CHANDIGARH,Total,10,Non-Technical Diploma,0,0,0
25410,4,State - CHANDIGARH,Total,11,Non-Technical Diploma,0,0,0
25411,4,State - CHANDIGARH,Total,12,Non-Technical Diploma,0,0,0
25412,4,State - CHANDIGARH,Total,13,Non-Technical Diploma,0,0,0
25413,4,State - CHANDIGARH,Total,14,Non-Technical Diploma,0,0,0
25414,4,State - CHANDIGARH,Total,15,Non-Technical Diploma,0,0,0
25415,4,State - CHANDIGARH,Total,16,Non-Technical Diploma,0,0,0
25416,4,State - CHANDIGARH,Total,17,Non-Technical Diploma,0,0,0
25417,4,State - CHANDIGARH,Total,18,Non-Technical Diploma,16,24,40
25418,4,State - CHANDIGARH,Total,19,Non-Technical Diploma,18,15,33
25419,4,State - CHANDIGARH,Total,20-24,Non-Technical Diploma,115,80,195
25420,4,State - CHANDIGARH,Total,25-29,Non-Technical Diploma,56,45,101
25421,4,State - CHANDIGARH,Total,30-34,Non-Technical Diploma,45,49,94
25422,4,State - CHANDIGARH,Total,35-39,Non-Technical Diploma,32,61,93
25423,4,State - CHANDIGARH,Total,40-44,Non-Technical Diploma,36,102,138
25424,4,State - CHANDIGARH,Total,45-49,Non-Technical Diploma,40,104,144
25425,4,State - CHANDIGARH,Total,50-54,Non-Technical Diploma,37,94,131
25426,4,State - CHANDIGARH,Total,55-59,Non-Technical Diploma,35,77,112
25427,4,State - CHANDIGARH,Total,60-64,Non-Technical Diploma,26,42,68
25428,4,State - CHANDIGARH,Total,65-69,Non-Technical Diploma,16,58,74
25429,4,State - CHANDIGARH,Total,70-74,Non-Technical Diploma,15,100,115
25430,4,State - CHANDIGARH,Total,75-79,Non-Technical Diploma,12,76,88
25431,4,State - CHANDIGARH,Total,80+,Non-Technical Diploma,11,69,80
25432,4,State - CHANDIGARH,Total,Age not stated,Non-Technical Diploma,0,0,0
25433,4,State - CHANDIGARH,Rural,All ages,Non-Technical Diploma,4,8,12
25434,4,State - CHANDIGARH,Rural,0-6,Non-Technical Diploma,0,0,0
25435,4,State - CHANDIGARH,Rural,7,Non-Technical Diploma,0,0,0
25436,4,State - CHANDIGARH,Rural,8,Non-Technical Diploma,0,0,0
25437,4,State - CHANDIGARH,Rural,9,Non-Technical Diploma,0,0,0
25438,4,State - CHANDIGARH,Rural,10,Non-Technical Diploma,0,0,0
25439,4,State - CHANDIGARH,Rural,11,Non-Technical Diploma,0,0,0
25440,4,State - CHANDIGARH,Rural,12,Non-Technical Diploma,0,0,0
25441,4,State - CHANDIGARH,Rural,13,Non-Technical Diploma,0,0,0
25442,4,State - CHANDIGARH,Rural,14,Non-Technical Diploma,0,0,0
25443,4,State - CHANDIGARH,Rural,15,Non-Technical Diploma,0,0,0
25444,4,State - CHANDIGARH,Rural,16,Non-Technical Diploma,0,0,0
25445,4,State - CHANDIGARH,Rural,17,Non-Technical Diploma,0,0,0
25446,4,State - CHANDIGARH,Rural,18,Non-Technical Diploma,0,0,0
25447,4,State - CHANDIGARH,Rural,19,Non-Technical Diploma,0,0,0
25448,4,State - CHANDIGARH,Rural,20-24,Non-Technical Diploma,0,2,2
25449,4,State - CHANDIGARH,Rural,25-29,Non-Technical Diploma,1,1,2
25450,4,State - CHANDIGARH,Rural,30-34,Non-Technical Diploma,1,0,1
25451,4,State - CHANDIGARH,Rural,35-39,Non-Technical Diploma,2,0,2
25452,4,State - CHANDIGARH,Rural,40-44,Non-Technical Diploma,0,3,3
25453,4,State - CHANDIGARH,Rural,45-49,Non-Technical Diploma,0,0,0
25454,4,State - CHANDIGARH,Rural,50-54,Non-Technical Diploma,0,1,1
25455,4,State - CHANDIGARH,Rural,55-59,Non-Technical Diploma,0,1,1
25456,4,State - CHANDIGARH,Rural,60-64,Non-Technical Diploma,0,0,0
25457,4,State - CHANDIGARH,Rural,65-69,Non-Technical Diploma,0,0,0
25458,4,State - CHANDIGARH,Rural,70-74,Non-Technical Diploma,0,0,0
25459,4,State - CHANDIGARH,Rural,75-79,Non-Technical Diploma,0,0,0
25460,4,State - CHANDIGARH,Rural,80+,Non-Technical Diploma,0,0,0
25461,4,State - CHANDIGARH,Rural,Age not stated,Non-Technical Diploma,0,0,0
25462,4,State - CHANDIGARH,Urban,All ages,Non-Technical Diploma,506,988,1494
25463,4,State - CHANDIGARH,Urban,0-6,Non-Technical Diploma,0,0,0
25464,4,State - CHANDIGARH,Urban,7,Non-Technical Diploma,0,0,0
25465,4,State - CHANDIGARH,Urban,8,Non-Technical Diploma,0,0,0
25466,4,State - CHANDIGARH,Urban,9,Non-Technical Diploma,0,0,0
25467,4,State - CHANDIGARH,Urban,10,Non-Technical Diploma,0,0,0
25468,4,State - CHANDIGARH,Urban,11,Non-Technical Diploma,0,0,0
25469,4,State - CHANDIGARH,Urban,12,Non-Technical Diploma,0,0,0
25470,4,State - CHANDIGARH,Urban,13,Non-Technical Diploma,0,0,0
25471,4,State - CHANDIGARH,Urban,14,Non-Technical Diploma,0,0,0
25472,4,State - CHANDIGARH,Urban,15,Non-Technical Diploma,0,0,0
25473,4,State - CHANDIGARH,Urban,16,Non-Technical Diploma,0,0,0
25474,4,State - CHANDIGARH,Urban,17,Non-Technical Diploma,0,0,0
25475,4,State - CHANDIGARH,Urban,18,Non-Technical Diploma,16,24,40
25476,4,State - CHANDIGARH,Urban,19,Non-Technical Diploma,18,15,33
25477,4,State - CHANDIGARH,Urban,20-24,Non-Technical Diploma,115,78,193
25478,4,State - CHANDIGARH,Urban,25-29,Non-Technical Diploma,55,44,99
25479,4,State - CHANDIGARH,Urban,30-34,Non-Technical Diploma,44,49,93
25480,4,State - CHANDIGARH,Urban,35-39,Non-Technical Diploma,30,61,91
25481,4,State - CHANDIGARH,Urban,40-44,Non-Technical Diploma,36,99,135
25482,4,State - CHANDIGARH,Urban,45-49,Non-Technical Diploma,40,104,144
25483,4,State - CHANDIGARH,Urban,50-54,Non-Technical Diploma,37,93,130
25484,4,State - CHANDIGARH,Urban,55-59,Non-Technical Diploma,35,76,111
25485,4,State - CHANDIGARH,Urban,60-64,Non-Technical Diploma,26,42,68
25486,4,State - CHANDIGARH,Urban,65-69,Non-Technical Diploma,16,58,74
25487,4,State - CHANDIGARH,Urban,70-74,Non-Technical Diploma,15,100,115
25488,4,State - CHANDIGARH,Urban,75-79,Non-Technical Diploma,12,76,88
25489,4,State - CHANDIGARH,Urban,80+,Non-Technical Diploma,11,69,80
25490,4,State - CHANDIGARH,Urban,Age not stated,Non-Technical Diploma,0,0,0
25491,5,State - UTTARAKHAND,Total,All ages,Non-Technical Diploma,3102,1714,4816
25492,5,State - UTTARAKHAND,Total,0-6,Non-Technical Diploma,0,0,0
25493,5,State - UTTARAKHAND,Total,7,Non-Technical Diploma,0,0,0
25494,5,State - UTTARAKHAND,Total,8,Non-Technical Diploma,0,0,0
25495,5,State - UTTARAKHAND,Total,9,Non-Technical Diploma,0,0,0
25496,5,State - UTTARAKHAND,Total,10,Non-Technical Diploma,0,0,0
25497,5,State - UTTARAKHAND,Total,11,Non-Technical Diploma,0,0,0
25498,5,State - UTTARAKHAND,Total,12,Non-Technical Diploma,0,0,0
25499,5,State - UTTARAKHAND,Total,13,Non-Technical Diploma,0,0,0
25500,5,State - UTTARAKHAND,Total,14,Non-Technical Diploma,0,0,0
25501,5,State - UTTARAKHAND,Total,15,Non-Technical Diploma,0,0,0
25502,5,State - UTTARAKHAND,Total,16,Non-Technical Diploma,0,0,0
25503,5,State - UTTARAKHAND,Total,17,Non-Technical Diploma,0,0,0
25504,5,State - UTTARAKHAND,Total,18,Non-Technical Diploma,140,105,245
25505,5,State - UTTARAKHAND,Total,19,Non-Technical Diploma,107,79,186
25506,5,State - UTTARAKHAND,Total,20-24,Non-Technical Diploma,634,434,1068
25507,5,State - UTTARAKHAND,Total,25-29,Non-Technical Diploma,367,261,628
25508,5,State - UTTARAKHAND,Total,30-34,Non-Technical Diploma,236,187,423
25509,5,State - UTTARAKHAND,Total,35-39,Non-Technical Diploma,247,153,400
25510,5,State - UTTARAKHAND,Total,40-44,Non-Technical Diploma,296,133,429
25511,5,State - UTTARAKHAND,Total,45-49,Non-Technical Diploma,257,93,350
25512,5,State - UTTARAKHAND,Total,50-54,Non-Technical Diploma,219,65,284
25513,5,State - UTTARAKHAND,Total,55-59,Non-Technical Diploma,147,56,203
25514,5,State - UTTARAKHAND,Total,60-64,Non-Technical Diploma,150,49,199
25515,5,State - UTTARAKHAND,Total,65-69,Non-Technical Diploma,128,33,161
25516,5,State - UTTARAKHAND,Total,70-74,Non-Technical Diploma,94,34,128
25517,5,State - UTTARAKHAND,Total,75-79,Non-Technical Diploma,44,18,62
25518,5,State - UTTARAKHAND,Total,80+,Non-Technical Diploma,34,12,46
25519,5,State - UTTARAKHAND,Total,Age not stated,Non-Technical Diploma,2,2,4
25520,5,State - UTTARAKHAND,Rural,All ages,Non-Technical Diploma,1216,864,2080
25521,5,State - UTTARAKHAND,Rural,0-6,Non-Technical Diploma,0,0,0
25522,5,State - UTTARAKHAND,Rural,7,Non-Technical Diploma,0,0,0
25523,5,State - UTTARAKHAND,Rural,8,Non-Technical Diploma,0,0,0
25524,5,State - UTTARAKHAND,Rural,9,Non-Technical Diploma,0,0,0
25525,5,State - UTTARAKHAND,Rural,10,Non-Technical Diploma,0,0,0
25526,5,State - UTTARAKHAND,Rural,11,Non-Technical Diploma,0,0,0
25527,5,State - UTTARAKHAND,Rural,12,Non-Technical Diploma,0,0,0
25528,5,State - UTTARAKHAND,Rural,13,Non-Technical Diploma,0,0,0
25529,5,State - UTTARAKHAND,Rural,14,Non-Technical Diploma,0,0,0
25530,5,State - UTTARAKHAND,Rural,15,Non-Technical Diploma,0,0,0
25531,5,State - UTTARAKHAND,Rural,16,Non-Technical Diploma,0,0,0
25532,5,State - UTTARAKHAND,Rural,17,Non-Technical Diploma,0,0,0
25533,5,State - UTTARAKHAND,Rural,18,Non-Technical Diploma,63,56,119
25534,5,State - UTTARAKHAND,Rural,19,Non-Technical Diploma,40,42,82
25535,5,State - UTTARAKHAND,Rural,20-24,Non-Technical Diploma,291,217,508
25536,5,State - UTTARAKHAND,Rural,25-29,Non-Technical Diploma,161,135,296
25537,5,State - UTTARAKHAND,Rural,30-34,Non-Technical Diploma,103,113,216
25538,5,State - UTTARAKHAND,Rural,35-39,Non-Technical Diploma,91,79,170
25539,5,State - UTTARAKHAND,Rural,40-44,Non-Technical Diploma,118,69,187
25540,5,State - UTTARAKHAND,Rural,45-49,Non-Technical Diploma,93,47,140
25541,5,State - UTTARAKHAND,Rural,50-54,Non-Technical Diploma,87,27,114
25542,5,State - UTTARAKHAND,Rural,55-59,Non-Technical Diploma,48,30,78
25543,5,State - UTTARAKHAND,Rural,60-64,Non-Technical Diploma,41,18,59
25544,5,State - UTTARAKHAND,Rural,65-69,Non-Technical Diploma,27,12,39
25545,5,State - UTTARAKHAND,Rural,70-74,Non-Technical Diploma,27,14,41
25546,5,State - UTTARAKHAND,Rural,75-79,Non-Technical Diploma,11,3,14
25547,5,State - UTTARAKHAND,Rural,80+,Non-Technical Diploma,14,1,15
25548,5,State - UTTARAKHAND,Rural,Age not stated,Non-Technical Diploma,1,1,2
25549,5,State - UTTARAKHAND,Urban,All ages,Non-Technical Diploma,1886,850,2736
25550,5,State - UTTARAKHAND,Urban,0-6,Non-Technical Diploma,0,0,0
25551,5,State - UTTARAKHAND,Urban,7,Non-Technical Diploma,0,0,0
25552,5,State - UTTARAKHAND,Urban,8,Non-Technical Diploma,0,0,0
25553,5,State - UTTARAKHAND,Urban,9,Non-Technical Diploma,0,0,0
25554,5,State - UTTARAKHAND,Urban,10,Non-Technical Diploma,0,0,0
25555,5,State - UTTARAKHAND,Urban,11,Non-Technical Diploma,0,0,0
25556,5,State - UTTARAKHAND,Urban,12,Non-Technical Diploma,0,0,0
25557,5,State - UTTARAKHAND,Urban,13,Non-Technical Diploma,0,0,0
25558,5,State - UTTARAKHAND,Urban,14,Non-Technical Diploma,0,0,0
25559,5,State - UTTARAKHAND,Urban,15,Non-Technical Diploma,0,0,0
25560,5,State - UTTARAKHAND,Urban,16,Non-Technical Diploma,0,0,0
25561,5,State - UTTARAKHAND,Urban,17,Non-Technical Diploma,0,0,0
25562,5,State - UTTARAKHAND,Urban,18,Non-Technical Diploma,77,49,126
25563,5,State - UTTARAKHAND,Urban,19,Non-Technical Diploma,67,37,104
25564,5,State - UTTARAKHAND,Urban,20-24,Non-Technical Diploma,343,217,560
25565,5,State - UTTARAKHAND,Urban,25-29,Non-Technical Diploma,206,126,332
25566,5,State - UTTARAKHAND,Urban,30-34,Non-Technical Diploma,133,74,207
25567,5,State - UTTARAKHAND,Urban,35-39,Non-Technical Diploma,156,74,230
25568,5,State - UTTARAKHAND,Urban,40-44,Non-Technical Diploma,178,64,242
25569,5,State - UTTARAKHAND,Urban,45-49,Non-Technical Diploma,164,46,210
25570,5,State - UTTARAKHAND,Urban,50-54,Non-Technical Diploma,132,38,170
25571,5,State - UTTARAKHAND,Urban,55-59,Non-Technical Diploma,99,26,125
25572,5,State - UTTARAKHAND,Urban,60-64,Non-Technical Diploma,109,31,140
25573,5,State - UTTARAKHAND,Urban,65-69,Non-Technical Diploma,101,21,122
25574,5,State - UTTARAKHAND,Urban,70-74,Non-Technical Diploma,67,20,87
25575,5,State - UTTARAKHAND,Urban,75-79,Non-Technical Diploma,33,15,48
25576,5,State - UTTARAKHAND,Urban,80+,Non-Technical Diploma,20,11,31
25577,5,State - UTTARAKHAND,Urban,Age not stated,Non-Technical Diploma,1,1,2
25578,6,State - HARYANA,Total,All ages,Non-Technical Diploma,17774,12840,30614
25579,6,State - HARYANA,Total,0-6,Non-Technical Diploma,0,0,0
25580,6,State - HARYANA,Total,7,Non-Technical Diploma,0,0,0
25581,6,State - HARYANA,Total,8,Non-Technical Diploma,0,0,0
25582,6,State - HARYANA,Total,9,Non-Technical Diploma,0,0,0
25583,6,State - HARYANA,Total,10,Non-Technical Diploma,0,0,0
25584,6,State - HARYANA,Total,11,Non-Technical Diploma,0,0,0
25585,6,State - HARYANA,Total,12,Non-Technical Diploma,0,0,0
25586,6,State - HARYANA,Total,13,Non-Technical Diploma,0,0,0
25587,6,State - HARYANA,Total,14,Non-Technical Diploma,0,0,0
25588,6,State - HARYANA,Total,15,Non-Technical Diploma,0,0,0
25589,6,State - HARYANA,Total,16,Non-Technical Diploma,0,0,0
25590,6,State - HARYANA,Total,17,Non-Technical Diploma,0,0,0
25591,6,State - HARYANA,Total,18,Non-Technical Diploma,1115,455,1570
25592,6,State - HARYANA,Total,19,Non-Technical Diploma,987,404,1391
25593,6,State - HARYANA,Total,20-24,Non-Technical Diploma,3903,1643,5546
25594,6,State - HARYANA,Total,25-29,Non-Technical Diploma,2123,1235,3358
25595,6,State - HARYANA,Total,30-34,Non-Technical Diploma,1692,1401,3093
25596,6,State - HARYANA,Total,35-39,Non-Technical Diploma,1559,1358,2917
25597,6,State - HARYANA,Total,40-44,Non-Technical Diploma,1322,1549,2871
25598,6,State - HARYANA,Total,45-49,Non-Technical Diploma,1205,1158,2363
25599,6,State - HARYANA,Total,50-54,Non-Technical Diploma,995,967,1962
25600,6,State - HARYANA,Total,55-59,Non-Technical Diploma,906,960,1866
25601,6,State - HARYANA,Total,60-64,Non-Technical Diploma,718,380,1098
25602,6,State - HARYANA,Total,65-69,Non-Technical Diploma,498,390,888
25603,6,State - HARYANA,Total,70-74,Non-Technical Diploma,327,453,780
25604,6,State - HARYANA,Total,75-79,Non-Technical Diploma,208,285,493
25605,6,State - HARYANA,Total,80+,Non-Technical Diploma,180,182,362
25606,6,State - HARYANA,Total,Age not stated,Non-Technical Diploma,36,20,56
25607,6,State - HARYANA,Rural,All ages,Non-Technical Diploma,8221,4763,12984
25608,6,State - HARYANA,Rural,0-6,Non-Technical Diploma,0,0,0
25609,6,State - HARYANA,Rural,7,Non-Technical Diploma,0,0,0
25610,6,State - HARYANA,Rural,8,Non-Technical Diploma,0,0,0
25611,6,State - HARYANA,Rural,9,Non-Technical Diploma,0,0,0
25612,6,State - HARYANA,Rural,10,Non-Technical Diploma,0,0,0
25613,6,State - HARYANA,Rural,11,Non-Technical Diploma,0,0,0
25614,6,State - HARYANA,Rural,12,Non-Technical Diploma,0,0,0
25615,6,State - HARYANA,Rural,13,Non-Technical Diploma,0,0,0
25616,6,State - HARYANA,Rural,14,Non-Technical Diploma,0,0,0
25617,6,State - HARYANA,Rural,15,Non-Technical Diploma,0,0,0
25618,6,State - HARYANA,Rural,16,Non-Technical Diploma,0,0,0
25619,6,State - HARYANA,Rural,17,Non-Technical Diploma,0,0,0
25620,6,State - HARYANA,Rural,18,Non-Technical Diploma,562,205,767
25621,6,State - HARYANA,Rural,19,Non-Technical Diploma,498,188,686
25622,6,State - HARYANA,Rural,20-24,Non-Technical Diploma,1995,739,2734
25623,6,State - HARYANA,Rural,25-29,Non-Technical Diploma,1056,648,1704
25624,6,State - HARYANA,Rural,30-34,Non-Technical Diploma,818,747,1565
25625,6,State - HARYANA,Rural,35-39,Non-Technical Diploma,762,627,1389
25626,6,State - HARYANA,Rural,40-44,Non-Technical Diploma,591,588,1179
25627,6,State - HARYANA,Rural,45-49,Non-Technical Diploma,480,338,818
25628,6,State - HARYANA,Rural,50-54,Non-Technical Diploma,364,239,603
25629,6,State - HARYANA,Rural,55-59,Non-Technical Diploma,355,276,631
25630,6,State - HARYANA,Rural,60-64,Non-Technical Diploma,293,65,358
25631,6,State - HARYANA,Rural,65-69,Non-Technical Diploma,172,33,205
25632,6,State - HARYANA,Rural,70-74,Non-Technical Diploma,114,26,140
25633,6,State - HARYANA,Rural,75-79,Non-Technical Diploma,70,17,87
25634,6,State - HARYANA,Rural,80+,Non-Technical Diploma,78,23,101
25635,6,State - HARYANA,Rural,Age not stated,Non-Technical Diploma,13,4,17
25636,6,State - HARYANA,Urban,All ages,Non-Technical Diploma,9553,8077,17630
25637,6,State - HARYANA,Urban,0-6,Non-Technical Diploma,0,0,0
25638,6,State - HARYANA,Urban,7,Non-Technical Diploma,0,0,0
25639,6,State - HARYANA,Urban,8,Non-Technical Diploma,0,0,0
25640,6,State - HARYANA,Urban,9,Non-Technical Diploma,0,0,0
25641,6,State - HARYANA,Urban,10,Non-Technical Diploma,0,0,0
25642,6,State - HARYANA,Urban,11,Non-Technical Diploma,0,0,0
25643,6,State - HARYANA,Urban,12,Non-Technical Diploma,0,0,0
25644,6,State - HARYANA,Urban,13,Non-Technical Diploma,0,0,0
25645,6,State - HARYANA,Urban,14,Non-Technical Diploma,0,0,0
25646,6,State - HARYANA,Urban,15,Non-Technical Diploma,0,0,0
25647,6,State - HARYANA,Urban,16,Non-Technical Diploma,0,0,0
25648,6,State - HARYANA,Urban,17,Non-Technical Diploma,0,0,0
25649,6,State - HARYANA,Urban,18,Non-Technical Diploma,553,250,803
25650,6,State - HARYANA,Urban,19,Non-Technical Diploma,489,216,705
25651,6,State - HARYANA,Urban,20-24,Non-Technical Diploma,1908,904,2812
25652,6,State - HARYANA,Urban,25-29,Non-Technical Diploma,1067,587,1654
25653,6,State - HARYANA,Urban,30-34,Non-Technical Diploma,874,654,1528
25654,6,State - HARYANA,Urban,35-39,Non-Technical Diploma,797,731,1528
25655,6,State - HARYANA,Urban,40-44,Non-Technical Diploma,731,961,1692
25656,6,State - HARYANA,Urban,45-49,Non-Technical Diploma,725,820,1545
25657,6,State - HARYANA,Urban,50-54,Non-Technical Diploma,631,728,1359
25658,6,State - HARYANA,Urban,55-59,Non-Technical Diploma,551,684,1235
25659,6,State - HARYANA,Urban,60-64,Non-Technical Diploma,425,315,740
25660,6,State - HARYANA,Urban,65-69,Non-Technical Diploma,326,357,683
25661,6,State - HARYANA,Urban,70-74,Non-Technical Diploma,213,427,640
25662,6,State - HARYANA,Urban,75-79,Non-Technical Diploma,138,268,406
25663,6,State - HARYANA,Urban,80+,Non-Technical Diploma,102,159,261
25664,6,State - HARYANA,Urban,Age not stated,Non-Technical Diploma,23,16,39
25665,7,State - NCT OF DELHI,Total,All ages,Non-Technical Diploma,6430,6108,12538
25666,7,State - NCT OF DELHI,Total,0-6,Non-Technical Diploma,0,0,0
25667,7,State - NCT OF DELHI,Total,7,Non-Technical Diploma,0,0,0
25668,7,State - NCT OF DELHI,Total,8,Non-Technical Diploma,0,0,0
25669,7,State - NCT OF DELHI,Total,9,Non-Technical Diploma,0,0,0
25670,7,State - NCT OF DELHI,Total,10,Non-Technical Diploma,0,0,0
25671,7,State - NCT OF DELHI,Total,11,Non-Technical Diploma,0,0,0
25672,7,State - NCT OF DELHI,Total,12,Non-Technical Diploma,0,0,0
25673,7,State - NCT OF DELHI,Total,13,Non-Technical Diploma,0,0,0
25674,7,State - NCT OF DELHI,Total,14,Non-Technical Diploma,0,0,0
25675,7,State - NCT OF DELHI,Total,15,Non-Technical Diploma,0,0,0
25676,7,State - NCT OF DELHI,Total,16,Non-Technical Diploma,0,0,0
25677,7,State - NCT OF DELHI,Total,17,Non-Technical Diploma,0,0,0
25678,7,State - NCT OF DELHI,Total,18,Non-Technical Diploma,180,178,358
25679,7,State - NCT OF DELHI,Total,19,Non-Technical Diploma,247,229,476
25680,7,State - NCT OF DELHI,Total,20-24,Non-Technical Diploma,1344,1229,2573
25681,7,State - NCT OF DELHI,Total,25-29,Non-Technical Diploma,907,844,1751
25682,7,State - NCT OF DELHI,Total,30-34,Non-Technical Diploma,697,578,1275
25683,7,State - NCT OF DELHI,Total,35-39,Non-Technical Diploma,613,470,1083
25684,7,State - NCT OF DELHI,Total,40-44,Non-Technical Diploma,476,374,850
25685,7,State - NCT OF DELHI,Total,45-49,Non-Technical Diploma,541,314,855
25686,7,State - NCT OF DELHI,Total,50-54,Non-Technical Diploma,349,247,596
25687,7,State - NCT OF DELHI,Total,55-59,Non-Technical Diploma,277,183,460
25688,7,State - NCT OF DELHI,Total,60-64,Non-Technical Diploma,240,178,418
25689,7,State - NCT OF DELHI,Total,65-69,Non-Technical Diploma,172,285,457
25690,7,State - NCT OF DELHI,Total,70-74,Non-Technical Diploma,173,397,570
25691,7,State - NCT OF DELHI,Total,75-79,Non-Technical Diploma,104,344,448
25692,7,State - NCT OF DELHI,Total,80+,Non-Technical Diploma,106,256,362
25693,7,State - NCT OF DELHI,Total,Age not stated,Non-Technical Diploma,4,2,6
25694,7,State - NCT OF DELHI,Rural,All ages,Non-Technical Diploma,75,68,143
25695,7,State - NCT OF DELHI,Rural,0-6,Non-Technical Diploma,0,0,0
25696,7,State - NCT OF DELHI,Rural,7,Non-Technical Diploma,0,0,0
25697,7,State - NCT OF DELHI,Rural,8,Non-Technical Diploma,0,0,0
25698,7,State - NCT OF DELHI,Rural,9,Non-Technical Diploma,0,0,0
25699,7,State - NCT OF DELHI,Rural,10,Non-Technical Diploma,0,0,0
25700,7,State - NCT OF DELHI,Rural,11,Non-Technical Diploma,0,0,0
25701,7,State - NCT OF DELHI,Rural,12,Non-Technical Diploma,0,0,0
25702,7,State - NCT OF DELHI,Rural,13,Non-Technical Diploma,0,0,0
25703,7,State - NCT OF DELHI,Rural,14,Non-Technical Diploma,0,0,0
25704,7,State - NCT OF DELHI,Rural,15,Non-Technical Diploma,0,0,0
25705,7,State - NCT OF DELHI,Rural,16,Non-Technical Diploma,0,0,0
25706,7,State - NCT OF DELHI,Rural,17,Non-Technical Diploma,0,0,0
25707,7,State - NCT OF DELHI,Rural,18,Non-Technical Diploma,5,7,12
25708,7,State - NCT OF DELHI,Rural,19,Non-Technical Diploma,3,4,7
25709,7,State - NCT OF DELHI,Rural,20-24,Non-Technical Diploma,17,9,26
25710,7,State - NCT OF DELHI,Rural,25-29,Non-Technical Diploma,9,12,21
25711,7,State - NCT OF DELHI,Rural,30-34,Non-Technical Diploma,13,6,19
25712,7,State - NCT OF DELHI,Rural,35-39,Non-Technical Diploma,10,9,19
25713,7,State - NCT OF DELHI,Rural,40-44,Non-Technical Diploma,4,6,10
25714,7,State - NCT OF DELHI,Rural,45-49,Non-Technical Diploma,3,5,8
25715,7,State - NCT OF DELHI,Rural,50-54,Non-Technical Diploma,5,3,8
25716,7,State - NCT OF DELHI,Rural,55-59,Non-Technical Diploma,0,3,3
25717,7,State - NCT OF DELHI,Rural,60-64,Non-Technical Diploma,3,1,4
25718,7,State - NCT OF DELHI,Rural,65-69,Non-Technical Diploma,1,1,2
25719,7,State - NCT OF DELHI,Rural,70-74,Non-Technical Diploma,0,2,2
25720,7,State - NCT OF DELHI,Rural,75-79,Non-Technical Diploma,0,0,0
25721,7,State - NCT OF DELHI,Rural,80+,Non-Technical Diploma,2,0,2
25722,7,State - NCT OF DELHI,Rural,Age not stated,Non-Technical Diploma,0,0,0
25723,7,State - NCT OF DELHI,Urban,All ages,Non-Technical Diploma,6355,6040,12395
25724,7,State - NCT OF DELHI,Urban,0-6,Non-Technical Diploma,0,0,0
25725,7,State - NCT OF DELHI,Urban,7,Non-Technical Diploma,0,0,0
25726,7,State - NCT OF DELHI,Urban,8,Non-Technical Diploma,0,0,0
25727,7,State - NCT OF DELHI,Urban,9,Non-Technical Diploma,0,0,0
25728,7,State - NCT OF DELHI,Urban,10,Non-Technical Diploma,0,0,0
25729,7,State - NCT OF DELHI,Urban,11,Non-Technical Diploma,0,0,0
25730,7,State - NCT OF DELHI,Urban,12,Non-Technical Diploma,0,0,0
25731,7,State - NCT OF DELHI,Urban,13,Non-Technical Diploma,0,0,0
25732,7,State - NCT OF DELHI,Urban,14,Non-Technical Diploma,0,0,0
25733,7,State - NCT OF DELHI,Urban,15,Non-Technical Diploma,0,0,0
25734,7,State - NCT OF DELHI,Urban,16,Non-Technical Diploma,0,0,0
25735,7,State - NCT OF DELHI,Urban,17,Non-Technical Diploma,0,0,0
25736,7,State - NCT OF DELHI,Urban,18,Non-Technical Diploma,175,171,346
25737,7,State - NCT OF DELHI,Urban,19,Non-Technical Diploma,244,225,469
25738,7,State - NCT OF DELHI,Urban,20-24,Non-Technical Diploma,1327,1220,2547
25739,7,State - NCT OF DELHI,Urban,25-29,Non-Technical Diploma,898,832,1730
25740,7,State - NCT OF DELHI,Urban,30-34,Non-Technical Diploma,684,572,1256
25741,7,State - NCT OF DELHI,Urban,35-39,Non-Technical Diploma,603,461,1064
25742,7,State - NCT OF DELHI,Urban,40-44,Non-Technical Diploma,472,368,840
25743,7,State - NCT OF DELHI,Urban,45-49,Non-Technical Diploma,538,309,847
25744,7,State - NCT OF DELHI,Urban,50-54,Non-Technical Diploma,344,244,588
25745,7,State - NCT OF DELHI,Urban,55-59,Non-Technical Diploma,277,180,457
25746,7,State - NCT OF DELHI,Urban,60-64,Non-Technical Diploma,237,177,414
25747,7,State - NCT OF DELHI,Urban,65-69,Non-Technical Diploma,171,284,455
25748,7,State - NCT OF DELHI,Urban,70-74,Non-Technical Diploma,173,395,568
25749,7,State - NCT OF DELHI,Urban,75-79,Non-Technical Diploma,104,344,448
25750,7,State - NCT OF DELHI,Urban,80+,Non-Technical Diploma,104,256,360
25751,7,State - NCT OF DELHI,Urban,Age not stated,Non-Technical Diploma,4,2,6
25752,8,State - RAJASTHAN,Total,All ages,Non-Technical Diploma,4801,2721,7522
25753,8,State - RAJASTHAN,Total,0-6,Non-Technical Diploma,0,0,0
25754,8,State - RAJASTHAN,Total,7,Non-Technical Diploma,0,0,0
25755,8,State - RAJASTHAN,Total,8,Non-Technical Diploma,0,0,0
25756,8,State - RAJASTHAN,Total,9,Non-Technical Diploma,0,0,0
25757,8,State - RAJASTHAN,Total,10,Non-Technical Diploma,0,0,0
25758,8,State - RAJASTHAN,Total,11,Non-Technical Diploma,0,0,0
25759,8,State - RAJASTHAN,Total,12,Non-Technical Diploma,0,0,0
25760,8,State - RAJASTHAN,Total,13,Non-Technical Diploma,0,0,0
25761,8,State - RAJASTHAN,Total,14,Non-Technical Diploma,0,0,0
25762,8,State - RAJASTHAN,Total,15,Non-Technical Diploma,0,0,0
25763,8,State - RAJASTHAN,Total,16,Non-Technical Diploma,0,0,0
25764,8,State - RAJASTHAN,Total,17,Non-Technical Diploma,0,0,0
25765,8,State - RAJASTHAN,Total,18,Non-Technical Diploma,219,152,371
25766,8,State - RAJASTHAN,Total,19,Non-Technical Diploma,204,134,338
25767,8,State - RAJASTHAN,Total,20-24,Non-Technical Diploma,1123,826,1949
25768,8,State - RAJASTHAN,Total,25-29,Non-Technical Diploma,693,419,1112
25769,8,State - RAJASTHAN,Total,30-34,Non-Technical Diploma,435,237,672
25770,8,State - RAJASTHAN,Total,35-39,Non-Technical Diploma,403,200,603
25771,8,State - RAJASTHAN,Total,40-44,Non-Technical Diploma,352,200,552
25772,8,State - RAJASTHAN,Total,45-49,Non-Technical Diploma,347,134,481
25773,8,State - RAJASTHAN,Total,50-54,Non-Technical Diploma,250,100,350
25774,8,State - RAJASTHAN,Total,55-59,Non-Technical Diploma,215,79,294
25775,8,State - RAJASTHAN,Total,60-64,Non-Technical Diploma,153,67,220
25776,8,State - RAJASTHAN,Total,65-69,Non-Technical Diploma,132,51,183
25777,8,State - RAJASTHAN,Total,70-74,Non-Technical Diploma,105,52,157
25778,8,State - RAJASTHAN,Total,75-79,Non-Technical Diploma,57,25,82
25779,8,State - RAJASTHAN,Total,80+,Non-Technical Diploma,94,33,127
25780,8,State - RAJASTHAN,Total,Age not stated,Non-Technical Diploma,19,12,31
25781,8,State - RAJASTHAN,Rural,All ages,Non-Technical Diploma,1991,787,2778
25782,8,State - RAJASTHAN,Rural,0-6,Non-Technical Diploma,0,0,0
25783,8,State - RAJASTHAN,Rural,7,Non-Technical Diploma,0,0,0
25784,8,State - RAJASTHAN,Rural,8,Non-Technical Diploma,0,0,0
25785,8,State - RAJASTHAN,Rural,9,Non-Technical Diploma,0,0,0
25786,8,State - RAJASTHAN,Rural,10,Non-Technical Diploma,0,0,0
25787,8,State - RAJASTHAN,Rural,11,Non-Technical Diploma,0,0,0
25788,8,State - RAJASTHAN,Rural,12,Non-Technical Diploma,0,0,0
25789,8,State - RAJASTHAN,Rural,13,Non-Technical Diploma,0,0,0
25790,8,State - RAJASTHAN,Rural,14,Non-Technical Diploma,0,0,0
25791,8,State - RAJASTHAN,Rural,15,Non-Technical Diploma,0,0,0
25792,8,State - RAJASTHAN,Rural,16,Non-Technical Diploma,0,0,0
25793,8,State - RAJASTHAN,Rural,17,Non-Technical Diploma,0,0,0
25794,8,State - RAJASTHAN,Rural,18,Non-Technical Diploma,112,59,171
25795,8,State - RAJASTHAN,Rural,19,Non-Technical Diploma,90,46,136
25796,8,State - RAJASTHAN,Rural,20-24,Non-Technical Diploma,504,254,758
25797,8,State - RAJASTHAN,Rural,25-29,Non-Technical Diploma,324,124,448
25798,8,State - RAJASTHAN,Rural,30-34,Non-Technical Diploma,192,78,270
25799,8,State - RAJASTHAN,Rural,35-39,Non-Technical Diploma,182,53,235
25800,8,State - RAJASTHAN,Rural,40-44,Non-Technical Diploma,137,56,193
25801,8,State - RAJASTHAN,Rural,45-49,Non-Technical Diploma,129,40,169
25802,8,State - RAJASTHAN,Rural,50-54,Non-Technical Diploma,68,27,95
25803,8,State - RAJASTHAN,Rural,55-59,Non-Technical Diploma,67,12,79
25804,8,State - RAJASTHAN,Rural,60-64,Non-Technical Diploma,49,6,55
25805,8,State - RAJASTHAN,Rural,65-69,Non-Technical Diploma,31,10,41
25806,8,State - RAJASTHAN,Rural,70-74,Non-Technical Diploma,32,9,41
25807,8,State - RAJASTHAN,Rural,75-79,Non-Technical Diploma,27,4,31
25808,8,State - RAJASTHAN,Rural,80+,Non-Technical Diploma,42,1,43
25809,8,State - RAJASTHAN,Rural,Age not stated,Non-Technical Diploma,5,8,13
25810,8,State - RAJASTHAN,Urban,All ages,Non-Technical Diploma,2810,1934,4744
25811,8,State - RAJASTHAN,Urban,0-6,Non-Technical Diploma,0,0,0
25812,8,State - RAJASTHAN,Urban,7,Non-Technical Diploma,0,0,0
25813,8,State - RAJASTHAN,Urban,8,Non-Technical Diploma,0,0,0
25814,8,State - RAJASTHAN,Urban,9,Non-Technical Diploma,0,0,0
25815,8,State - RAJASTHAN,Urban,10,Non-Technical Diploma,0,0,0
25816,8,State - RAJASTHAN,Urban,11,Non-Technical Diploma,0,0,0
25817,8,State - RAJASTHAN,Urban,12,Non-Technical Diploma,0,0,0
25818,8,State - RAJASTHAN,Urban,13,Non-Technical Diploma,0,0,0
25819,8,State - RAJASTHAN,Urban,14,Non-Technical Diploma,0,0,0
25820,8,State - RAJASTHAN,Urban,15,Non-Technical Diploma,0,0,0
25821,8,State - RAJASTHAN,Urban,16,Non-Technical Diploma,0,0,0
25822,8,State - RAJASTHAN,Urban,17,Non-Technical Diploma,0,0,0
25823,8,State - RAJASTHAN,Urban,18,Non-Technical Diploma,107,93,200
25824,8,State - RAJASTHAN,Urban,19,Non-Technical Diploma,114,88,202
25825,8,State - RAJASTHAN,Urban,20-24,Non-Technical Diploma,619,572,1191
25826,8,State - RAJASTHAN,Urban,25-29,Non-Technical Diploma,369,295,664
25827,8,State - RAJASTHAN,Urban,30-34,Non-Technical Diploma,243,159,402
25828,8,State - RAJASTHAN,Urban,35-39,Non-Technical Diploma,221,147,368
25829,8,State - RAJASTHAN,Urban,40-44,Non-Technical Diploma,215,144,359
25830,8,State - RAJASTHAN,Urban,45-49,Non-Technical Diploma,218,94,312
25831,8,State - RAJASTHAN,Urban,50-54,Non-Technical Diploma,182,73,255
25832,8,State - RAJASTHAN,Urban,55-59,Non-Technical Diploma,148,67,215
25833,8,State - RAJASTHAN,Urban,60-64,Non-Technical Diploma,104,61,165
25834,8,State - RAJASTHAN,Urban,65-69,Non-Technical Diploma,101,41,142
25835,8,State - RAJASTHAN,Urban,70-74,Non-Technical Diploma,73,43,116
25836,8,State - RAJASTHAN,Urban,75-79,Non-Technical Diploma,30,21,51
25837,8,State - RAJASTHAN,Urban,80+,Non-Technical Diploma,52,32,84
25838,8,State - RAJASTHAN,Urban,Age not stated,Non-Technical Diploma,14,4,18
25839,9,State - UTTAR PRADESH,Total,All ages,Non-Technical Diploma,73327,62631,135958
25840,9,State - UTTAR PRADESH,Total,0-6,Non-Technical Diploma,0,0,0
25841,9,State - UTTAR PRADESH,Total,7,Non-Technical Diploma,0,0,0
25842,9,State - UTTAR PRADESH,Total,8,Non-Technical Diploma,0,0,0
25843,9,State - UTTAR PRADESH,Total,9,Non-Technical Diploma,0,0,0
25844,9,State - UTTAR PRADESH,Total,10,Non-Technical Diploma,0,0,0
25845,9,State - UTTAR PRADESH,Total,11,Non-Technical Diploma,0,0,0
25846,9,State - UTTAR PRADESH,Total,12,Non-Technical Diploma,0,0,0
25847,9,State - UTTAR PRADESH,Total,13,Non-Technical Diploma,0,0,0
25848,9,State - UTTAR PRADESH,Total,14,Non-Technical Diploma,0,0,0
25849,9,State - UTTAR PRADESH,Total,15,Non-Technical Diploma,0,0,0
25850,9,State - UTTAR PRADESH,Total,16,Non-Technical Diploma,0,0,0
25851,9,State - UTTAR PRADESH,Total,17,Non-Technical Diploma,0,0,0
25852,9,State - UTTAR PRADESH,Total,18,Non-Technical Diploma,4182,4146,8328
25853,9,State - UTTAR PRADESH,Total,19,Non-Technical Diploma,2937,2499,5436
25854,9,State - UTTAR PRADESH,Total,20-24,Non-Technical Diploma,13944,12218,26162
25855,9,State - UTTAR PRADESH,Total,25-29,Non-Technical Diploma,8335,9501,17836
25856,9,State - UTTAR PRADESH,Total,30-34,Non-Technical Diploma,6456,7963,14419
25857,9,State - UTTAR PRADESH,Total,35-39,Non-Technical Diploma,6595,6930,13525
25858,9,State - UTTAR PRADESH,Total,40-44,Non-Technical Diploma,6091,5108,11199
25859,9,State - UTTAR PRADESH,Total,45-49,Non-Technical Diploma,5496,3852,9348
25860,9,State - UTTAR PRADESH,Total,50-54,Non-Technical Diploma,4679,2713,7392
25861,9,State - UTTAR PRADESH,Total,55-59,Non-Technical Diploma,3734,2264,5998
25862,9,State - UTTAR PRADESH,Total,60-64,Non-Technical Diploma,3842,1934,5776
25863,9,State - UTTAR PRADESH,Total,65-69,Non-Technical Diploma,2537,1180,3717
25864,9,State - UTTAR PRADESH,Total,70-74,Non-Technical Diploma,1798,688,2486
25865,9,State - UTTAR PRADESH,Total,75-79,Non-Technical Diploma,803,335,1138
25866,9,State - UTTAR PRADESH,Total,80+,Non-Technical Diploma,1087,563,1650
25867,9,State - UTTAR PRADESH,Total,Age not stated,Non-Technical Diploma,811,737,1548
25868,9,State - UTTAR PRADESH,Rural,All ages,Non-Technical Diploma,40781,43082,83863
25869,9,State - UTTAR PRADESH,Rural,0-6,Non-Technical Diploma,0,0,0
25870,9,State - UTTAR PRADESH,Rural,7,Non-Technical Diploma,0,0,0
25871,9,State - UTTAR PRADESH,Rural,8,Non-Technical Diploma,0,0,0
25872,9,State - UTTAR PRADESH,Rural,9,Non-Technical Diploma,0,0,0
25873,9,State - UTTAR PRADESH,Rural,10,Non-Technical Diploma,0,0,0
25874,9,State - UTTAR PRADESH,Rural,11,Non-Technical Diploma,0,0,0
25875,9,State - UTTAR PRADESH,Rural,12,Non-Technical Diploma,0,0,0
25876,9,State - UTTAR PRADESH,Rural,13,Non-Technical Diploma,0,0,0
25877,9,State - UTTAR PRADESH,Rural,14,Non-Technical Diploma,0,0,0
25878,9,State - UTTAR PRADESH,Rural,15,Non-Technical Diploma,0,0,0
25879,9,State - UTTAR PRADESH,Rural,16,Non-Technical Diploma,0,0,0
25880,9,State - UTTAR PRADESH,Rural,17,Non-Technical Diploma,0,0,0
25881,9,State - UTTAR PRADESH,Rural,18,Non-Technical Diploma,2513,3086,5599
25882,9,State - UTTAR PRADESH,Rural,19,Non-Technical Diploma,1640,1739,3379
25883,9,State - UTTAR PRADESH,Rural,20-24,Non-Technical Diploma,7959,8669,16628
25884,9,State - UTTAR PRADESH,Rural,25-29,Non-Technical Diploma,5116,6810,11926
25885,9,State - UTTAR PRADESH,Rural,30-34,Non-Technical Diploma,3934,5762,9696
25886,9,State - UTTAR PRADESH,Rural,35-39,Non-Technical Diploma,3834,4873,8707
25887,9,State - UTTAR PRADESH,Rural,40-44,Non-Technical Diploma,3313,3462,6775
25888,9,State - UTTAR PRADESH,Rural,45-49,Non-Technical Diploma,2794,2470,5264
25889,9,State - UTTAR PRADESH,Rural,50-54,Non-Technical Diploma,2212,1643,3855
25890,9,State - UTTAR PRADESH,Rural,55-59,Non-Technical Diploma,1678,1368,3046
25891,9,State - UTTAR PRADESH,Rural,60-64,Non-Technical Diploma,1961,1135,3096
25892,9,State - UTTAR PRADESH,Rural,65-69,Non-Technical Diploma,1303,666,1969
25893,9,State - UTTAR PRADESH,Rural,70-74,Non-Technical Diploma,964,373,1337
25894,9,State - UTTAR PRADESH,Rural,75-79,Non-Technical Diploma,444,196,640
25895,9,State - UTTAR PRADESH,Rural,80+,Non-Technical Diploma,697,334,1031
25896,9,State - UTTAR PRADESH,Rural,Age not stated,Non-Technical Diploma,419,496,915
25897,9,State - UTTAR PRADESH,Urban,All ages,Non-Technical Diploma,32546,19549,52095
25898,9,State - UTTAR PRADESH,Urban,0-6,Non-Technical Diploma,0,0,0
25899,9,State - UTTAR PRADESH,Urban,7,Non-Technical Diploma,0,0,0
25900,9,State - UTTAR PRADESH,Urban,8,Non-Technical Diploma,0,0,0
25901,9,State - UTTAR PRADESH,Urban,9,Non-Technical Diploma,0,0,0
25902,9,State - UTTAR PRADESH,Urban,10,Non-Technical Diploma,0,0,0
25903,9,State - UTTAR PRADESH,Urban,11,Non-Technical Diploma,0,0,0
25904,9,State - UTTAR PRADESH,Urban,12,Non-Technical Diploma,0,0,0
25905,9,State - UTTAR PRADESH,Urban,13,Non-Technical Diploma,0,0,0
25906,9,State - UTTAR PRADESH,Urban,14,Non-Technical Diploma,0,0,0
25907,9,State - UTTAR PRADESH,Urban,15,Non-Technical Diploma,0,0,0
25908,9,State - UTTAR PRADESH,Urban,16,Non-Technical Diploma,0,0,0
25909,9,State - UTTAR PRADESH,Urban,17,Non-Technical Diploma,0,0,0
25910,9,State - UTTAR PRADESH,Urban,18,Non-Technical Diploma,1669,1060,2729
25911,9,State - UTTAR PRADESH,Urban,19,Non-Technical Diploma,1297,760,2057
25912,9,State - UTTAR PRADESH,Urban,20-24,Non-Technical Diploma,5985,3549,9534
25913,9,State - UTTAR PRADESH,Urban,25-29,Non-Technical Diploma,3219,2691,5910
25914,9,State - UTTAR PRADESH,Urban,30-34,Non-Technical Diploma,2522,2201,4723
25915,9,State - UTTAR PRADESH,Urban,35-39,Non-Technical Diploma,2761,2057,4818
25916,9,State - UTTAR PRADESH,Urban,40-44,Non-Technical Diploma,2778,1646,4424
25917,9,State - UTTAR PRADESH,Urban,45-49,Non-Technical Diploma,2702,1382,4084
25918,9,State - UTTAR PRADESH,Urban,50-54,Non-Technical Diploma,2467,1070,3537
25919,9,State - UTTAR PRADESH,Urban,55-59,Non-Technical Diploma,2056,896,2952
25920,9,State - UTTAR PRADESH,Urban,60-64,Non-Technical Diploma,1881,799,2680
25921,9,State - UTTAR PRADESH,Urban,65-69,Non-Technical Diploma,1234,514,1748
25922,9,State - UTTAR PRADESH,Urban,70-74,Non-Technical Diploma,834,315,1149
25923,9,State - UTTAR PRADESH,Urban,75-79,Non-Technical Diploma,359,139,498
25924,9,State - UTTAR PRADESH,Urban,80+,Non-Technical Diploma,390,229,619
25925,9,State - UTTAR PRADESH,Urban,Age not stated,Non-Technical Diploma,392,241,633
25926,10,State - BIHAR,Total,All ages,Non-Technical Diploma,58956,34095,93051
25927,10,State - BIHAR,Total,0-6,Non-Technical Diploma,0,0,0
25928,10,State - BIHAR,Total,7,Non-Technical Diploma,0,0,0
25929,10,State - BIHAR,Total,8,Non-Technical Diploma,0,0,0
25930,10,State - BIHAR,Total,9,Non-Technical Diploma,0,0,0
25931,10,State - BIHAR,Total,10,Non-Technical Diploma,0,0,0
25932,10,State - BIHAR,Total,11,Non-Technical Diploma,0,0,0
25933,10,State - BIHAR,Total,12,Non-Technical Diploma,0,0,0
25934,10,State - BIHAR,Total,13,Non-Technical Diploma,0,0,0
25935,10,State - BIHAR,Total,14,Non-Technical Diploma,0,0,0
25936,10,State - BIHAR,Total,15,Non-Technical Diploma,0,0,0
25937,10,State - BIHAR,Total,16,Non-Technical Diploma,0,0,0
25938,10,State - BIHAR,Total,17,Non-Technical Diploma,0,0,0
25939,10,State - BIHAR,Total,18,Non-Technical Diploma,2655,2338,4993
25940,10,State - BIHAR,Total,19,Non-Technical Diploma,1827,1794,3621
25941,10,State - BIHAR,Total,20-24,Non-Technical Diploma,11220,9089,20309
25942,10,State - BIHAR,Total,25-29,Non-Technical Diploma,8776,6527,15303
25943,10,State - BIHAR,Total,30-34,Non-Technical Diploma,7262,4639,11901
25944,10,State - BIHAR,Total,35-39,Non-Technical Diploma,6198,3383,9581
25945,10,State - BIHAR,Total,40-44,Non-Technical Diploma,4841,2012,6853
25946,10,State - BIHAR,Total,45-49,Non-Technical Diploma,3850,1358,5208
25947,10,State - BIHAR,Total,50-54,Non-Technical Diploma,3323,887,4210
25948,10,State - BIHAR,Total,55-59,Non-Technical Diploma,2447,649,3096
25949,10,State - BIHAR,Total,60-64,Non-Technical Diploma,2512,522,3034
25950,10,State - BIHAR,Total,65-69,Non-Technical Diploma,1921,317,2238
25951,10,State - BIHAR,Total,70-74,Non-Technical Diploma,1047,167,1214
25952,10,State - BIHAR,Total,75-79,Non-Technical Diploma,426,86,512
25953,10,State - BIHAR,Total,80+,Non-Technical Diploma,424,153,577
25954,10,State - BIHAR,Total,Age not stated,Non-Technical Diploma,227,174,401
25955,10,State - BIHAR,Rural,All ages,Non-Technical Diploma,49520,28273,77793
25956,10,State - BIHAR,Rural,0-6,Non-Technical Diploma,0,0,0
25957,10,State - BIHAR,Rural,7,Non-Technical Diploma,0,0,0
25958,10,State - BIHAR,Rural,8,Non-Technical Diploma,0,0,0
25959,10,State - BIHAR,Rural,9,Non-Technical Diploma,0,0,0
25960,10,State - BIHAR,Rural,10,Non-Technical Diploma,0,0,0
25961,10,State - BIHAR,Rural,11,Non-Technical Diploma,0,0,0
25962,10,State - BIHAR,Rural,12,Non-Technical Diploma,0,0,0
25963,10,State - BIHAR,Rural,13,Non-Technical Diploma,0,0,0
25964,10,State - BIHAR,Rural,14,Non-Technical Diploma,0,0,0
25965,10,State - BIHAR,Rural,15,Non-Technical Diploma,0,0,0
25966,10,State - BIHAR,Rural,16,Non-Technical Diploma,0,0,0
25967,10,State - BIHAR,Rural,17,Non-Technical Diploma,0,0,0
25968,10,State - BIHAR,Rural,18,Non-Technical Diploma,2331,2066,4397
25969,10,State - BIHAR,Rural,19,Non-Technical Diploma,1573,1603,3176
25970,10,State - BIHAR,Rural,20-24,Non-Technical Diploma,9845,8056,17901
25971,10,State - BIHAR,Rural,25-29,Non-Technical Diploma,7780,5679,13459
25972,10,State - BIHAR,Rural,30-34,Non-Technical Diploma,6303,3880,10183
25973,10,State - BIHAR,Rural,35-39,Non-Technical Diploma,5328,2679,8007
25974,10,State - BIHAR,Rural,40-44,Non-Technical Diploma,4002,1486,5488
25975,10,State - BIHAR,Rural,45-49,Non-Technical Diploma,3136,928,4064
25976,10,State - BIHAR,Rural,50-54,Non-Technical Diploma,2652,576,3228
25977,10,State - BIHAR,Rural,55-59,Non-Technical Diploma,1837,415,2252
25978,10,State - BIHAR,Rural,60-64,Non-Technical Diploma,1853,317,2170
25979,10,State - BIHAR,Rural,65-69,Non-Technical Diploma,1329,197,1526
25980,10,State - BIHAR,Rural,70-74,Non-Technical Diploma,741,94,835
25981,10,State - BIHAR,Rural,75-79,Non-Technical Diploma,308,60,368
25982,10,State - BIHAR,Rural,80+,Non-Technical Diploma,323,100,423
25983,10,State - BIHAR,Rural,Age not stated,Non-Technical Diploma,179,137,316
25984,10,State - BIHAR,Urban,All ages,Non-Technical Diploma,9436,5822,15258
25985,10,State - BIHAR,Urban,0-6,Non-Technical Diploma,0,0,0
25986,10,State - BIHAR,Urban,7,Non-Technical Diploma,0,0,0
25987,10,State - BIHAR,Urban,8,Non-Technical Diploma,0,0,0
25988,10,State - BIHAR,Urban,9,Non-Technical Diploma,0,0,0
25989,10,State - BIHAR,Urban,10,Non-Technical Diploma,0,0,0
25990,10,State - BIHAR,Urban,11,Non-Technical Diploma,0,0,0
25991,10,State - BIHAR,Urban,12,Non-Technical Diploma,0,0,0
25992,10,State - BIHAR,Urban,13,Non-Technical Diploma,0,0,0
25993,10,State - BIHAR,Urban,14,Non-Technical Diploma,0,0,0
25994,10,State - BIHAR,Urban,15,Non-Technical Diploma,0,0,0
25995,10,State - BIHAR,Urban,16,Non-Technical Diploma,0,0,0
25996,10,State - BIHAR,Urban,17,Non-Technical Diploma,0,0,0
25997,10,State - BIHAR,Urban,18,Non-Technical Diploma,324,272,596
25998,10,State - BIHAR,Urban,19,Non-Technical Diploma,254,191,445
25999,10,State - BIHAR,Urban,20-24,Non-Technical Diploma,1375,1033,2408
26000,10,State - BIHAR,Urban,25-29,Non-Technical Diploma,996,848,1844
26001,10,State - BIHAR,Urban,30-34,Non-Technical Diploma,959,759,1718
26002,10,State - BIHAR,Urban,35-39,Non-Technical Diploma,870,704,1574
26003,10,State - BIHAR,Urban,40-44,Non-Technical Diploma,839,526,1365
26004,10,State - BIHAR,Urban,45-49,Non-Technical Diploma,714,430,1144
26005,10,State - BIHAR,Urban,50-54,Non-Technical Diploma,671,311,982
26006,10,State - BIHAR,Urban,55-59,Non-Technical Diploma,610,234,844
26007,10,State - BIHAR,Urban,60-64,Non-Technical Diploma,659,205,864
26008,10,State - BIHAR,Urban,65-69,Non-Technical Diploma,592,120,712
26009,10,State - BIHAR,Urban,70-74,Non-Technical Diploma,306,73,379
26010,10,State - BIHAR,Urban,75-79,Non-Technical Diploma,118,26,144
26011,10,State - BIHAR,Urban,80+,Non-Technical Diploma,101,53,154
26012,10,State - BIHAR,Urban,Age not stated,Non-Technical Diploma,48,37,85
26013,11,State - SIKKIM,Total,All ages,Non-Technical Diploma,103,52,155
26014,11,State - SIKKIM,Total,0-6,Non-Technical Diploma,0,0,0
26015,11,State - SIKKIM,Total,7,Non-Technical Diploma,0,0,0
26016,11,State - SIKKIM,Total,8,Non-Technical Diploma,0,0,0
26017,11,State - SIKKIM,Total,9,Non-Technical Diploma,0,0,0
26018,11,State - SIKKIM,Total,10,Non-Technical Diploma,0,0,0
26019,11,State - SIKKIM,Total,11,Non-Technical Diploma,0,0,0
26020,11,State - SIKKIM,Total,12,Non-Technical Diploma,0,0,0
26021,11,State - SIKKIM,Total,13,Non-Technical Diploma,0,0,0
26022,11,State - SIKKIM,Total,14,Non-Technical Diploma,0,0,0
26023,11,State - SIKKIM,Total,15,Non-Technical Diploma,0,0,0
26024,11,State - SIKKIM,Total,16,Non-Technical Diploma,0,0,0
26025,11,State - SIKKIM,Total,17,Non-Technical Diploma,0,0,0
26026,11,State - SIKKIM,Total,18,Non-Technical Diploma,2,5,7
26027,11,State - SIKKIM,Total,19,Non-Technical Diploma,6,2,8
26028,11,State - SIKKIM,Total,20-24,Non-Technical Diploma,26,23,49
26029,11,State - SIKKIM,Total,25-29,Non-Technical Diploma,25,9,34
26030,11,State - SIKKIM,Total,30-34,Non-Technical Diploma,10,4,14
26031,11,State - SIKKIM,Total,35-39,Non-Technical Diploma,8,2,10
26032,11,State - SIKKIM,Total,40-44,Non-Technical Diploma,10,2,12
26033,11,State - SIKKIM,Total,45-49,Non-Technical Diploma,6,2,8
26034,11,State - SIKKIM,Total,50-54,Non-Technical Diploma,4,2,6
26035,11,State - SIKKIM,Total,55-59,Non-Technical Diploma,4,0,4
26036,11,State - SIKKIM,Total,60-64,Non-Technical Diploma,0,1,1
26037,11,State - SIKKIM,Total,65-69,Non-Technical Diploma,0,0,0
26038,11,State - SIKKIM,Total,70-74,Non-Technical Diploma,0,0,0
26039,11,State - SIKKIM,Total,75-79,Non-Technical Diploma,1,0,1
26040,11,State - SIKKIM,Total,80+,Non-Technical Diploma,1,0,1
26041,11,State - SIKKIM,Total,Age not stated,Non-Technical Diploma,0,0,0
26042,11,State - SIKKIM,Rural,All ages,Non-Technical Diploma,53,24,77
26043,11,State - SIKKIM,Rural,0-6,Non-Technical Diploma,0,0,0
26044,11,State - SIKKIM,Rural,7,Non-Technical Diploma,0,0,0
26045,11,State - SIKKIM,Rural,8,Non-Technical Diploma,0,0,0
26046,11,State - SIKKIM,Rural,9,Non-Technical Diploma,0,0,0
26047,11,State - SIKKIM,Rural,10,Non-Technical Diploma,0,0,0
26048,11,State - SIKKIM,Rural,11,Non-Technical Diploma,0,0,0
26049,11,State - SIKKIM,Rural,12,Non-Technical Diploma,0,0,0
26050,11,State - SIKKIM,Rural,13,Non-Technical Diploma,0,0,0
26051,11,State - SIKKIM,Rural,14,Non-Technical Diploma,0,0,0
26052,11,State - SIKKIM,Rural,15,Non-Technical Diploma,0,0,0
26053,11,State - SIKKIM,Rural,16,Non-Technical Diploma,0,0,0
26054,11,State - SIKKIM,Rural,17,Non-Technical Diploma,0,0,0
26055,11,State - SIKKIM,Rural,18,Non-Technical Diploma,1,4,5
26056,11,State - SIKKIM,Rural,19,Non-Technical Diploma,3,2,5
26057,11,State - SIKKIM,Rural,20-24,Non-Technical Diploma,13,11,24
26058,11,State - SIKKIM,Rural,25-29,Non-Technical Diploma,13,1,14
26059,11,State - SIKKIM,Rural,30-34,Non-Technical Diploma,5,2,7
26060,11,State - SIKKIM,Rural,35-39,Non-Technical Diploma,4,0,4
26061,11,State - SIKKIM,Rural,40-44,Non-Technical Diploma,6,2,8
26062,11,State - SIKKIM,Rural,45-49,Non-Technical Diploma,4,1,5
26063,11,State - SIKKIM,Rural,50-54,Non-Technical Diploma,2,1,3
26064,11,State - SIKKIM,Rural,55-59,Non-Technical Diploma,2,0,2
26065,11,State - SIKKIM,Rural,60-64,Non-Technical Diploma,0,0,0
26066,11,State - SIKKIM,Rural,65-69,Non-Technical Diploma,0,0,0
26067,11,State - SIKKIM,Rural,70-74,Non-Technical Diploma,0,0,0
26068,11,State - SIKKIM,Rural,75-79,Non-Technical Diploma,0,0,0
26069,11,State - SIKKIM,Rural,80+,Non-Technical Diploma,0,0,0
26070,11,State - SIKKIM,Rural,Age not stated,Non-Technical Diploma,0,0,0
26071,11,State - SIKKIM,Urban,All ages,Non-Technical Diploma,50,28,78
26072,11,State - SIKKIM,Urban,0-6,Non-Technical Diploma,0,0,0
26073,11,State - SIKKIM,Urban,7,Non-Technical Diploma,0,0,0
26074,11,State - SIKKIM,Urban,8,Non-Technical Diploma,0,0,0
26075,11,State - SIKKIM,Urban,9,Non-Technical Diploma,0,0,0
26076,11,State - SIKKIM,Urban,10,Non-Technical Diploma,0,0,0
26077,11,State - SIKKIM,Urban,11,Non-Technical Diploma,0,0,0
26078,11,State - SIKKIM,Urban,12,Non-Technical Diploma,0,0,0
26079,11,State - SIKKIM,Urban,13,Non-Technical Diploma,0,0,0
26080,11,State - SIKKIM,Urban,14,Non-Technical Diploma,0,0,0
26081,11,State - SIKKIM,Urban,15,Non-Technical Diploma,0,0,0
26082,11,State - SIKKIM,Urban,16,Non-Technical Diploma,0,0,0
26083,11,State - SIKKIM,Urban,17,Non-Technical Diploma,0,0,0
26084,11,State - SIKKIM,Urban,18,Non-Technical Diploma,1,1,2
26085,11,State - SIKKIM,Urban,19,Non-Technical Diploma,3,0,3
26086,11,State - SIKKIM,Urban,20-24,Non-Technical Diploma,13,12,25
26087,11,State - SIKKIM,Urban,25-29,Non-Technical Diploma,12,8,20
26088,11,State - SIKKIM,Urban,30-34,Non-Technical Diploma,5,2,7
26089,11,State - SIKKIM,Urban,35-39,Non-Technical Diploma,4,2,6
26090,11,State - SIKKIM,Urban,40-44,Non-Technical Diploma,4,0,4
26091,11,State - SIKKIM,Urban,45-49,Non-Technical Diploma,2,1,3
26092,11,State - SIKKIM,Urban,50-54,Non-Technical Diploma,2,1,3
26093,11,State - SIKKIM,Urban,55-59,Non-Technical Diploma,2,0,2
26094,11,State - SIKKIM,Urban,60-64,Non-Technical Diploma,0,1,1
26095,11,State - SIKKIM,Urban,65-69,Non-Technical Diploma,0,0,0
26096,11,State - SIKKIM,Urban,70-74,Non-Technical Diploma,0,0,0
26097,11,State - SIKKIM,Urban,75-79,Non-Technical Diploma,1,0,1
26098,11,State - SIKKIM,Urban,80+,Non-Technical Diploma,1,0,1
26099,11,State - SIKKIM,Urban,Age not stated,Non-Technical Diploma,0,0,0
26100,12,State - ARUNACHAL PRADESH,Total,All ages,Non-Technical Diploma,606,172,778
26101,12,State - ARUNACHAL PRADESH,Total,0-6,Non-Technical Diploma,0,0,0
26102,12,State - ARUNACHAL PRADESH,Total,7,Non-Technical Diploma,0,0,0
26103,12,State - ARUNACHAL PRADESH,Total,8,Non-Technical Diploma,0,0,0
26104,12,State - ARUNACHAL PRADESH,Total,9,Non-Technical Diploma,0,0,0
26105,12,State - ARUNACHAL PRADESH,Total,10,Non-Technical Diploma,0,0,0
26106,12,State - ARUNACHAL PRADESH,Total,11,Non-Technical Diploma,0,0,0
26107,12,State - ARUNACHAL PRADESH,Total,12,Non-Technical Diploma,0,0,0
26108,12,State - ARUNACHAL PRADESH,Total,13,Non-Technical Diploma,0,0,0
26109,12,State - ARUNACHAL PRADESH,Total,14,Non-Technical Diploma,0,0,0
26110,12,State - ARUNACHAL PRADESH,Total,15,Non-Technical Diploma,0,0,0
26111,12,State - ARUNACHAL PRADESH,Total,16,Non-Technical Diploma,0,0,0
26112,12,State - ARUNACHAL PRADESH,Total,17,Non-Technical Diploma,0,0,0
26113,12,State - ARUNACHAL PRADESH,Total,18,Non-Technical Diploma,35,13,48
26114,12,State - ARUNACHAL PRADESH,Total,19,Non-Technical Diploma,31,16,47
26115,12,State - ARUNACHAL PRADESH,Total,20-24,Non-Technical Diploma,170,60,230
26116,12,State - ARUNACHAL PRADESH,Total,25-29,Non-Technical Diploma,119,43,162
26117,12,State - ARUNACHAL PRADESH,Total,30-34,Non-Technical Diploma,65,16,81
26118,12,State - ARUNACHAL PRADESH,Total,35-39,Non-Technical Diploma,53,8,61
26119,12,State - ARUNACHAL PRADESH,Total,40-44,Non-Technical Diploma,52,5,57
26120,12,State - ARUNACHAL PRADESH,Total,45-49,Non-Technical Diploma,36,4,40
26121,12,State - ARUNACHAL PRADESH,Total,50-54,Non-Technical Diploma,29,2,31
26122,12,State - ARUNACHAL PRADESH,Total,55-59,Non-Technical Diploma,13,1,14
26123,12,State - ARUNACHAL PRADESH,Total,60-64,Non-Technical Diploma,0,0,0
26124,12,State - ARUNACHAL PRADESH,Total,65-69,Non-Technical Diploma,0,0,0
26125,12,State - ARUNACHAL PRADESH,Total,70-74,Non-Technical Diploma,1,1,2
26126,12,State - ARUNACHAL PRADESH,Total,75-79,Non-Technical Diploma,0,0,0
26127,12,State - ARUNACHAL PRADESH,Total,80+,Non-Technical Diploma,0,1,1
26128,12,State - ARUNACHAL PRADESH,Total,Age not stated,Non-Technical Diploma,2,2,4
26129,12,State - ARUNACHAL PRADESH,Rural,All ages,Non-Technical Diploma,317,95,412
26130,12,State - ARUNACHAL PRADESH,Rural,0-6,Non-Technical Diploma,0,0,0
26131,12,State - ARUNACHAL PRADESH,Rural,7,Non-Technical Diploma,0,0,0
26132,12,State - ARUNACHAL PRADESH,Rural,8,Non-Technical Diploma,0,0,0
26133,12,State - ARUNACHAL PRADESH,Rural,9,Non-Technical Diploma,0,0,0
26134,12,State - ARUNACHAL PRADESH,Rural,10,Non-Technical Diploma,0,0,0
26135,12,State - ARUNACHAL PRADESH,Rural,11,Non-Technical Diploma,0,0,0
26136,12,State - ARUNACHAL PRADESH,Rural,12,Non-Technical Diploma,0,0,0
26137,12,State - ARUNACHAL PRADESH,Rural,13,Non-Technical Diploma,0,0,0
26138,12,State - ARUNACHAL PRADESH,Rural,14,Non-Technical Diploma,0,0,0
26139,12,State - ARUNACHAL PRADESH,Rural,15,Non-Technical Diploma,0,0,0
26140,12,State - ARUNACHAL PRADESH,Rural,16,Non-Technical Diploma,0,0,0
26141,12,State - ARUNACHAL PRADESH,Rural,17,Non-Technical Diploma,0,0,0
26142,12,State - ARUNACHAL PRADESH,Rural,18,Non-Technical Diploma,14,7,21
26143,12,State - ARUNACHAL PRADESH,Rural,19,Non-Technical Diploma,16,11,27
26144,12,State - ARUNACHAL PRADESH,Rural,20-24,Non-Technical Diploma,94,32,126
26145,12,State - ARUNACHAL PRADESH,Rural,25-29,Non-Technical Diploma,60,22,82
26146,12,State - ARUNACHAL PRADESH,Rural,30-34,Non-Technical Diploma,40,11,51
26147,12,State - ARUNACHAL PRADESH,Rural,35-39,Non-Technical Diploma,29,3,32
26148,12,State - ARUNACHAL PRADESH,Rural,40-44,Non-Technical Diploma,29,1,30
26149,12,State - ARUNACHAL PRADESH,Rural,45-49,Non-Technical Diploma,19,3,22
26150,12,State - ARUNACHAL PRADESH,Rural,50-54,Non-Technical Diploma,8,2,10
26151,12,State - ARUNACHAL PRADESH,Rural,55-59,Non-Technical Diploma,5,0,5
26152,12,State - ARUNACHAL PRADESH,Rural,60-64,Non-Technical Diploma,0,0,0
26153,12,State - ARUNACHAL PRADESH,Rural,65-69,Non-Technical Diploma,0,0,0
26154,12,State - ARUNACHAL PRADESH,Rural,70-74,Non-Technical Diploma,1,0,1
26155,12,State - ARUNACHAL PRADESH,Rural,75-79,Non-Technical Diploma,0,0,0
26156,12,State - ARUNACHAL PRADESH,Rural,80+,Non-Technical Diploma,0,1,1
26157,12,State - ARUNACHAL PRADESH,Rural,Age not stated,Non-Technical Diploma,2,2,4
26158,12,State - ARUNACHAL PRADESH,Urban,All ages,Non-Technical Diploma,289,77,366
26159,12,State - ARUNACHAL PRADESH,Urban,0-6,Non-Technical Diploma,0,0,0
26160,12,State - ARUNACHAL PRADESH,Urban,7,Non-Technical Diploma,0,0,0
26161,12,State - ARUNACHAL PRADESH,Urban,8,Non-Technical Diploma,0,0,0
26162,12,State - ARUNACHAL PRADESH,Urban,9,Non-Technical Diploma,0,0,0
26163,12,State - ARUNACHAL PRADESH,Urban,10,Non-Technical Diploma,0,0,0
26164,12,State - ARUNACHAL PRADESH,Urban,11,Non-Technical Diploma,0,0,0
26165,12,State - ARUNACHAL PRADESH,Urban,12,Non-Technical Diploma,0,0,0
26166,12,State - ARUNACHAL PRADESH,Urban,13,Non-Technical Diploma,0,0,0
26167,12,State - ARUNACHAL PRADESH,Urban,14,Non-Technical Diploma,0,0,0
26168,12,State - ARUNACHAL PRADESH,Urban,15,Non-Technical Diploma,0,0,0
26169,12,State - ARUNACHAL PRADESH,Urban,16,Non-Technical Diploma,0,0,0
26170,12,State - ARUNACHAL PRADESH,Urban,17,Non-Technical Diploma,0,0,0
26171,12,State - ARUNACHAL PRADESH,Urban,18,Non-Technical Diploma,21,6,27
26172,12,State - ARUNACHAL PRADESH,Urban,19,Non-Technical Diploma,15,5,20
26173,12,State - ARUNACHAL PRADESH,Urban,20-24,Non-Technical Diploma,76,28,104
26174,12,State - ARUNACHAL PRADESH,Urban,25-29,Non-Technical Diploma,59,21,80
26175,12,State - ARUNACHAL PRADESH,Urban,30-34,Non-Technical Diploma,25,5,30
26176,12,State - ARUNACHAL PRADESH,Urban,35-39,Non-Technical Diploma,24,5,29
26177,12,State - ARUNACHAL PRADESH,Urban,40-44,Non-Technical Diploma,23,4,27
26178,12,State - ARUNACHAL PRADESH,Urban,45-49,Non-Technical Diploma,17,1,18
26179,12,State - ARUNACHAL PRADESH,Urban,50-54,Non-Technical Diploma,21,0,21
26180,12,State - ARUNACHAL PRADESH,Urban,55-59,Non-Technical Diploma,8,1,9
26181,12,State - ARUNACHAL PRADESH,Urban,60-64,Non-Technical Diploma,0,0,0
26182,12,State - ARUNACHAL PRADESH,Urban,65-69,Non-Technical Diploma,0,0,0
26183,12,State - ARUNACHAL PRADESH,Urban,70-74,Non-Technical Diploma,0,1,1
26184,12,State - ARUNACHAL PRADESH,Urban,75-79,Non-Technical Diploma,0,0,0
26185,12,State - ARUNACHAL PRADESH,Urban,80+,Non-Technical Diploma,0,0,0
26186,12,State - ARUNACHAL PRADESH,Urban,Age not stated,Non-Technical Diploma,0,0,0
26187,13,State - NAGALAND,Total,All ages,Non-Technical Diploma,323,286,609
26188,13,State - NAGALAND,Total,0-6,Non-Technical Diploma,0,0,0
26189,13,State - NAGALAND,Total,7,Non-Technical Diploma,0,0,0
26190,13,State - NAGALAND,Total,8,Non-Technical Diploma,0,0,0
26191,13,State - NAGALAND,Total,9,Non-Technical Diploma,0,0,0
26192,13,State - NAGALAND,Total,10,Non-Technical Diploma,0,0,0
26193,13,State - NAGALAND,Total,11,Non-Technical Diploma,0,0,0
26194,13,State - NAGALAND,Total,12,Non-Technical Diploma,0,0,0
26195,13,State - NAGALAND,Total,13,Non-Technical Diploma,0,0,0
26196,13,State - NAGALAND,Total,14,Non-Technical Diploma,0,0,0
26197,13,State - NAGALAND,Total,15,Non-Technical Diploma,0,0,0
26198,13,State - NAGALAND,Total,16,Non-Technical Diploma,0,0,0
26199,13,State - NAGALAND,Total,17,Non-Technical Diploma,0,0,0
26200,13,State - NAGALAND,Total,18,Non-Technical Diploma,8,15,23
26201,13,State - NAGALAND,Total,19,Non-Technical Diploma,5,5,10
26202,13,State - NAGALAND,Total,20-24,Non-Technical Diploma,52,84,136
26203,13,State - NAGALAND,Total,25-29,Non-Technical Diploma,52,51,103
26204,13,State - NAGALAND,Total,30-34,Non-Technical Diploma,40,43,83
26205,13,State - NAGALAND,Total,35-39,Non-Technical Diploma,34,37,71
26206,13,State - NAGALAND,Total,40-44,Non-Technical Diploma,33,22,55
26207,13,State - NAGALAND,Total,45-49,Non-Technical Diploma,30,8,38
26208,13,State - NAGALAND,Total,50-54,Non-Technical Diploma,24,7,31
26209,13,State - NAGALAND,Total,55-59,Non-Technical Diploma,14,5,19
26210,13,State - NAGALAND,Total,60-64,Non-Technical Diploma,16,3,19
26211,13,State - NAGALAND,Total,65-69,Non-Technical Diploma,4,1,5
26212,13,State - NAGALAND,Total,70-74,Non-Technical Diploma,4,1,5
26213,13,State - NAGALAND,Total,75-79,Non-Technical Diploma,2,2,4
26214,13,State - NAGALAND,Total,80+,Non-Technical Diploma,5,1,6
26215,13,State - NAGALAND,Total,Age not stated,Non-Technical Diploma,0,1,1
26216,13,State - NAGALAND,Rural,All ages,Non-Technical Diploma,221,181,402
26217,13,State - NAGALAND,Rural,0-6,Non-Technical Diploma,0,0,0
26218,13,State - NAGALAND,Rural,7,Non-Technical Diploma,0,0,0
26219,13,State - NAGALAND,Rural,8,Non-Technical Diploma,0,0,0
26220,13,State - NAGALAND,Rural,9,Non-Technical Diploma,0,0,0
26221,13,State - NAGALAND,Rural,10,Non-Technical Diploma,0,0,0
26222,13,State - NAGALAND,Rural,11,Non-Technical Diploma,0,0,0
26223,13,State - NAGALAND,Rural,12,Non-Technical Diploma,0,0,0
26224,13,State - NAGALAND,Rural,13,Non-Technical Diploma,0,0,0
26225,13,State - NAGALAND,Rural,14,Non-Technical Diploma,0,0,0
26226,13,State - NAGALAND,Rural,15,Non-Technical Diploma,0,0,0
26227,13,State - NAGALAND,Rural,16,Non-Technical Diploma,0,0,0
26228,13,State - NAGALAND,Rural,17,Non-Technical Diploma,0,0,0
26229,13,State - NAGALAND,Rural,18,Non-Technical Diploma,5,0,5
26230,13,State - NAGALAND,Rural,19,Non-Technical Diploma,3,3,6
26231,13,State - NAGALAND,Rural,20-24,Non-Technical Diploma,27,43,70
26232,13,State - NAGALAND,Rural,25-29,Non-Technical Diploma,38,36,74
26233,13,State - NAGALAND,Rural,30-34,Non-Technical Diploma,32,32,64
26234,13,State - NAGALAND,Rural,35-39,Non-Technical Diploma,25,27,52
26235,13,State - NAGALAND,Rural,40-44,Non-Technical Diploma,16,16,32
26236,13,State - NAGALAND,Rural,45-49,Non-Technical Diploma,24,7,31
26237,13,State - NAGALAND,Rural,50-54,Non-Technical Diploma,16,5,21
26238,13,State - NAGALAND,Rural,55-59,Non-Technical Diploma,13,4,17
26239,13,State - NAGALAND,Rural,60-64,Non-Technical Diploma,11,3,14
26240,13,State - NAGALAND,Rural,65-69,Non-Technical Diploma,3,1,4
26241,13,State - NAGALAND,Rural,70-74,Non-Technical Diploma,4,0,4
26242,13,State - NAGALAND,Rural,75-79,Non-Technical Diploma,1,2,3
26243,13,State - NAGALAND,Rural,80+,Non-Technical Diploma,3,1,4
26244,13,State - NAGALAND,Rural,Age not stated,Non-Technical Diploma,0,1,1
26245,13,State - NAGALAND,Urban,All ages,Non-Technical Diploma,102,105,207
26246,13,State - NAGALAND,Urban,0-6,Non-Technical Diploma,0,0,0
26247,13,State - NAGALAND,Urban,7,Non-Technical Diploma,0,0,0
26248,13,State - NAGALAND,Urban,8,Non-Technical Diploma,0,0,0
26249,13,State - NAGALAND,Urban,9,Non-Technical Diploma,0,0,0
26250,13,State - NAGALAND,Urban,10,Non-Technical Diploma,0,0,0
26251,13,State - NAGALAND,Urban,11,Non-Technical Diploma,0,0,0
26252,13,State - NAGALAND,Urban,12,Non-Technical Diploma,0,0,0
26253,13,State - NAGALAND,Urban,13,Non-Technical Diploma,0,0,0
26254,13,State - NAGALAND,Urban,14,Non-Technical Diploma,0,0,0
26255,13,State - NAGALAND,Urban,15,Non-Technical Diploma,0,0,0
26256,13,State - NAGALAND,Urban,16,Non-Technical Diploma,0,0,0
26257,13,State - NAGALAND,Urban,17,Non-Technical Diploma,0,0,0
26258,13,State - NAGALAND,Urban,18,Non-Technical Diploma,3,15,18
26259,13,State - NAGALAND,Urban,19,Non-Technical Diploma,2,2,4
26260,13,State - NAGALAND,Urban,20-24,Non-Technical Diploma,25,41,66
26261,13,State - NAGALAND,Urban,25-29,Non-Technical Diploma,14,15,29
26262,13,State - NAGALAND,Urban,30-34,Non-Technical Diploma,8,11,19
26263,13,State - NAGALAND,Urban,35-39,Non-Technical Diploma,9,10,19
26264,13,State - NAGALAND,Urban,40-44,Non-Technical Diploma,17,6,23
26265,13,State - NAGALAND,Urban,45-49,Non-Technical Diploma,6,1,7
26266,13,State - NAGALAND,Urban,50-54,Non-Technical Diploma,8,2,10
26267,13,State - NAGALAND,Urban,55-59,Non-Technical Diploma,1,1,2
26268,13,State - NAGALAND,Urban,60-64,Non-Technical Diploma,5,0,5
26269,13,State - NAGALAND,Urban,65-69,Non-Technical Diploma,1,0,1
26270,13,State - NAGALAND,Urban,70-74,Non-Technical Diploma,0,1,1
26271,13,State - NAGALAND,Urban,75-79,Non-Technical Diploma,1,0,1
26272,13,State - NAGALAND,Urban,80+,Non-Technical Diploma,2,0,2
26273,13,State - NAGALAND,Urban,Age not stated,Non-Technical Diploma,0,0,0
26274,14,State - MANIPUR,Total,All ages,Non-Technical Diploma,452,153,605
26275,14,State - MANIPUR,Total,0-6,Non-Technical Diploma,0,0,0
26276,14,State - MANIPUR,Total,7,Non-Technical Diploma,0,0,0
26277,14,State - MANIPUR,Total,8,Non-Technical Diploma,0,0,0
26278,14,State - MANIPUR,Total,9,Non-Technical Diploma,0,0,0
26279,14,State - MANIPUR,Total,10,Non-Technical Diploma,0,0,0
26280,14,State - MANIPUR,Total,11,Non-Technical Diploma,0,0,0
26281,14,State - MANIPUR,Total,12,Non-Technical Diploma,0,0,0
26282,14,State - MANIPUR,Total,13,Non-Technical Diploma,0,0,0
26283,14,State - MANIPUR,Total,14,Non-Technical Diploma,0,0,0
26284,14,State - MANIPUR,Total,15,Non-Technical Diploma,0,0,0
26285,14,State - MANIPUR,Total,16,Non-Technical Diploma,0,0,0
26286,14,State - MANIPUR,Total,17,Non-Technical Diploma,0,0,0
26287,14,State - MANIPUR,Total,18,Non-Technical Diploma,20,8,28
26288,14,State - MANIPUR,Total,19,Non-Technical Diploma,14,8,22
26289,14,State - MANIPUR,Total,20-24,Non-Technical Diploma,98,46,144
26290,14,State - MANIPUR,Total,25-29,Non-Technical Diploma,74,39,113
26291,14,State - MANIPUR,Total,30-34,Non-Technical Diploma,46,15,61
26292,14,State - MANIPUR,Total,35-39,Non-Technical Diploma,27,6,33
26293,14,State - MANIPUR,Total,40-44,Non-Technical Diploma,31,11,42
26294,14,State - MANIPUR,Total,45-49,Non-Technical Diploma,29,7,36
26295,14,State - MANIPUR,Total,50-54,Non-Technical Diploma,40,7,47
26296,14,State - MANIPUR,Total,55-59,Non-Technical Diploma,37,4,41
26297,14,State - MANIPUR,Total,60-64,Non-Technical Diploma,8,0,8
26298,14,State - MANIPUR,Total,65-69,Non-Technical Diploma,10,0,10
26299,14,State - MANIPUR,Total,70-74,Non-Technical Diploma,2,0,2
26300,14,State - MANIPUR,Total,75-79,Non-Technical Diploma,6,1,7
26301,14,State - MANIPUR,Total,80+,Non-Technical Diploma,7,0,7
26302,14,State - MANIPUR,Total,Age not stated,Non-Technical Diploma,3,1,4
26303,14,State - MANIPUR,Rural,All ages,Non-Technical Diploma,220,50,270
26304,14,State - MANIPUR,Rural,0-6,Non-Technical Diploma,0,0,0
26305,14,State - MANIPUR,Rural,7,Non-Technical Diploma,0,0,0
26306,14,State - MANIPUR,Rural,8,Non-Technical Diploma,0,0,0
26307,14,State - MANIPUR,Rural,9,Non-Technical Diploma,0,0,0
26308,14,State - MANIPUR,Rural,10,Non-Technical Diploma,0,0,0
26309,14,State - MANIPUR,Rural,11,Non-Technical Diploma,0,0,0
26310,14,State - MANIPUR,Rural,12,Non-Technical Diploma,0,0,0
26311,14,State - MANIPUR,Rural,13,Non-Technical Diploma,0,0,0
26312,14,State - MANIPUR,Rural,14,Non-Technical Diploma,0,0,0
26313,14,State - MANIPUR,Rural,15,Non-Technical Diploma,0,0,0
26314,14,State - MANIPUR,Rural,16,Non-Technical Diploma,0,0,0
26315,14,State - MANIPUR,Rural,17,Non-Technical Diploma,0,0,0
26316,14,State - MANIPUR,Rural,18,Non-Technical Diploma,10,5,15
26317,14,State - MANIPUR,Rural,19,Non-Technical Diploma,7,4,11
26318,14,State - MANIPUR,Rural,20-24,Non-Technical Diploma,49,13,62
26319,14,State - MANIPUR,Rural,25-29,Non-Technical Diploma,42,13,55
26320,14,State - MANIPUR,Rural,30-34,Non-Technical Diploma,22,4,26
26321,14,State - MANIPUR,Rural,35-39,Non-Technical Diploma,15,2,17
26322,14,State - MANIPUR,Rural,40-44,Non-Technical Diploma,12,4,16
26323,14,State - MANIPUR,Rural,45-49,Non-Technical Diploma,15,1,16
26324,14,State - MANIPUR,Rural,50-54,Non-Technical Diploma,12,2,14
26325,14,State - MANIPUR,Rural,55-59,Non-Technical Diploma,15,1,16
26326,14,State - MANIPUR,Rural,60-64,Non-Technical Diploma,5,0,5
26327,14,State - MANIPUR,Rural,65-69,Non-Technical Diploma,7,0,7
26328,14,State - MANIPUR,Rural,70-74,Non-Technical Diploma,2,0,2
26329,14,State - MANIPUR,Rural,75-79,Non-Technical Diploma,3,0,3
26330,14,State - MANIPUR,Rural,80+,Non-Technical Diploma,3,0,3
26331,14,State - MANIPUR,Rural,Age not stated,Non-Technical Diploma,1,1,2
26332,14,State - MANIPUR,Urban,All ages,Non-Technical Diploma,232,103,335
26333,14,State - MANIPUR,Urban,0-6,Non-Technical Diploma,0,0,0
26334,14,State - MANIPUR,Urban,7,Non-Technical Diploma,0,0,0
26335,14,State - MANIPUR,Urban,8,Non-Technical Diploma,0,0,0
26336,14,State - MANIPUR,Urban,9,Non-Technical Diploma,0,0,0
26337,14,State - MANIPUR,Urban,10,Non-Technical Diploma,0,0,0
26338,14,State - MANIPUR,Urban,11,Non-Technical Diploma,0,0,0
26339,14,State - MANIPUR,Urban,12,Non-Technical Diploma,0,0,0
26340,14,State - MANIPUR,Urban,13,Non-Technical Diploma,0,0,0
26341,14,State - MANIPUR,Urban,14,Non-Technical Diploma,0,0,0
26342,14,State - MANIPUR,Urban,15,Non-Technical Diploma,0,0,0
26343,14,State - MANIPUR,Urban,16,Non-Technical Diploma,0,0,0
26344,14,State - MANIPUR,Urban,17,Non-Technical Diploma,0,0,0
26345,14,State - MANIPUR,Urban,18,Non-Technical Diploma,10,3,13
26346,14,State - MANIPUR,Urban,19,Non-Technical Diploma,7,4,11
26347,14,State - MANIPUR,Urban,20-24,Non-Technical Diploma,49,33,82
26348,14,State - MANIPUR,Urban,25-29,Non-Technical Diploma,32,26,58
26349,14,State - MANIPUR,Urban,30-34,Non-Technical Diploma,24,11,35
26350,14,State - MANIPUR,Urban,35-39,Non-Technical Diploma,12,4,16
26351,14,State - MANIPUR,Urban,40-44,Non-Technical Diploma,19,7,26
26352,14,State - MANIPUR,Urban,45-49,Non-Technical Diploma,14,6,20
26353,14,State - MANIPUR,Urban,50-54,Non-Technical Diploma,28,5,33
26354,14,State - MANIPUR,Urban,55-59,Non-Technical Diploma,22,3,25
26355,14,State - MANIPUR,Urban,60-64,Non-Technical Diploma,3,0,3
26356,14,State - MANIPUR,Urban,65-69,Non-Technical Diploma,3,0,3
26357,14,State - MANIPUR,Urban,70-74,Non-Technical Diploma,0,0,0
26358,14,State - MANIPUR,Urban,75-79,Non-Technical Diploma,3,1,4
26359,14,State - MANIPUR,Urban,80+,Non-Technical Diploma,4,0,4
26360,14,State - MANIPUR,Urban,Age not stated,Non-Technical Diploma,2,0,2
26361,15,State - MIZORAM,Total,All ages,Non-Technical Diploma,103,89,192
26362,15,State - MIZORAM,Total,0-6,Non-Technical Diploma,0,0,0
26363,15,State - MIZORAM,Total,7,Non-Technical Diploma,0,0,0
26364,15,State - MIZORAM,Total,8,Non-Technical Diploma,0,0,0
26365,15,State - MIZORAM,Total,9,Non-Technical Diploma,0,0,0
26366,15,State - MIZORAM,Total,10,Non-Technical Diploma,0,0,0
26367,15,State - MIZORAM,Total,11,Non-Technical Diploma,0,0,0
26368,15,State - MIZORAM,Total,12,Non-Technical Diploma,0,0,0
26369,15,State - MIZORAM,Total,13,Non-Technical Diploma,0,0,0
26370,15,State - MIZORAM,Total,14,Non-Technical Diploma,0,0,0
26371,15,State - MIZORAM,Total,15,Non-Technical Diploma,0,0,0
26372,15,State - MIZORAM,Total,16,Non-Technical Diploma,0,0,0
26373,15,State - MIZORAM,Total,17,Non-Technical Diploma,0,0,0
26374,15,State - MIZORAM,Total,18,Non-Technical Diploma,2,3,5
26375,15,State - MIZORAM,Total,19,Non-Technical Diploma,5,12,17
26376,15,State - MIZORAM,Total,20-24,Non-Technical Diploma,30,34,64
26377,15,State - MIZORAM,Total,25-29,Non-Technical Diploma,18,15,33
26378,15,State - MIZORAM,Total,30-34,Non-Technical Diploma,6,5,11
26379,15,State - MIZORAM,Total,35-39,Non-Technical Diploma,5,4,9
26380,15,State - MIZORAM,Total,40-44,Non-Technical Diploma,8,4,12
26381,15,State - MIZORAM,Total,45-49,Non-Technical Diploma,7,5,12
26382,15,State - MIZORAM,Total,50-54,Non-Technical Diploma,11,1,12
26383,15,State - MIZORAM,Total,55-59,Non-Technical Diploma,2,3,5
26384,15,State - MIZORAM,Total,60-64,Non-Technical Diploma,1,0,1
26385,15,State - MIZORAM,Total,65-69,Non-Technical Diploma,1,1,2
26386,15,State - MIZORAM,Total,70-74,Non-Technical Diploma,2,1,3
26387,15,State - MIZORAM,Total,75-79,Non-Technical Diploma,1,0,1
26388,15,State - MIZORAM,Total,80+,Non-Technical Diploma,4,1,5
26389,15,State - MIZORAM,Total,Age not stated,Non-Technical Diploma,0,0,0
26390,15,State - MIZORAM,Rural,All ages,Non-Technical Diploma,17,15,32
26391,15,State - MIZORAM,Rural,0-6,Non-Technical Diploma,0,0,0
26392,15,State - MIZORAM,Rural,7,Non-Technical Diploma,0,0,0
26393,15,State - MIZORAM,Rural,8,Non-Technical Diploma,0,0,0
26394,15,State - MIZORAM,Rural,9,Non-Technical Diploma,0,0,0
26395,15,State - MIZORAM,Rural,10,Non-Technical Diploma,0,0,0
26396,15,State - MIZORAM,Rural,11,Non-Technical Diploma,0,0,0
26397,15,State - MIZORAM,Rural,12,Non-Technical Diploma,0,0,0
26398,15,State - MIZORAM,Rural,13,Non-Technical Diploma,0,0,0
26399,15,State - MIZORAM,Rural,14,Non-Technical Diploma,0,0,0
26400,15,State - MIZORAM,Rural,15,Non-Technical Diploma,0,0,0
26401,15,State - MIZORAM,Rural,16,Non-Technical Diploma,0,0,0
26402,15,State - MIZORAM,Rural,17,Non-Technical Diploma,0,0,0
26403,15,State - MIZORAM,Rural,18,Non-Technical Diploma,0,2,2
26404,15,State - MIZORAM,Rural,19,Non-Technical Diploma,1,4,5
26405,15,State - MIZORAM,Rural,20-24,Non-Technical Diploma,4,4,8
26406,15,State - MIZORAM,Rural,25-29,Non-Technical Diploma,3,1,4
26407,15,State - MIZORAM,Rural,30-34,Non-Technical Diploma,2,1,3
26408,15,State - MIZORAM,Rural,35-39,Non-Technical Diploma,0,1,1
26409,15,State - MIZORAM,Rural,40-44,Non-Technical Diploma,3,1,4
26410,15,State - MIZORAM,Rural,45-49,Non-Technical Diploma,1,1,2
26411,15,State - MIZORAM,Rural,50-54,Non-Technical Diploma,1,0,1
26412,15,State - MIZORAM,Rural,55-59,Non-Technical Diploma,0,0,0
26413,15,State - MIZORAM,Rural,60-64,Non-Technical Diploma,0,0,0
26414,15,State - MIZORAM,Rural,65-69,Non-Technical Diploma,1,0,1
26415,15,State - MIZORAM,Rural,70-74,Non-Technical Diploma,0,0,0
26416,15,State - MIZORAM,Rural,75-79,Non-Technical Diploma,0,0,0
26417,15,State - MIZORAM,Rural,80+,Non-Technical Diploma,1,0,1
26418,15,State - MIZORAM,Rural,Age not stated,Non-Technical Diploma,0,0,0
26419,15,State - MIZORAM,Urban,All ages,Non-Technical Diploma,86,74,160
26420,15,State - MIZORAM,Urban,0-6,Non-Technical Diploma,0,0,0
26421,15,State - MIZORAM,Urban,7,Non-Technical Diploma,0,0,0
26422,15,State - MIZORAM,Urban,8,Non-Technical Diploma,0,0,0
26423,15,State - MIZORAM,Urban,9,Non-Technical Diploma,0,0,0
26424,15,State - MIZORAM,Urban,10,Non-Technical Diploma,0,0,0
26425,15,State - MIZORAM,Urban,11,Non-Technical Diploma,0,0,0
26426,15,State - MIZORAM,Urban,12,Non-Technical Diploma,0,0,0
26427,15,State - MIZORAM,Urban,13,Non-Technical Diploma,0,0,0
26428,15,State - MIZORAM,Urban,14,Non-Technical Diploma,0,0,0
26429,15,State - MIZORAM,Urban,15,Non-Technical Diploma,0,0,0
26430,15,State - MIZORAM,Urban,16,Non-Technical Diploma,0,0,0
26431,15,State - MIZORAM,Urban,17,Non-Technical Diploma,0,0,0
26432,15,State - MIZORAM,Urban,18,Non-Technical Diploma,2,1,3
26433,15,State - MIZORAM,Urban,19,Non-Technical Diploma,4,8,12
26434,15,State - MIZORAM,Urban,20-24,Non-Technical Diploma,26,30,56
26435,15,State - MIZORAM,Urban,25-29,Non-Technical Diploma,15,14,29
26436,15,State - MIZORAM,Urban,30-34,Non-Technical Diploma,4,4,8
26437,15,State - MIZORAM,Urban,35-39,Non-Technical Diploma,5,3,8
26438,15,State - MIZORAM,Urban,40-44,Non-Technical Diploma,5,3,8
26439,15,State - MIZORAM,Urban,45-49,Non-Technical Diploma,6,4,10
26440,15,State - MIZORAM,Urban,50-54,Non-Technical Diploma,10,1,11
26441,15,State - MIZORAM,Urban,55-59,Non-Technical Diploma,2,3,5
26442,15,State - MIZORAM,Urban,60-64,Non-Technical Diploma,1,0,1
26443,15,State - MIZORAM,Urban,65-69,Non-Technical Diploma,0,1,1
26444,15,State - MIZORAM,Urban,70-74,Non-Technical Diploma,2,1,3
26445,15,State - MIZORAM,Urban,75-79,Non-Technical Diploma,1,0,1
26446,15,State - MIZORAM,Urban,80+,Non-Technical Diploma,3,1,4
26447,15,State - MIZORAM,Urban,Age not stated,Non-Technical Diploma,0,0,0
26448,16,State - TRIPURA,Total,All ages,Non-Technical Diploma,320,94,414
26449,16,State - TRIPURA,Total,0-6,Non-Technical Diploma,0,0,0
26450,16,State - TRIPURA,Total,7,Non-Technical Diploma,0,0,0
26451,16,State - TRIPURA,Total,8,Non-Technical Diploma,0,0,0
26452,16,State - TRIPURA,Total,9,Non-Technical Diploma,0,0,0
26453,16,State - TRIPURA,Total,10,Non-Technical Diploma,0,0,0
26454,16,State - TRIPURA,Total,11,Non-Technical Diploma,0,0,0
26455,16,State - TRIPURA,Total,12,Non-Technical Diploma,0,0,0
26456,16,State - TRIPURA,Total,13,Non-Technical Diploma,0,0,0
26457,16,State - TRIPURA,Total,14,Non-Technical Diploma,0,0,0
26458,16,State - TRIPURA,Total,15,Non-Technical Diploma,0,0,0
26459,16,State - TRIPURA,Total,16,Non-Technical Diploma,0,0,0
26460,16,State - TRIPURA,Total,17,Non-Technical Diploma,0,0,0
26461,16,State - TRIPURA,Total,18,Non-Technical Diploma,7,5,12
26462,16,State - TRIPURA,Total,19,Non-Technical Diploma,10,11,21
26463,16,State - TRIPURA,Total,20-24,Non-Technical Diploma,79,37,116
26464,16,State - TRIPURA,Total,25-29,Non-Technical Diploma,55,22,77
26465,16,State - TRIPURA,Total,30-34,Non-Technical Diploma,48,6,54
26466,16,State - TRIPURA,Total,35-39,Non-Technical Diploma,30,5,35
26467,16,State - TRIPURA,Total,40-44,Non-Technical Diploma,25,1,26
26468,16,State - TRIPURA,Total,45-49,Non-Technical Diploma,18,1,19
26469,16,State - TRIPURA,Total,50-54,Non-Technical Diploma,22,1,23
26470,16,State - TRIPURA,Total,55-59,Non-Technical Diploma,10,1,11
26471,16,State - TRIPURA,Total,60-64,Non-Technical Diploma,10,1,11
26472,16,State - TRIPURA,Total,65-69,Non-Technical Diploma,2,2,4
26473,16,State - TRIPURA,Total,70-74,Non-Technical Diploma,1,0,1
26474,16,State - TRIPURA,Total,75-79,Non-Technical Diploma,3,0,3
26475,16,State - TRIPURA,Total,80+,Non-Technical Diploma,0,0,0
26476,16,State - TRIPURA,Total,Age not stated,Non-Technical Diploma,0,1,1
26477,16,State - TRIPURA,Rural,All ages,Non-Technical Diploma,89,32,121
26478,16,State - TRIPURA,Rural,0-6,Non-Technical Diploma,0,0,0
26479,16,State - TRIPURA,Rural,7,Non-Technical Diploma,0,0,0
26480,16,State - TRIPURA,Rural,8,Non-Technical Diploma,0,0,0
26481,16,State - TRIPURA,Rural,9,Non-Technical Diploma,0,0,0
26482,16,State - TRIPURA,Rural,10,Non-Technical Diploma,0,0,0
26483,16,State - TRIPURA,Rural,11,Non-Technical Diploma,0,0,0
26484,16,State - TRIPURA,Rural,12,Non-Technical Diploma,0,0,0
26485,16,State - TRIPURA,Rural,13,Non-Technical Diploma,0,0,0
26486,16,State - TRIPURA,Rural,14,Non-Technical Diploma,0,0,0
26487,16,State - TRIPURA,Rural,15,Non-Technical Diploma,0,0,0
26488,16,State - TRIPURA,Rural,16,Non-Technical Diploma,0,0,0
26489,16,State - TRIPURA,Rural,17,Non-Technical Diploma,0,0,0
26490,16,State - TRIPURA,Rural,18,Non-Technical Diploma,2,0,2
26491,16,State - TRIPURA,Rural,19,Non-Technical Diploma,4,4,8
26492,16,State - TRIPURA,Rural,20-24,Non-Technical Diploma,26,14,40
26493,16,State - TRIPURA,Rural,25-29,Non-Technical Diploma,22,10,32
26494,16,State - TRIPURA,Rural,30-34,Non-Technical Diploma,11,0,11
26495,16,State - TRIPURA,Rural,35-39,Non-Technical Diploma,8,1,9
26496,16,State - TRIPURA,Rural,40-44,Non-Technical Diploma,11,0,11
26497,16,State - TRIPURA,Rural,45-49,Non-Technical Diploma,1,1,2
26498,16,State - TRIPURA,Rural,50-54,Non-Technical Diploma,0,0,0
26499,16,State - TRIPURA,Rural,55-59,Non-Technical Diploma,1,0,1
26500,16,State - TRIPURA,Rural,60-64,Non-Technical Diploma,1,1,2
26501,16,State - TRIPURA,Rural,65-69,Non-Technical Diploma,2,1,3
26502,16,State - TRIPURA,Rural,70-74,Non-Technical Diploma,0,0,0
26503,16,State - TRIPURA,Rural,75-79,Non-Technical Diploma,0,0,0
26504,16,State - TRIPURA,Rural,80+,Non-Technical Diploma,0,0,0
26505,16,State - TRIPURA,Rural,Age not stated,Non-Technical Diploma,0,0,0
26506,16,State - TRIPURA,Urban,All ages,Non-Technical Diploma,231,62,293
26507,16,State - TRIPURA,Urban,0-6,Non-Technical Diploma,0,0,0
26508,16,State - TRIPURA,Urban,7,Non-Technical Diploma,0,0,0
26509,16,State - TRIPURA,Urban,8,Non-Technical Diploma,0,0,0
26510,16,State - TRIPURA,Urban,9,Non-Technical Diploma,0,0,0
26511,16,State - TRIPURA,Urban,10,Non-Technical Diploma,0,0,0
26512,16,State - TRIPURA,Urban,11,Non-Technical Diploma,0,0,0
26513,16,State - TRIPURA,Urban,12,Non-Technical Diploma,0,0,0
26514,16,State - TRIPURA,Urban,13,Non-Technical Diploma,0,0,0
26515,16,State - TRIPURA,Urban,14,Non-Technical Diploma,0,0,0
26516,16,State - TRIPURA,Urban,15,Non-Technical Diploma,0,0,0
26517,16,State - TRIPURA,Urban,16,Non-Technical Diploma,0,0,0
26518,16,State - TRIPURA,Urban,17,Non-Technical Diploma,0,0,0
26519,16,State - TRIPURA,Urban,18,Non-Technical Diploma,5,5,10
26520,16,State - TRIPURA,Urban,19,Non-Technical Diploma,6,7,13
26521,16,State - TRIPURA,Urban,20-24,Non-Technical Diploma,53,23,76
26522,16,State - TRIPURA,Urban,25-29,Non-Technical Diploma,33,12,45
26523,16,State - TRIPURA,Urban,30-34,Non-Technical Diploma,37,6,43
26524,16,State - TRIPURA,Urban,35-39,Non-Technical Diploma,22,4,26
26525,16,State - TRIPURA,Urban,40-44,Non-Technical Diploma,14,1,15
26526,16,State - TRIPURA,Urban,45-49,Non-Technical Diploma,17,0,17
26527,16,State - TRIPURA,Urban,50-54,Non-Technical Diploma,22,1,23
26528,16,State - TRIPURA,Urban,55-59,Non-Technical Diploma,9,1,10
26529,16,State - TRIPURA,Urban,60-64,Non-Technical Diploma,9,0,9
26530,16,State - TRIPURA,Urban,65-69,Non-Technical Diploma,0,1,1
26531,16,State - TRIPURA,Urban,70-74,Non-Technical Diploma,1,0,1
26532,16,State - TRIPURA,Urban,75-79,Non-Technical Diploma,3,0,3
26533,16,State - TRIPURA,Urban,80+,Non-Technical Diploma,0,0,0
26534,16,State - TRIPURA,Urban,Age not stated,Non-Technical Diploma,0,1,1
26535,17,State - MEGHALAYA,Total,All ages,Non-Technical Diploma,130,64,194
26536,17,State - MEGHALAYA,Total,0-6,Non-Technical Diploma,0,0,0
26537,17,State - MEGHALAYA,Total,7,Non-Technical Diploma,0,0,0
26538,17,State - MEGHALAYA,Total,8,Non-Technical Diploma,0,0,0
26539,17,State - MEGHALAYA,Total,9,Non-Technical Diploma,0,0,0
26540,17,State - MEGHALAYA,Total,10,Non-Technical Diploma,0,0,0
26541,17,State - MEGHALAYA,Total,11,Non-Technical Diploma,0,0,0
26542,17,State - MEGHALAYA,Total,12,Non-Technical Diploma,0,0,0
26543,17,State - MEGHALAYA,Total,13,Non-Technical Diploma,0,0,0
26544,17,State - MEGHALAYA,Total,14,Non-Technical Diploma,0,0,0
26545,17,State - MEGHALAYA,Total,15,Non-Technical Diploma,0,0,0
26546,17,State - MEGHALAYA,Total,16,Non-Technical Diploma,0,0,0
26547,17,State - MEGHALAYA,Total,17,Non-Technical Diploma,0,0,0
26548,17,State - MEGHALAYA,Total,18,Non-Technical Diploma,5,1,6
26549,17,State - MEGHALAYA,Total,19,Non-Technical Diploma,2,4,6
26550,17,State - MEGHALAYA,Total,20-24,Non-Technical Diploma,28,19,47
26551,17,State - MEGHALAYA,Total,25-29,Non-Technical Diploma,26,21,47
26552,17,State - MEGHALAYA,Total,30-34,Non-Technical Diploma,18,2,20
26553,17,State - MEGHALAYA,Total,35-39,Non-Technical Diploma,11,2,13
26554,17,State - MEGHALAYA,Total,40-44,Non-Technical Diploma,12,6,18
26555,17,State - MEGHALAYA,Total,45-49,Non-Technical Diploma,7,2,9
26556,17,State - MEGHALAYA,Total,50-54,Non-Technical Diploma,8,4,12
26557,17,State - MEGHALAYA,Total,55-59,Non-Technical Diploma,6,3,9
26558,17,State - MEGHALAYA,Total,60-64,Non-Technical Diploma,2,0,2
26559,17,State - MEGHALAYA,Total,65-69,Non-Technical Diploma,3,0,3
26560,17,State - MEGHALAYA,Total,70-74,Non-Technical Diploma,0,0,0
26561,17,State - MEGHALAYA,Total,75-79,Non-Technical Diploma,1,0,1
26562,17,State - MEGHALAYA,Total,80+,Non-Technical Diploma,1,0,1
26563,17,State - MEGHALAYA,Total,Age not stated,Non-Technical Diploma,0,0,0
26564,17,State - MEGHALAYA,Rural,All ages,Non-Technical Diploma,60,14,74
26565,17,State - MEGHALAYA,Rural,0-6,Non-Technical Diploma,0,0,0
26566,17,State - MEGHALAYA,Rural,7,Non-Technical Diploma,0,0,0
26567,17,State - MEGHALAYA,Rural,8,Non-Technical Diploma,0,0,0
26568,17,State - MEGHALAYA,Rural,9,Non-Technical Diploma,0,0,0
26569,17,State - MEGHALAYA,Rural,10,Non-Technical Diploma,0,0,0
26570,17,State - MEGHALAYA,Rural,11,Non-Technical Diploma,0,0,0
26571,17,State - MEGHALAYA,Rural,12,Non-Technical Diploma,0,0,0
26572,17,State - MEGHALAYA,Rural,13,Non-Technical Diploma,0,0,0
26573,17,State - MEGHALAYA,Rural,14,Non-Technical Diploma,0,0,0
26574,17,State - MEGHALAYA,Rural,15,Non-Technical Diploma,0,0,0
26575,17,State - MEGHALAYA,Rural,16,Non-Technical Diploma,0,0,0
26576,17,State - MEGHALAYA,Rural,17,Non-Technical Diploma,0,0,0
26577,17,State - MEGHALAYA,Rural,18,Non-Technical Diploma,2,1,3
26578,17,State - MEGHALAYA,Rural,19,Non-Technical Diploma,0,1,1
26579,17,State - MEGHALAYA,Rural,20-24,Non-Technical Diploma,14,6,20
26580,17,State - MEGHALAYA,Rural,25-29,Non-Technical Diploma,12,5,17
26581,17,State - MEGHALAYA,Rural,30-34,Non-Technical Diploma,8,0,8
26582,17,State - MEGHALAYA,Rural,35-39,Non-Technical Diploma,7,0,7
26583,17,State - MEGHALAYA,Rural,40-44,Non-Technical Diploma,5,1,6
26584,17,State - MEGHALAYA,Rural,45-49,Non-Technical Diploma,4,0,4
26585,17,State - MEGHALAYA,Rural,50-54,Non-Technical Diploma,4,0,4
26586,17,State - MEGHALAYA,Rural,55-59,Non-Technical Diploma,2,0,2
26587,17,State - MEGHALAYA,Rural,60-64,Non-Technical Diploma,2,0,2
26588,17,State - MEGHALAYA,Rural,65-69,Non-Technical Diploma,0,0,0
26589,17,State - MEGHALAYA,Rural,70-74,Non-Technical Diploma,0,0,0
26590,17,State - MEGHALAYA,Rural,75-79,Non-Technical Diploma,0,0,0
26591,17,State - MEGHALAYA,Rural,80+,Non-Technical Diploma,0,0,0
26592,17,State - MEGHALAYA,Rural,Age not stated,Non-Technical Diploma,0,0,0
26593,17,State - MEGHALAYA,Urban,All ages,Non-Technical Diploma,70,50,120
26594,17,State - MEGHALAYA,Urban,0-6,Non-Technical Diploma,0,0,0
26595,17,State - MEGHALAYA,Urban,7,Non-Technical Diploma,0,0,0
26596,17,State - MEGHALAYA,Urban,8,Non-Technical Diploma,0,0,0
26597,17,State - MEGHALAYA,Urban,9,Non-Technical Diploma,0,0,0
26598,17,State - MEGHALAYA,Urban,10,Non-Technical Diploma,0,0,0
26599,17,State - MEGHALAYA,Urban,11,Non-Technical Diploma,0,0,0
26600,17,State - MEGHALAYA,Urban,12,Non-Technical Diploma,0,0,0
26601,17,State - MEGHALAYA,Urban,13,Non-Technical Diploma,0,0,0
26602,17,State - MEGHALAYA,Urban,14,Non-Technical Diploma,0,0,0
26603,17,State - MEGHALAYA,Urban,15,Non-Technical Diploma,0,0,0
26604,17,State - MEGHALAYA,Urban,16,Non-Technical Diploma,0,0,0
26605,17,State - MEGHALAYA,Urban,17,Non-Technical Diploma,0,0,0
26606,17,State - MEGHALAYA,Urban,18,Non-Technical Diploma,3,0,3
26607,17,State - MEGHALAYA,Urban,19,Non-Technical Diploma,2,3,5
26608,17,State - MEGHALAYA,Urban,20-24,Non-Technical Diploma,14,13,27
26609,17,State - MEGHALAYA,Urban,25-29,Non-Technical Diploma,14,16,30
26610,17,State - MEGHALAYA,Urban,30-34,Non-Technical Diploma,10,2,12
26611,17,State - MEGHALAYA,Urban,35-39,Non-Technical Diploma,4,2,6
26612,17,State - MEGHALAYA,Urban,40-44,Non-Technical Diploma,7,5,12
26613,17,State - MEGHALAYA,Urban,45-49,Non-Technical Diploma,3,2,5
26614,17,State - MEGHALAYA,Urban,50-54,Non-Technical Diploma,4,4,8
26615,17,State - MEGHALAYA,Urban,55-59,Non-Technical Diploma,4,3,7
26616,17,State - MEGHALAYA,Urban,60-64,Non-Technical Diploma,0,0,0
26617,17,State - MEGHALAYA,Urban,65-69,Non-Technical Diploma,3,0,3
26618,17,State - MEGHALAYA,Urban,70-74,Non-Technical Diploma,0,0,0
26619,17,State - MEGHALAYA,Urban,75-79,Non-Technical Diploma,1,0,1
26620,17,State - MEGHALAYA,Urban,80+,Non-Technical Diploma,1,0,1
26621,17,State - MEGHALAYA,Urban,Age not stated,Non-Technical Diploma,0,0,0
26622,18,State - ASSAM,Total,All ages,Non-Technical Diploma,3106,577,3683
26623,18,State - ASSAM,Total,0-6,Non-Technical Diploma,0,0,0
26624,18,State - ASSAM,Total,7,Non-Technical Diploma,0,0,0
26625,18,State - ASSAM,Total,8,Non-Technical Diploma,0,0,0
26626,18,State - ASSAM,Total,9,Non-Technical Diploma,0,0,0
26627,18,State - ASSAM,Total,10,Non-Technical Diploma,0,0,0
26628,18,State - ASSAM,Total,11,Non-Technical Diploma,0,0,0
26629,18,State - ASSAM,Total,12,Non-Technical Diploma,0,0,0
26630,18,State - ASSAM,Total,13,Non-Technical Diploma,0,0,0
26631,18,State - ASSAM,Total,14,Non-Technical Diploma,0,0,0
26632,18,State - ASSAM,Total,15,Non-Technical Diploma,0,0,0
26633,18,State - ASSAM,Total,16,Non-Technical Diploma,0,0,0
26634,18,State - ASSAM,Total,17,Non-Technical Diploma,0,0,0
26635,18,State - ASSAM,Total,18,Non-Technical Diploma,143,27,170
26636,18,State - ASSAM,Total,19,Non-Technical Diploma,117,24,141
26637,18,State - ASSAM,Total,20-24,Non-Technical Diploma,609,144,753
26638,18,State - ASSAM,Total,25-29,Non-Technical Diploma,503,111,614
26639,18,State - ASSAM,Total,30-34,Non-Technical Diploma,280,58,338
26640,18,State - ASSAM,Total,35-39,Non-Technical Diploma,281,56,337
26641,18,State - ASSAM,Total,40-44,Non-Technical Diploma,298,60,358
26642,18,State - ASSAM,Total,45-49,Non-Technical Diploma,198,36,234
26643,18,State - ASSAM,Total,50-54,Non-Technical Diploma,192,16,208
26644,18,State - ASSAM,Total,55-59,Non-Technical Diploma,151,16,167
26645,18,State - ASSAM,Total,60-64,Non-Technical Diploma,111,11,122
26646,18,State - ASSAM,Total,65-69,Non-Technical Diploma,73,11,84
26647,18,State - ASSAM,Total,70-74,Non-Technical Diploma,64,1,65
26648,18,State - ASSAM,Total,75-79,Non-Technical Diploma,42,5,47
26649,18,State - ASSAM,Total,80+,Non-Technical Diploma,41,1,42
26650,18,State - ASSAM,Total,Age not stated,Non-Technical Diploma,3,0,3
26651,18,State - ASSAM,Rural,All ages,Non-Technical Diploma,2270,301,2571
26652,18,State - ASSAM,Rural,0-6,Non-Technical Diploma,0,0,0
26653,18,State - ASSAM,Rural,7,Non-Technical Diploma,0,0,0
26654,18,State - ASSAM,Rural,8,Non-Technical Diploma,0,0,0
26655,18,State - ASSAM,Rural,9,Non-Technical Diploma,0,0,0
26656,18,State - ASSAM,Rural,10,Non-Technical Diploma,0,0,0
26657,18,State - ASSAM,Rural,11,Non-Technical Diploma,0,0,0
26658,18,State - ASSAM,Rural,12,Non-Technical Diploma,0,0,0
26659,18,State - ASSAM,Rural,13,Non-Technical Diploma,0,0,0
26660,18,State - ASSAM,Rural,14,Non-Technical Diploma,0,0,0
26661,18,State - ASSAM,Rural,15,Non-Technical Diploma,0,0,0
26662,18,State - ASSAM,Rural,16,Non-Technical Diploma,0,0,0
26663,18,State - ASSAM,Rural,17,Non-Technical Diploma,0,0,0
26664,18,State - ASSAM,Rural,18,Non-Technical Diploma,128,24,152
26665,18,State - ASSAM,Rural,19,Non-Technical Diploma,98,19,117
26666,18,State - ASSAM,Rural,20-24,Non-Technical Diploma,503,73,576
26667,18,State - ASSAM,Rural,25-29,Non-Technical Diploma,393,57,450
26668,18,State - ASSAM,Rural,30-34,Non-Technical Diploma,204,34,238
26669,18,State - ASSAM,Rural,35-39,Non-Technical Diploma,221,35,256
26670,18,State - ASSAM,Rural,40-44,Non-Technical Diploma,186,20,206
26671,18,State - ASSAM,Rural,45-49,Non-Technical Diploma,126,13,139
26672,18,State - ASSAM,Rural,50-54,Non-Technical Diploma,103,8,111
26673,18,State - ASSAM,Rural,55-59,Non-Technical Diploma,88,7,95
26674,18,State - ASSAM,Rural,60-64,Non-Technical Diploma,70,5,75
26675,18,State - ASSAM,Rural,65-69,Non-Technical Diploma,46,4,50
26676,18,State - ASSAM,Rural,70-74,Non-Technical Diploma,42,1,43
26677,18,State - ASSAM,Rural,75-79,Non-Technical Diploma,29,1,30
26678,18,State - ASSAM,Rural,80+,Non-Technical Diploma,30,0,30
26679,18,State - ASSAM,Rural,Age not stated,Non-Technical Diploma,3,0,3
26680,18,State - ASSAM,Urban,All ages,Non-Technical Diploma,836,276,1112
26681,18,State - ASSAM,Urban,0-6,Non-Technical Diploma,0,0,0
26682,18,State - ASSAM,Urban,7,Non-Technical Diploma,0,0,0
26683,18,State - ASSAM,Urban,8,Non-Technical Diploma,0,0,0
26684,18,State - ASSAM,Urban,9,Non-Technical Diploma,0,0,0
26685,18,State - ASSAM,Urban,10,Non-Technical Diploma,0,0,0
26686,18,State - ASSAM,Urban,11,Non-Technical Diploma,0,0,0
26687,18,State - ASSAM,Urban,12,Non-Technical Diploma,0,0,0
26688,18,State - ASSAM,Urban,13,Non-Technical Diploma,0,0,0
26689,18,State - ASSAM,Urban,14,Non-Technical Diploma,0,0,0
26690,18,State - ASSAM,Urban,15,Non-Technical Diploma,0,0,0
26691,18,State - ASSAM,Urban,16,Non-Technical Diploma,0,0,0
26692,18,State - ASSAM,Urban,17,Non-Technical Diploma,0,0,0
26693,18,State - ASSAM,Urban,18,Non-Technical Diploma,15,3,18
26694,18,State - ASSAM,Urban,19,Non-Technical Diploma,19,5,24
26695,18,State - ASSAM,Urban,20-24,Non-Technical Diploma,106,71,177
26696,18,State - ASSAM,Urban,25-29,Non-Technical Diploma,110,54,164
26697,18,State - ASSAM,Urban,30-34,Non-Technical Diploma,76,24,100
26698,18,State - ASSAM,Urban,35-39,Non-Technical Diploma,60,21,81
26699,18,State - ASSAM,Urban,40-44,Non-Technical Diploma,112,40,152
26700,18,State - ASSAM,Urban,45-49,Non-Technical Diploma,72,23,95
26701,18,State - ASSAM,Urban,50-54,Non-Technical Diploma,89,8,97
26702,18,State - ASSAM,Urban,55-59,Non-Technical Diploma,63,9,72
26703,18,State - ASSAM,Urban,60-64,Non-Technical Diploma,41,6,47
26704,18,State - ASSAM,Urban,65-69,Non-Technical Diploma,27,7,34
26705,18,State - ASSAM,Urban,70-74,Non-Technical Diploma,22,0,22
26706,18,State - ASSAM,Urban,75-79,Non-Technical Diploma,13,4,17
26707,18,State - ASSAM,Urban,80+,Non-Technical Diploma,11,1,12
26708,18,State - ASSAM,Urban,Age not stated,Non-Technical Diploma,0,0,0
26709,19,State - WEST BENGAL,Total,All ages,Non-Technical Diploma,15236,4891,20127
26710,19,State - WEST BENGAL,Total,0-6,Non-Technical Diploma,0,0,0
26711,19,State - WEST BENGAL,Total,7,Non-Technical Diploma,0,0,0
26712,19,State - WEST BENGAL,Total,8,Non-Technical Diploma,0,0,0
26713,19,State - WEST BENGAL,Total,9,Non-Technical Diploma,0,0,0
26714,19,State - WEST BENGAL,Total,10,Non-Technical Diploma,0,0,0
26715,19,State - WEST BENGAL,Total,11,Non-Technical Diploma,0,0,0
26716,19,State - WEST BENGAL,Total,12,Non-Technical Diploma,0,0,0
26717,19,State - WEST BENGAL,Total,13,Non-Technical Diploma,0,0,0
26718,19,State - WEST BENGAL,Total,14,Non-Technical Diploma,0,0,0
26719,19,State - WEST BENGAL,Total,15,Non-Technical Diploma,0,0,0
26720,19,State - WEST BENGAL,Total,16,Non-Technical Diploma,0,0,0
26721,19,State - WEST BENGAL,Total,17,Non-Technical Diploma,0,0,0
26722,19,State - WEST BENGAL,Total,18,Non-Technical Diploma,489,228,717
26723,19,State - WEST BENGAL,Total,19,Non-Technical Diploma,484,217,701
26724,19,State - WEST BENGAL,Total,20-24,Non-Technical Diploma,3122,1399,4521
26725,19,State - WEST BENGAL,Total,25-29,Non-Technical Diploma,2111,853,2964
26726,19,State - WEST BENGAL,Total,30-34,Non-Technical Diploma,1589,509,2098
26727,19,State - WEST BENGAL,Total,35-39,Non-Technical Diploma,1297,391,1688
26728,19,State - WEST BENGAL,Total,40-44,Non-Technical Diploma,1178,320,1498
26729,19,State - WEST BENGAL,Total,45-49,Non-Technical Diploma,1085,242,1327
26730,19,State - WEST BENGAL,Total,50-54,Non-Technical Diploma,894,200,1094
26731,19,State - WEST BENGAL,Total,55-59,Non-Technical Diploma,702,151,853
26732,19,State - WEST BENGAL,Total,60-64,Non-Technical Diploma,696,131,827
26733,19,State - WEST BENGAL,Total,65-69,Non-Technical Diploma,609,86,695
26734,19,State - WEST BENGAL,Total,70-74,Non-Technical Diploma,486,72,558
26735,19,State - WEST BENGAL,Total,75-79,Non-Technical Diploma,242,36,278
26736,19,State - WEST BENGAL,Total,80+,Non-Technical Diploma,229,46,275
26737,19,State - WEST BENGAL,Total,Age not stated,Non-Technical Diploma,23,10,33
26738,19,State - WEST BENGAL,Rural,All ages,Non-Technical Diploma,7156,1350,8506
26739,19,State - WEST BENGAL,Rural,0-6,Non-Technical Diploma,0,0,0
26740,19,State - WEST BENGAL,Rural,7,Non-Technical Diploma,0,0,0
26741,19,State - WEST BENGAL,Rural,8,Non-Technical Diploma,0,0,0
26742,19,State - WEST BENGAL,Rural,9,Non-Technical Diploma,0,0,0
26743,19,State - WEST BENGAL,Rural,10,Non-Technical Diploma,0,0,0
26744,19,State - WEST BENGAL,Rural,11,Non-Technical Diploma,0,0,0
26745,19,State - WEST BENGAL,Rural,12,Non-Technical Diploma,0,0,0
26746,19,State - WEST BENGAL,Rural,13,Non-Technical Diploma,0,0,0
26747,19,State - WEST BENGAL,Rural,14,Non-Technical Diploma,0,0,0
26748,19,State - WEST BENGAL,Rural,15,Non-Technical Diploma,0,0,0
26749,19,State - WEST BENGAL,Rural,16,Non-Technical Diploma,0,0,0
26750,19,State - WEST BENGAL,Rural,17,Non-Technical Diploma,0,0,0
26751,19,State - WEST BENGAL,Rural,18,Non-Technical Diploma,345,115,460
26752,19,State - WEST BENGAL,Rural,19,Non-Technical Diploma,304,98,402
26753,19,State - WEST BENGAL,Rural,20-24,Non-Technical Diploma,1619,395,2014
26754,19,State - WEST BENGAL,Rural,25-29,Non-Technical Diploma,1049,197,1246
26755,19,State - WEST BENGAL,Rural,30-34,Non-Technical Diploma,802,144,946
26756,19,State - WEST BENGAL,Rural,35-39,Non-Technical Diploma,612,111,723
26757,19,State - WEST BENGAL,Rural,40-44,Non-Technical Diploma,535,83,618
26758,19,State - WEST BENGAL,Rural,45-49,Non-Technical Diploma,457,61,518
26759,19,State - WEST BENGAL,Rural,50-54,Non-Technical Diploma,352,41,393
26760,19,State - WEST BENGAL,Rural,55-59,Non-Technical Diploma,303,42,345
26761,19,State - WEST BENGAL,Rural,60-64,Non-Technical Diploma,267,29,296
26762,19,State - WEST BENGAL,Rural,65-69,Non-Technical Diploma,217,18,235
26763,19,State - WEST BENGAL,Rural,70-74,Non-Technical Diploma,157,9,166
26764,19,State - WEST BENGAL,Rural,75-79,Non-Technical Diploma,58,4,62
26765,19,State - WEST BENGAL,Rural,80+,Non-Technical Diploma,73,2,75
26766,19,State - WEST BENGAL,Rural,Age not stated,Non-Technical Diploma,6,1,7
26767,19,State - WEST BENGAL,Urban,All ages,Non-Technical Diploma,8080,3541,11621
26768,19,State - WEST BENGAL,Urban,0-6,Non-Technical Diploma,0,0,0
26769,19,State - WEST BENGAL,Urban,7,Non-Technical Diploma,0,0,0
26770,19,State - WEST BENGAL,Urban,8,Non-Technical Diploma,0,0,0
26771,19,State - WEST BENGAL,Urban,9,Non-Technical Diploma,0,0,0
26772,19,State - WEST BENGAL,Urban,10,Non-Technical Diploma,0,0,0
26773,19,State - WEST BENGAL,Urban,11,Non-Technical Diploma,0,0,0
26774,19,State - WEST BENGAL,Urban,12,Non-Technical Diploma,0,0,0
26775,19,State - WEST BENGAL,Urban,13,Non-Technical Diploma,0,0,0
26776,19,State - WEST BENGAL,Urban,14,Non-Technical Diploma,0,0,0
26777,19,State - WEST BENGAL,Urban,15,Non-Technical Diploma,0,0,0
26778,19,State - WEST BENGAL,Urban,16,Non-Technical Diploma,0,0,0
26779,19,State - WEST BENGAL,Urban,17,Non-Technical Diploma,0,0,0
26780,19,State - WEST BENGAL,Urban,18,Non-Technical Diploma,144,113,257
26781,19,State - WEST BENGAL,Urban,19,Non-Technical Diploma,180,119,299
26782,19,State - WEST BENGAL,Urban,20-24,Non-Technical Diploma,1503,1004,2507
26783,19,State - WEST BENGAL,Urban,25-29,Non-Technical Diploma,1062,656,1718
26784,19,State - WEST BENGAL,Urban,30-34,Non-Technical Diploma,787,365,1152
26785,19,State - WEST BENGAL,Urban,35-39,Non-Technical Diploma,685,280,965
26786,19,State - WEST BENGAL,Urban,40-44,Non-Technical Diploma,643,237,880
26787,19,State - WEST BENGAL,Urban,45-49,Non-Technical Diploma,628,181,809
26788,19,State - WEST BENGAL,Urban,50-54,Non-Technical Diploma,542,159,701
26789,19,State - WEST BENGAL,Urban,55-59,Non-Technical Diploma,399,109,508
26790,19,State - WEST BENGAL,Urban,60-64,Non-Technical Diploma,429,102,531
26791,19,State - WEST BENGAL,Urban,65-69,Non-Technical Diploma,392,68,460
26792,19,State - WEST BENGAL,Urban,70-74,Non-Technical Diploma,329,63,392
26793,19,State - WEST BENGAL,Urban,75-79,Non-Technical Diploma,184,32,216
26794,19,State - WEST BENGAL,Urban,80+,Non-Technical Diploma,156,44,200
26795,19,State - WEST BENGAL,Urban,Age not stated,Non-Technical Diploma,17,9,26
26796,20,State - JHARKHAND,Total,All ages,Non-Technical Diploma,14198,8468,22666
26797,20,State - JHARKHAND,Total,0-6,Non-Technical Diploma,0,0,0
26798,20,State - JHARKHAND,Total,7,Non-Technical Diploma,0,0,0
26799,20,State - JHARKHAND,Total,8,Non-Technical Diploma,0,0,0
26800,20,State - JHARKHAND,Total,9,Non-Technical Diploma,0,0,0
26801,20,State - JHARKHAND,Total,10,Non-Technical Diploma,0,0,0
26802,20,State - JHARKHAND,Total,11,Non-Technical Diploma,0,0,0
26803,20,State - JHARKHAND,Total,12,Non-Technical Diploma,0,0,0
26804,20,State - JHARKHAND,Total,13,Non-Technical Diploma,0,0,0
26805,20,State - JHARKHAND,Total,14,Non-Technical Diploma,0,0,0
26806,20,State - JHARKHAND,Total,15,Non-Technical Diploma,0,0,0
26807,20,State - JHARKHAND,Total,16,Non-Technical Diploma,0,0,0
26808,20,State - JHARKHAND,Total,17,Non-Technical Diploma,0,0,0
26809,20,State - JHARKHAND,Total,18,Non-Technical Diploma,651,407,1058
26810,20,State - JHARKHAND,Total,19,Non-Technical Diploma,396,280,676
26811,20,State - JHARKHAND,Total,20-24,Non-Technical Diploma,2568,1684,4252
26812,20,State - JHARKHAND,Total,25-29,Non-Technical Diploma,1909,1447,3356
26813,20,State - JHARKHAND,Total,30-34,Non-Technical Diploma,1805,1183,2988
26814,20,State - JHARKHAND,Total,35-39,Non-Technical Diploma,1537,998,2535
26815,20,State - JHARKHAND,Total,40-44,Non-Technical Diploma,1171,670,1841
26816,20,State - JHARKHAND,Total,45-49,Non-Technical Diploma,1012,546,1558
26817,20,State - JHARKHAND,Total,50-54,Non-Technical Diploma,862,374,1236
26818,20,State - JHARKHAND,Total,55-59,Non-Technical Diploma,687,320,1007
26819,20,State - JHARKHAND,Total,60-64,Non-Technical Diploma,600,224,824
26820,20,State - JHARKHAND,Total,65-69,Non-Technical Diploma,413,134,547
26821,20,State - JHARKHAND,Total,70-74,Non-Technical Diploma,265,84,349
26822,20,State - JHARKHAND,Total,75-79,Non-Technical Diploma,110,31,141
26823,20,State - JHARKHAND,Total,80+,Non-Technical Diploma,133,34,167
26824,20,State - JHARKHAND,Total,Age not stated,Non-Technical Diploma,79,52,131
26825,20,State - JHARKHAND,Rural,All ages,Non-Technical Diploma,8546,4601,13147
26826,20,State - JHARKHAND,Rural,0-6,Non-Technical Diploma,0,0,0
26827,20,State - JHARKHAND,Rural,7,Non-Technical Diploma,0,0,0
26828,20,State - JHARKHAND,Rural,8,Non-Technical Diploma,0,0,0
26829,20,State - JHARKHAND,Rural,9,Non-Technical Diploma,0,0,0
26830,20,State - JHARKHAND,Rural,10,Non-Technical Diploma,0,0,0
26831,20,State - JHARKHAND,Rural,11,Non-Technical Diploma,0,0,0
26832,20,State - JHARKHAND,Rural,12,Non-Technical Diploma,0,0,0
26833,20,State - JHARKHAND,Rural,13,Non-Technical Diploma,0,0,0
26834,20,State - JHARKHAND,Rural,14,Non-Technical Diploma,0,0,0
26835,20,State - JHARKHAND,Rural,15,Non-Technical Diploma,0,0,0
26836,20,State - JHARKHAND,Rural,16,Non-Technical Diploma,0,0,0
26837,20,State - JHARKHAND,Rural,17,Non-Technical Diploma,0,0,0
26838,20,State - JHARKHAND,Rural,18,Non-Technical Diploma,430,296,726
26839,20,State - JHARKHAND,Rural,19,Non-Technical Diploma,203,177,380
26840,20,State - JHARKHAND,Rural,20-24,Non-Technical Diploma,1595,1030,2625
26841,20,State - JHARKHAND,Rural,25-29,Non-Technical Diploma,1213,880,2093
26842,20,State - JHARKHAND,Rural,30-34,Non-Technical Diploma,1176,682,1858
26843,20,State - JHARKHAND,Rural,35-39,Non-Technical Diploma,1035,526,1561
26844,20,State - JHARKHAND,Rural,40-44,Non-Technical Diploma,761,324,1085
26845,20,State - JHARKHAND,Rural,45-49,Non-Technical Diploma,605,236,841
26846,20,State - JHARKHAND,Rural,50-54,Non-Technical Diploma,438,146,584
26847,20,State - JHARKHAND,Rural,55-59,Non-Technical Diploma,320,110,430
26848,20,State - JHARKHAND,Rural,60-64,Non-Technical Diploma,285,86,371
26849,20,State - JHARKHAND,Rural,65-69,Non-Technical Diploma,186,43,229
26850,20,State - JHARKHAND,Rural,70-74,Non-Technical Diploma,143,24,167
26851,20,State - JHARKHAND,Rural,75-79,Non-Technical Diploma,46,8,54
26852,20,State - JHARKHAND,Rural,80+,Non-Technical Diploma,85,15,100
26853,20,State - JHARKHAND,Rural,Age not stated,Non-Technical Diploma,25,18,43
26854,20,State - JHARKHAND,Urban,All ages,Non-Technical Diploma,5652,3867,9519
26855,20,State - JHARKHAND,Urban,0-6,Non-Technical Diploma,0,0,0
26856,20,State - JHARKHAND,Urban,7,Non-Technical Diploma,0,0,0
26857,20,State - JHARKHAND,Urban,8,Non-Technical Diploma,0,0,0
26858,20,State - JHARKHAND,Urban,9,Non-Technical Diploma,0,0,0
26859,20,State - JHARKHAND,Urban,10,Non-Technical Diploma,0,0,0
26860,20,State - JHARKHAND,Urban,11,Non-Technical Diploma,0,0,0
26861,20,State - JHARKHAND,Urban,12,Non-Technical Diploma,0,0,0
26862,20,State - JHARKHAND,Urban,13,Non-Technical Diploma,0,0,0
26863,20,State - JHARKHAND,Urban,14,Non-Technical Diploma,0,0,0
26864,20,State - JHARKHAND,Urban,15,Non-Technical Diploma,0,0,0
26865,20,State - JHARKHAND,Urban,16,Non-Technical Diploma,0,0,0
26866,20,State - JHARKHAND,Urban,17,Non-Technical Diploma,0,0,0
26867,20,State - JHARKHAND,Urban,18,Non-Technical Diploma,221,111,332
26868,20,State - JHARKHAND,Urban,19,Non-Technical Diploma,193,103,296
26869,20,State - JHARKHAND,Urban,20-24,Non-Technical Diploma,973,654,1627
26870,20,State - JHARKHAND,Urban,25-29,Non-Technical Diploma,696,567,1263
26871,20,State - JHARKHAND,Urban,30-34,Non-Technical Diploma,629,501,1130
26872,20,State - JHARKHAND,Urban,35-39,Non-Technical Diploma,502,472,974
26873,20,State - JHARKHAND,Urban,40-44,Non-Technical Diploma,410,346,756
26874,20,State - JHARKHAND,Urban,45-49,Non-Technical Diploma,407,310,717
26875,20,State - JHARKHAND,Urban,50-54,Non-Technical Diploma,424,228,652
26876,20,State - JHARKHAND,Urban,55-59,Non-Technical Diploma,367,210,577
26877,20,State - JHARKHAND,Urban,60-64,Non-Technical Diploma,315,138,453
26878,20,State - JHARKHAND,Urban,65-69,Non-Technical Diploma,227,91,318
26879,20,State - JHARKHAND,Urban,70-74,Non-Technical Diploma,122,60,182
26880,20,State - JHARKHAND,Urban,75-79,Non-Technical Diploma,64,23,87
26881,20,State - JHARKHAND,Urban,80+,Non-Technical Diploma,48,19,67
26882,20,State - JHARKHAND,Urban,Age not stated,Non-Technical Diploma,54,34,88
26883,21,State - ODISHA,Total,All ages,Non-Technical Diploma,28452,6202,34654
26884,21,State - ODISHA,Total,0-6,Non-Technical Diploma,0,0,0
26885,21,State - ODISHA,Total,7,Non-Technical Diploma,0,0,0
26886,21,State - ODISHA,Total,8,Non-Technical Diploma,0,0,0
26887,21,State - ODISHA,Total,9,Non-Technical Diploma,0,0,0
26888,21,State - ODISHA,Total,10,Non-Technical Diploma,0,0,0
26889,21,State - ODISHA,Total,11,Non-Technical Diploma,0,0,0
26890,21,State - ODISHA,Total,12,Non-Technical Diploma,0,0,0
26891,21,State - ODISHA,Total,13,Non-Technical Diploma,0,0,0
26892,21,State - ODISHA,Total,14,Non-Technical Diploma,0,0,0
26893,21,State - ODISHA,Total,15,Non-Technical Diploma,0,0,0
26894,21,State - ODISHA,Total,16,Non-Technical Diploma,0,0,0
26895,21,State - ODISHA,Total,17,Non-Technical Diploma,0,0,0
26896,21,State - ODISHA,Total,18,Non-Technical Diploma,1918,686,2604
26897,21,State - ODISHA,Total,19,Non-Technical Diploma,1846,577,2423
26898,21,State - ODISHA,Total,20-24,Non-Technical Diploma,8287,1790,10077
26899,21,State - ODISHA,Total,25-29,Non-Technical Diploma,4330,995,5325
26900,21,State - ODISHA,Total,30-34,Non-Technical Diploma,2537,469,3006
26901,21,State - ODISHA,Total,35-39,Non-Technical Diploma,2058,348,2406
26902,21,State - ODISHA,Total,40-44,Non-Technical Diploma,1905,461,2366
26903,21,State - ODISHA,Total,45-49,Non-Technical Diploma,1576,357,1933
26904,21,State - ODISHA,Total,50-54,Non-Technical Diploma,1020,209,1229
26905,21,State - ODISHA,Total,55-59,Non-Technical Diploma,769,141,910
26906,21,State - ODISHA,Total,60-64,Non-Technical Diploma,787,65,852
26907,21,State - ODISHA,Total,65-69,Non-Technical Diploma,634,30,664
26908,21,State - ODISHA,Total,70-74,Non-Technical Diploma,377,27,404
26909,21,State - ODISHA,Total,75-79,Non-Technical Diploma,153,8,161
26910,21,State - ODISHA,Total,80+,Non-Technical Diploma,110,12,122
26911,21,State - ODISHA,Total,Age not stated,Non-Technical Diploma,145,27,172
26912,21,State - ODISHA,Rural,All ages,Non-Technical Diploma,14019,2708,16727
26913,21,State - ODISHA,Rural,0-6,Non-Technical Diploma,0,0,0
26914,21,State - ODISHA,Rural,7,Non-Technical Diploma,0,0,0
26915,21,State - ODISHA,Rural,8,Non-Technical Diploma,0,0,0
26916,21,State - ODISHA,Rural,9,Non-Technical Diploma,0,0,0
26917,21,State - ODISHA,Rural,10,Non-Technical Diploma,0,0,0
26918,21,State - ODISHA,Rural,11,Non-Technical Diploma,0,0,0
26919,21,State - ODISHA,Rural,12,Non-Technical Diploma,0,0,0
26920,21,State - ODISHA,Rural,13,Non-Technical Diploma,0,0,0
26921,21,State - ODISHA,Rural,14,Non-Technical Diploma,0,0,0
26922,21,State - ODISHA,Rural,15,Non-Technical Diploma,0,0,0
26923,21,State - ODISHA,Rural,16,Non-Technical Diploma,0,0,0
26924,21,State - ODISHA,Rural,17,Non-Technical Diploma,0,0,0
26925,21,State - ODISHA,Rural,18,Non-Technical Diploma,1074,301,1375
26926,21,State - ODISHA,Rural,19,Non-Technical Diploma,1068,252,1320
26927,21,State - ODISHA,Rural,20-24,Non-Technical Diploma,4437,794,5231
26928,21,State - ODISHA,Rural,25-29,Non-Technical Diploma,2356,470,2826
26929,21,State - ODISHA,Rural,30-34,Non-Technical Diploma,1305,188,1493
26930,21,State - ODISHA,Rural,35-39,Non-Technical Diploma,873,156,1029
26931,21,State - ODISHA,Rural,40-44,Non-Technical Diploma,759,223,982
26932,21,State - ODISHA,Rural,45-49,Non-Technical Diploma,557,144,701
26933,21,State - ODISHA,Rural,50-54,Non-Technical Diploma,350,74,424
26934,21,State - ODISHA,Rural,55-59,Non-Technical Diploma,331,53,384
26935,21,State - ODISHA,Rural,60-64,Non-Technical Diploma,341,22,363
26936,21,State - ODISHA,Rural,65-69,Non-Technical Diploma,268,5,273
26937,21,State - ODISHA,Rural,70-74,Non-Technical Diploma,141,7,148
26938,21,State - ODISHA,Rural,75-79,Non-Technical Diploma,69,2,71
26939,21,State - ODISHA,Rural,80+,Non-Technical Diploma,46,5,51
26940,21,State - ODISHA,Rural,Age not stated,Non-Technical Diploma,44,12,56
26941,21,State - ODISHA,Urban,All ages,Non-Technical Diploma,14433,3494,17927
26942,21,State - ODISHA,Urban,0-6,Non-Technical Diploma,0,0,0
26943,21,State - ODISHA,Urban,7,Non-Technical Diploma,0,0,0
26944,21,State - ODISHA,Urban,8,Non-Technical Diploma,0,0,0
26945,21,State - ODISHA,Urban,9,Non-Technical Diploma,0,0,0
26946,21,State - ODISHA,Urban,10,Non-Technical Diploma,0,0,0
26947,21,State - ODISHA,Urban,11,Non-Technical Diploma,0,0,0
26948,21,State - ODISHA,Urban,12,Non-Technical Diploma,0,0,0
26949,21,State - ODISHA,Urban,13,Non-Technical Diploma,0,0,0
26950,21,State - ODISHA,Urban,14,Non-Technical Diploma,0,0,0
26951,21,State - ODISHA,Urban,15,Non-Technical Diploma,0,0,0
26952,21,State - ODISHA,Urban,16,Non-Technical Diploma,0,0,0
26953,21,State - ODISHA,Urban,17,Non-Technical Diploma,0,0,0
26954,21,State - ODISHA,Urban,18,Non-Technical Diploma,844,385,1229
26955,21,State - ODISHA,Urban,19,Non-Technical Diploma,778,325,1103
26956,21,State - ODISHA,Urban,20-24,Non-Technical Diploma,3850,996,4846
26957,21,State - ODISHA,Urban,25-29,Non-Technical Diploma,1974,525,2499
26958,21,State - ODISHA,Urban,30-34,Non-Technical Diploma,1232,281,1513
26959,21,State - ODISHA,Urban,35-39,Non-Technical Diploma,1185,192,1377
26960,21,State - ODISHA,Urban,40-44,Non-Technical Diploma,1146,238,1384
26961,21,State - ODISHA,Urban,45-49,Non-Technical Diploma,1019,213,1232
26962,21,State - ODISHA,Urban,50-54,Non-Technical Diploma,670,135,805
26963,21,State - ODISHA,Urban,55-59,Non-Technical Diploma,438,88,526
26964,21,State - ODISHA,Urban,60-64,Non-Technical Diploma,446,43,489
26965,21,State - ODISHA,Urban,65-69,Non-Technical Diploma,366,25,391
26966,21,State - ODISHA,Urban,70-74,Non-Technical Diploma,236,20,256
26967,21,State - ODISHA,Urban,75-79,Non-Technical Diploma,84,6,90
26968,21,State - ODISHA,Urban,80+,Non-Technical Diploma,64,7,71
26969,21,State - ODISHA,Urban,Age not stated,Non-Technical Diploma,101,15,116
26970,22,State - CHHATTISGARH,Total,All ages,Non-Technical Diploma,2728,1135,3863
26971,22,State - CHHATTISGARH,Total,0-6,Non-Technical Diploma,0,0,0
26972,22,State - CHHATTISGARH,Total,7,Non-Technical Diploma,0,0,0
26973,22,State - CHHATTISGARH,Total,8,Non-Technical Diploma,0,0,0
26974,22,State - CHHATTISGARH,Total,9,Non-Technical Diploma,0,0,0
26975,22,State - CHHATTISGARH,Total,10,Non-Technical Diploma,0,0,0
26976,22,State - CHHATTISGARH,Total,11,Non-Technical Diploma,0,0,0
26977,22,State - CHHATTISGARH,Total,12,Non-Technical Diploma,0,0,0
26978,22,State - CHHATTISGARH,Total,13,Non-Technical Diploma,0,0,0
26979,22,State - CHHATTISGARH,Total,14,Non-Technical Diploma,0,0,0
26980,22,State - CHHATTISGARH,Total,15,Non-Technical Diploma,0,0,0
26981,22,State - CHHATTISGARH,Total,16,Non-Technical Diploma,0,0,0
26982,22,State - CHHATTISGARH,Total,17,Non-Technical Diploma,0,0,0
26983,22,State - CHHATTISGARH,Total,18,Non-Technical Diploma,52,34,86
26984,22,State - CHHATTISGARH,Total,19,Non-Technical Diploma,75,81,156
26985,22,State - CHHATTISGARH,Total,20-24,Non-Technical Diploma,616,409,1025
26986,22,State - CHHATTISGARH,Total,25-29,Non-Technical Diploma,405,179,584
26987,22,State - CHHATTISGARH,Total,30-34,Non-Technical Diploma,363,147,510
26988,22,State - CHHATTISGARH,Total,35-39,Non-Technical Diploma,355,95,450
26989,22,State - CHHATTISGARH,Total,40-44,Non-Technical Diploma,276,66,342
26990,22,State - CHHATTISGARH,Total,45-49,Non-Technical Diploma,190,43,233
26991,22,State - CHHATTISGARH,Total,50-54,Non-Technical Diploma,141,25,166
26992,22,State - CHHATTISGARH,Total,55-59,Non-Technical Diploma,84,16,100
26993,22,State - CHHATTISGARH,Total,60-64,Non-Technical Diploma,53,14,67
26994,22,State - CHHATTISGARH,Total,65-69,Non-Technical Diploma,43,15,58
26995,22,State - CHHATTISGARH,Total,70-74,Non-Technical Diploma,31,3,34
26996,22,State - CHHATTISGARH,Total,75-79,Non-Technical Diploma,22,3,25
26997,22,State - CHHATTISGARH,Total,80+,Non-Technical Diploma,17,4,21
26998,22,State - CHHATTISGARH,Total,Age not stated,Non-Technical Diploma,5,1,6
26999,22,State - CHHATTISGARH,Rural,All ages,Non-Technical Diploma,977,353,1330
27000,22,State - CHHATTISGARH,Rural,0-6,Non-Technical Diploma,0,0,0
27001,22,State - CHHATTISGARH,Rural,7,Non-Technical Diploma,0,0,0
27002,22,State - CHHATTISGARH,Rural,8,Non-Technical Diploma,0,0,0
27003,22,State - CHHATTISGARH,Rural,9,Non-Technical Diploma,0,0,0
27004,22,State - CHHATTISGARH,Rural,10,Non-Technical Diploma,0,0,0
27005,22,State - CHHATTISGARH,Rural,11,Non-Technical Diploma,0,0,0
27006,22,State - CHHATTISGARH,Rural,12,Non-Technical Diploma,0,0,0
27007,22,State - CHHATTISGARH,Rural,13,Non-Technical Diploma,0,0,0
27008,22,State - CHHATTISGARH,Rural,14,Non-Technical Diploma,0,0,0
27009,22,State - CHHATTISGARH,Rural,15,Non-Technical Diploma,0,0,0
27010,22,State - CHHATTISGARH,Rural,16,Non-Technical Diploma,0,0,0
27011,22,State - CHHATTISGARH,Rural,17,Non-Technical Diploma,0,0,0
27012,22,State - CHHATTISGARH,Rural,18,Non-Technical Diploma,12,7,19
27013,22,State - CHHATTISGARH,Rural,19,Non-Technical Diploma,32,31,63
27014,22,State - CHHATTISGARH,Rural,20-24,Non-Technical Diploma,348,150,498
27015,22,State - CHHATTISGARH,Rural,25-29,Non-Technical Diploma,190,54,244
27016,22,State - CHHATTISGARH,Rural,30-34,Non-Technical Diploma,128,47,175
27017,22,State - CHHATTISGARH,Rural,35-39,Non-Technical Diploma,116,27,143
27018,22,State - CHHATTISGARH,Rural,40-44,Non-Technical Diploma,78,17,95
27019,22,State - CHHATTISGARH,Rural,45-49,Non-Technical Diploma,31,7,38
27020,22,State - CHHATTISGARH,Rural,50-54,Non-Technical Diploma,14,6,20
27021,22,State - CHHATTISGARH,Rural,55-59,Non-Technical Diploma,7,4,11
27022,22,State - CHHATTISGARH,Rural,60-64,Non-Technical Diploma,5,3,8
27023,22,State - CHHATTISGARH,Rural,65-69,Non-Technical Diploma,5,0,5
27024,22,State - CHHATTISGARH,Rural,70-74,Non-Technical Diploma,6,0,6
27025,22,State - CHHATTISGARH,Rural,75-79,Non-Technical Diploma,2,0,2
27026,22,State - CHHATTISGARH,Rural,80+,Non-Technical Diploma,2,0,2
27027,22,State - CHHATTISGARH,Rural,Age not stated,Non-Technical Diploma,1,0,1
27028,22,State - CHHATTISGARH,Urban,All ages,Non-Technical Diploma,1751,782,2533
27029,22,State - CHHATTISGARH,Urban,0-6,Non-Technical Diploma,0,0,0
27030,22,State - CHHATTISGARH,Urban,7,Non-Technical Diploma,0,0,0
27031,22,State - CHHATTISGARH,Urban,8,Non-Technical Diploma,0,0,0
27032,22,State - CHHATTISGARH,Urban,9,Non-Technical Diploma,0,0,0
27033,22,State - CHHATTISGARH,Urban,10,Non-Technical Diploma,0,0,0
27034,22,State - CHHATTISGARH,Urban,11,Non-Technical Diploma,0,0,0
27035,22,State - CHHATTISGARH,Urban,12,Non-Technical Diploma,0,0,0
27036,22,State - CHHATTISGARH,Urban,13,Non-Technical Diploma,0,0,0
27037,22,State - CHHATTISGARH,Urban,14,Non-Technical Diploma,0,0,0
27038,22,State - CHHATTISGARH,Urban,15,Non-Technical Diploma,0,0,0
27039,22,State - CHHATTISGARH,Urban,16,Non-Technical Diploma,0,0,0
27040,22,State - CHHATTISGARH,Urban,17,Non-Technical Diploma,0,0,0
27041,22,State - CHHATTISGARH,Urban,18,Non-Technical Diploma,40,27,67
27042,22,State - CHHATTISGARH,Urban,19,Non-Technical Diploma,43,50,93
27043,22,State - CHHATTISGARH,Urban,20-24,Non-Technical Diploma,268,259,527
27044,22,State - CHHATTISGARH,Urban,25-29,Non-Technical Diploma,215,125,340
27045,22,State - CHHATTISGARH,Urban,30-34,Non-Technical Diploma,235,100,335
27046,22,State - CHHATTISGARH,Urban,35-39,Non-Technical Diploma,239,68,307
27047,22,State - CHHATTISGARH,Urban,40-44,Non-Technical Diploma,198,49,247
27048,22,State - CHHATTISGARH,Urban,45-49,Non-Technical Diploma,159,36,195
27049,22,State - CHHATTISGARH,Urban,50-54,Non-Technical Diploma,127,19,146
27050,22,State - CHHATTISGARH,Urban,55-59,Non-Technical Diploma,77,12,89
27051,22,State - CHHATTISGARH,Urban,60-64,Non-Technical Diploma,48,11,59
27052,22,State - CHHATTISGARH,Urban,65-69,Non-Technical Diploma,38,15,53
27053,22,State - CHHATTISGARH,Urban,70-74,Non-Technical Diploma,25,3,28
27054,22,State - CHHATTISGARH,Urban,75-79,Non-Technical Diploma,20,3,23
27055,22,State - CHHATTISGARH,Urban,80+,Non-Technical Diploma,15,4,19
27056,22,State - CHHATTISGARH,Urban,Age not stated,Non-Technical Diploma,4,1,5
27057,23,State - MADHYA PRADESH,Total,All ages,Non-Technical Diploma,6814,2918,9732
27058,23,State - MADHYA PRADESH,Total,0-6,Non-Technical Diploma,0,0,0
27059,23,State - MADHYA PRADESH,Total,7,Non-Technical Diploma,0,0,0
27060,23,State - MADHYA PRADESH,Total,8,Non-Technical Diploma,0,0,0
27061,23,State - MADHYA PRADESH,Total,9,Non-Technical Diploma,0,0,0
27062,23,State - MADHYA PRADESH,Total,10,Non-Technical Diploma,0,0,0
27063,23,State - MADHYA PRADESH,Total,11,Non-Technical Diploma,0,0,0
27064,23,State - MADHYA PRADESH,Total,12,Non-Technical Diploma,0,0,0
27065,23,State - MADHYA PRADESH,Total,13,Non-Technical Diploma,0,0,0
27066,23,State - MADHYA PRADESH,Total,14,Non-Technical Diploma,0,0,0
27067,23,State - MADHYA PRADESH,Total,15,Non-Technical Diploma,0,0,0
27068,23,State - MADHYA PRADESH,Total,16,Non-Technical Diploma,0,0,0
27069,23,State - MADHYA PRADESH,Total,17,Non-Technical Diploma,0,0,0
27070,23,State - MADHYA PRADESH,Total,18,Non-Technical Diploma,218,152,370
27071,23,State - MADHYA PRADESH,Total,19,Non-Technical Diploma,235,146,381
27072,23,State - MADHYA PRADESH,Total,20-24,Non-Technical Diploma,1419,770,2189
27073,23,State - MADHYA PRADESH,Total,25-29,Non-Technical Diploma,831,451,1282
27074,23,State - MADHYA PRADESH,Total,30-34,Non-Technical Diploma,617,283,900
27075,23,State - MADHYA PRADESH,Total,35-39,Non-Technical Diploma,561,215,776
27076,23,State - MADHYA PRADESH,Total,40-44,Non-Technical Diploma,566,183,749
27077,23,State - MADHYA PRADESH,Total,45-49,Non-Technical Diploma,617,167,784
27078,23,State - MADHYA PRADESH,Total,50-54,Non-Technical Diploma,501,110,611
27079,23,State - MADHYA PRADESH,Total,55-59,Non-Technical Diploma,374,125,499
27080,23,State - MADHYA PRADESH,Total,60-64,Non-Technical Diploma,285,102,387
27081,23,State - MADHYA PRADESH,Total,65-69,Non-Technical Diploma,232,73,305
27082,23,State - MADHYA PRADESH,Total,70-74,Non-Technical Diploma,187,57,244
27083,23,State - MADHYA PRADESH,Total,75-79,Non-Technical Diploma,66,25,91
27084,23,State - MADHYA PRADESH,Total,80+,Non-Technical Diploma,89,54,143
27085,23,State - MADHYA PRADESH,Total,Age not stated,Non-Technical Diploma,16,5,21
27086,23,State - MADHYA PRADESH,Rural,All ages,Non-Technical Diploma,1698,500,2198
27087,23,State - MADHYA PRADESH,Rural,0-6,Non-Technical Diploma,0,0,0
27088,23,State - MADHYA PRADESH,Rural,7,Non-Technical Diploma,0,0,0
27089,23,State - MADHYA PRADESH,Rural,8,Non-Technical Diploma,0,0,0
27090,23,State - MADHYA PRADESH,Rural,9,Non-Technical Diploma,0,0,0
27091,23,State - MADHYA PRADESH,Rural,10,Non-Technical Diploma,0,0,0
27092,23,State - MADHYA PRADESH,Rural,11,Non-Technical Diploma,0,0,0
27093,23,State - MADHYA PRADESH,Rural,12,Non-Technical Diploma,0,0,0
27094,23,State - MADHYA PRADESH,Rural,13,Non-Technical Diploma,0,0,0
27095,23,State - MADHYA PRADESH,Rural,14,Non-Technical Diploma,0,0,0
27096,23,State - MADHYA PRADESH,Rural,15,Non-Technical Diploma,0,0,0
27097,23,State - MADHYA PRADESH,Rural,16,Non-Technical Diploma,0,0,0
27098,23,State - MADHYA PRADESH,Rural,17,Non-Technical Diploma,0,0,0
27099,23,State - MADHYA PRADESH,Rural,18,Non-Technical Diploma,99,35,134
27100,23,State - MADHYA PRADESH,Rural,19,Non-Technical Diploma,108,32,140
27101,23,State - MADHYA PRADESH,Rural,20-24,Non-Technical Diploma,512,145,657
27102,23,State - MADHYA PRADESH,Rural,25-29,Non-Technical Diploma,240,76,316
27103,23,State - MADHYA PRADESH,Rural,30-34,Non-Technical Diploma,162,54,216
27104,23,State - MADHYA PRADESH,Rural,35-39,Non-Technical Diploma,133,38,171
27105,23,State - MADHYA PRADESH,Rural,40-44,Non-Technical Diploma,113,36,149
27106,23,State - MADHYA PRADESH,Rural,45-49,Non-Technical Diploma,71,25,96
27107,23,State - MADHYA PRADESH,Rural,50-54,Non-Technical Diploma,58,17,75
27108,23,State - MADHYA PRADESH,Rural,55-59,Non-Technical Diploma,54,12,66
27109,23,State - MADHYA PRADESH,Rural,60-64,Non-Technical Diploma,41,11,52
27110,23,State - MADHYA PRADESH,Rural,65-69,Non-Technical Diploma,27,5,32
27111,23,State - MADHYA PRADESH,Rural,70-74,Non-Technical Diploma,33,5,38
27112,23,State - MADHYA PRADESH,Rural,75-79,Non-Technical Diploma,14,2,16
27113,23,State - MADHYA PRADESH,Rural,80+,Non-Technical Diploma,29,5,34
27114,23,State - MADHYA PRADESH,Rural,Age not stated,Non-Technical Diploma,4,2,6
27115,23,State - MADHYA PRADESH,Urban,All ages,Non-Technical Diploma,5116,2418,7534
27116,23,State - MADHYA PRADESH,Urban,0-6,Non-Technical Diploma,0,0,0
27117,23,State - MADHYA PRADESH,Urban,7,Non-Technical Diploma,0,0,0
27118,23,State - MADHYA PRADESH,Urban,8,Non-Technical Diploma,0,0,0
27119,23,State - MADHYA PRADESH,Urban,9,Non-Technical Diploma,0,0,0
27120,23,State - MADHYA PRADESH,Urban,10,Non-Technical Diploma,0,0,0
27121,23,State - MADHYA PRADESH,Urban,11,Non-Technical Diploma,0,0,0
27122,23,State - MADHYA PRADESH,Urban,12,Non-Technical Diploma,0,0,0
27123,23,State - MADHYA PRADESH,Urban,13,Non-Technical Diploma,0,0,0
27124,23,State - MADHYA PRADESH,Urban,14,Non-Technical Diploma,0,0,0
27125,23,State - MADHYA PRADESH,Urban,15,Non-Technical Diploma,0,0,0
27126,23,State - MADHYA PRADESH,Urban,16,Non-Technical Diploma,0,0,0
27127,23,State - MADHYA PRADESH,Urban,17,Non-Technical Diploma,0,0,0
27128,23,State - MADHYA PRADESH,Urban,18,Non-Technical Diploma,119,117,236
27129,23,State - MADHYA PRADESH,Urban,19,Non-Technical Diploma,127,114,241
27130,23,State - MADHYA PRADESH,Urban,20-24,Non-Technical Diploma,907,625,1532
27131,23,State - MADHYA PRADESH,Urban,25-29,Non-Technical Diploma,591,375,966
27132,23,State - MADHYA PRADESH,Urban,30-34,Non-Technical Diploma,455,229,684
27133,23,State - MADHYA PRADESH,Urban,35-39,Non-Technical Diploma,428,177,605
27134,23,State - MADHYA PRADESH,Urban,40-44,Non-Technical Diploma,453,147,600
27135,23,State - MADHYA PRADESH,Urban,45-49,Non-Technical Diploma,546,142,688
27136,23,State - MADHYA PRADESH,Urban,50-54,Non-Technical Diploma,443,93,536
27137,23,State - MADHYA PRADESH,Urban,55-59,Non-Technical Diploma,320,113,433
27138,23,State - MADHYA PRADESH,Urban,60-64,Non-Technical Diploma,244,91,335
27139,23,State - MADHYA PRADESH,Urban,65-69,Non-Technical Diploma,205,68,273
27140,23,State - MADHYA PRADESH,Urban,70-74,Non-Technical Diploma,154,52,206
27141,23,State - MADHYA PRADESH,Urban,75-79,Non-Technical Diploma,52,23,75
27142,23,State - MADHYA PRADESH,Urban,80+,Non-Technical Diploma,60,49,109
27143,23,State - MADHYA PRADESH,Urban,Age not stated,Non-Technical Diploma,12,3,15
27144,24,State - GUJARAT,Total,All ages,Non-Technical Diploma,25992,11764,37756
27145,24,State - GUJARAT,Total,0-6,Non-Technical Diploma,0,0,0
27146,24,State - GUJARAT,Total,7,Non-Technical Diploma,0,0,0
27147,24,State - GUJARAT,Total,8,Non-Technical Diploma,0,0,0
27148,24,State - GUJARAT,Total,9,Non-Technical Diploma,0,0,0
27149,24,State - GUJARAT,Total,10,Non-Technical Diploma,0,0,0
27150,24,State - GUJARAT,Total,11,Non-Technical Diploma,0,0,0
27151,24,State - GUJARAT,Total,12,Non-Technical Diploma,0,0,0
27152,24,State - GUJARAT,Total,13,Non-Technical Diploma,0,0,0
27153,24,State - GUJARAT,Total,14,Non-Technical Diploma,0,0,0
27154,24,State - GUJARAT,Total,15,Non-Technical Diploma,0,0,0
27155,24,State - GUJARAT,Total,16,Non-Technical Diploma,0,0,0
27156,24,State - GUJARAT,Total,17,Non-Technical Diploma,0,0,0
27157,24,State - GUJARAT,Total,18,Non-Technical Diploma,2343,797,3140
27158,24,State - GUJARAT,Total,19,Non-Technical Diploma,2163,792,2955
27159,24,State - GUJARAT,Total,20-24,Non-Technical Diploma,6120,2504,8624
27160,24,State - GUJARAT,Total,25-29,Non-Technical Diploma,3571,1728,5299
27161,24,State - GUJARAT,Total,30-34,Non-Technical Diploma,2467,1436,3903
27162,24,State - GUJARAT,Total,35-39,Non-Technical Diploma,2081,1191,3272
27163,24,State - GUJARAT,Total,40-44,Non-Technical Diploma,1813,1036,2849
27164,24,State - GUJARAT,Total,45-49,Non-Technical Diploma,1758,914,2672
27165,24,State - GUJARAT,Total,50-54,Non-Technical Diploma,1182,547,1729
27166,24,State - GUJARAT,Total,55-59,Non-Technical Diploma,814,300,1114
27167,24,State - GUJARAT,Total,60-64,Non-Technical Diploma,563,222,785
27168,24,State - GUJARAT,Total,65-69,Non-Technical Diploma,456,115,571
27169,24,State - GUJARAT,Total,70-74,Non-Technical Diploma,274,63,337
27170,24,State - GUJARAT,Total,75-79,Non-Technical Diploma,141,34,175
27171,24,State - GUJARAT,Total,80+,Non-Technical Diploma,130,39,169
27172,24,State - GUJARAT,Total,Age not stated,Non-Technical Diploma,116,46,162
27173,24,State - GUJARAT,Rural,All ages,Non-Technical Diploma,10167,2973,13140
27174,24,State - GUJARAT,Rural,0-6,Non-Technical Diploma,0,0,0
27175,24,State - GUJARAT,Rural,7,Non-Technical Diploma,0,0,0
27176,24,State - GUJARAT,Rural,8,Non-Technical Diploma,0,0,0
27177,24,State - GUJARAT,Rural,9,Non-Technical Diploma,0,0,0
27178,24,State - GUJARAT,Rural,10,Non-Technical Diploma,0,0,0
27179,24,State - GUJARAT,Rural,11,Non-Technical Diploma,0,0,0
27180,24,State - GUJARAT,Rural,12,Non-Technical Diploma,0,0,0
27181,24,State - GUJARAT,Rural,13,Non-Technical Diploma,0,0,0
27182,24,State - GUJARAT,Rural,14,Non-Technical Diploma,0,0,0
27183,24,State - GUJARAT,Rural,15,Non-Technical Diploma,0,0,0
27184,24,State - GUJARAT,Rural,16,Non-Technical Diploma,0,0,0
27185,24,State - GUJARAT,Rural,17,Non-Technical Diploma,0,0,0
27186,24,State - GUJARAT,Rural,18,Non-Technical Diploma,1213,404,1617
27187,24,State - GUJARAT,Rural,19,Non-Technical Diploma,1154,409,1563
27188,24,State - GUJARAT,Rural,20-24,Non-Technical Diploma,2898,858,3756
27189,24,State - GUJARAT,Rural,25-29,Non-Technical Diploma,1450,355,1805
27190,24,State - GUJARAT,Rural,30-34,Non-Technical Diploma,874,274,1148
27191,24,State - GUJARAT,Rural,35-39,Non-Technical Diploma,635,207,842
27192,24,State - GUJARAT,Rural,40-44,Non-Technical Diploma,550,160,710
27193,24,State - GUJARAT,Rural,45-49,Non-Technical Diploma,463,155,618
27194,24,State - GUJARAT,Rural,50-54,Non-Technical Diploma,321,71,392
27195,24,State - GUJARAT,Rural,55-59,Non-Technical Diploma,206,34,240
27196,24,State - GUJARAT,Rural,60-64,Non-Technical Diploma,139,16,155
27197,24,State - GUJARAT,Rural,65-69,Non-Technical Diploma,131,12,143
27198,24,State - GUJARAT,Rural,70-74,Non-Technical Diploma,41,6,47
27199,24,State - GUJARAT,Rural,75-79,Non-Technical Diploma,24,3,27
27200,24,State - GUJARAT,Rural,80+,Non-Technical Diploma,28,5,33
27201,24,State - GUJARAT,Rural,Age not stated,Non-Technical Diploma,40,4,44
27202,24,State - GUJARAT,Urban,All ages,Non-Technical Diploma,15825,8791,24616
27203,24,State - GUJARAT,Urban,0-6,Non-Technical Diploma,0,0,0
27204,24,State - GUJARAT,Urban,7,Non-Technical Diploma,0,0,0
27205,24,State - GUJARAT,Urban,8,Non-Technical Diploma,0,0,0
27206,24,State - GUJARAT,Urban,9,Non-Technical Diploma,0,0,0
27207,24,State - GUJARAT,Urban,10,Non-Technical Diploma,0,0,0
27208,24,State - GUJARAT,Urban,11,Non-Technical Diploma,0,0,0
27209,24,State - GUJARAT,Urban,12,Non-Technical Diploma,0,0,0
27210,24,State - GUJARAT,Urban,13,Non-Technical Diploma,0,0,0
27211,24,State - GUJARAT,Urban,14,Non-Technical Diploma,0,0,0
27212,24,State - GUJARAT,Urban,15,Non-Technical Diploma,0,0,0
27213,24,State - GUJARAT,Urban,16,Non-Technical Diploma,0,0,0
27214,24,State - GUJARAT,Urban,17,Non-Technical Diploma,0,0,0
27215,24,State - GUJARAT,Urban,18,Non-Technical Diploma,1130,393,1523
27216,24,State - GUJARAT,Urban,19,Non-Technical Diploma,1009,383,1392
27217,24,State - GUJARAT,Urban,20-24,Non-Technical Diploma,3222,1646,4868
27218,24,State - GUJARAT,Urban,25-29,Non-Technical Diploma,2121,1373,3494
27219,24,State - GUJARAT,Urban,30-34,Non-Technical Diploma,1593,1162,2755
27220,24,State - GUJARAT,Urban,35-39,Non-Technical Diploma,1446,984,2430
27221,24,State - GUJARAT,Urban,40-44,Non-Technical Diploma,1263,876,2139
27222,24,State - GUJARAT,Urban,45-49,Non-Technical Diploma,1295,759,2054
27223,24,State - GUJARAT,Urban,50-54,Non-Technical Diploma,861,476,1337
27224,24,State - GUJARAT,Urban,55-59,Non-Technical Diploma,608,266,874
27225,24,State - GUJARAT,Urban,60-64,Non-Technical Diploma,424,206,630
27226,24,State - GUJARAT,Urban,65-69,Non-Technical Diploma,325,103,428
27227,24,State - GUJARAT,Urban,70-74,Non-Technical Diploma,233,57,290
27228,24,State - GUJARAT,Urban,75-79,Non-Technical Diploma,117,31,148
27229,24,State - GUJARAT,Urban,80+,Non-Technical Diploma,102,34,136
27230,24,State - GUJARAT,Urban,Age not stated,Non-Technical Diploma,76,42,118
27231,25,State - DAMAN & DIU,Total,All ages,Non-Technical Diploma,120,42,162
27232,25,State - DAMAN & DIU,Total,0-6,Non-Technical Diploma,0,0,0
27233,25,State - DAMAN & DIU,Total,7,Non-Technical Diploma,0,0,0
27234,25,State - DAMAN & DIU,Total,8,Non-Technical Diploma,0,0,0
27235,25,State - DAMAN & DIU,Total,9,Non-Technical Diploma,0,0,0
27236,25,State - DAMAN & DIU,Total,10,Non-Technical Diploma,0,0,0
27237,25,State - DAMAN & DIU,Total,11,Non-Technical Diploma,0,0,0
27238,25,State - DAMAN & DIU,Total,12,Non-Technical Diploma,0,0,0
27239,25,State - DAMAN & DIU,Total,13,Non-Technical Diploma,0,0,0
27240,25,State - DAMAN & DIU,Total,14,Non-Technical Diploma,0,0,0
27241,25,State - DAMAN & DIU,Total,15,Non-Technical Diploma,0,0,0
27242,25,State - DAMAN & DIU,Total,16,Non-Technical Diploma,0,0,0
27243,25,State - DAMAN & DIU,Total,17,Non-Technical Diploma,0,0,0
27244,25,State - DAMAN & DIU,Total,18,Non-Technical Diploma,2,1,3
27245,25,State - DAMAN & DIU,Total,19,Non-Technical Diploma,3,3,6
27246,25,State - DAMAN & DIU,Total,20-24,Non-Technical Diploma,23,13,36
27247,25,State - DAMAN & DIU,Total,25-29,Non-Technical Diploma,18,6,24
27248,25,State - DAMAN & DIU,Total,30-34,Non-Technical Diploma,20,6,26
27249,25,State - DAMAN & DIU,Total,35-39,Non-Technical Diploma,23,5,28
27250,25,State - DAMAN & DIU,Total,40-44,Non-Technical Diploma,14,3,17
27251,25,State - DAMAN & DIU,Total,45-49,Non-Technical Diploma,3,3,6
27252,25,State - DAMAN & DIU,Total,50-54,Non-Technical Diploma,4,1,5
27253,25,State - DAMAN & DIU,Total,55-59,Non-Technical Diploma,3,0,3
27254,25,State - DAMAN & DIU,Total,60-64,Non-Technical Diploma,1,0,1
27255,25,State - DAMAN & DIU,Total,65-69,Non-Technical Diploma,4,0,4
27256,25,State - DAMAN & DIU,Total,70-74,Non-Technical Diploma,2,0,2
27257,25,State - DAMAN & DIU,Total,75-79,Non-Technical Diploma,0,0,0
27258,25,State - DAMAN & DIU,Total,80+,Non-Technical Diploma,0,1,1
27259,25,State - DAMAN & DIU,Total,Age not stated,Non-Technical Diploma,0,0,0
27260,25,State - DAMAN & DIU,Rural,All ages,Non-Technical Diploma,15,5,20
27261,25,State - DAMAN & DIU,Rural,0-6,Non-Technical Diploma,0,0,0
27262,25,State - DAMAN & DIU,Rural,7,Non-Technical Diploma,0,0,0
27263,25,State - DAMAN & DIU,Rural,8,Non-Technical Diploma,0,0,0
27264,25,State - DAMAN & DIU,Rural,9,Non-Technical Diploma,0,0,0
27265,25,State - DAMAN & DIU,Rural,10,Non-Technical Diploma,0,0,0
27266,25,State - DAMAN & DIU,Rural,11,Non-Technical Diploma,0,0,0
27267,25,State - DAMAN & DIU,Rural,12,Non-Technical Diploma,0,0,0
27268,25,State - DAMAN & DIU,Rural,13,Non-Technical Diploma,0,0,0
27269,25,State - DAMAN & DIU,Rural,14,Non-Technical Diploma,0,0,0
27270,25,State - DAMAN & DIU,Rural,15,Non-Technical Diploma,0,0,0
27271,25,State - DAMAN & DIU,Rural,16,Non-Technical Diploma,0,0,0
27272,25,State - DAMAN & DIU,Rural,17,Non-Technical Diploma,0,0,0
27273,25,State - DAMAN & DIU,Rural,18,Non-Technical Diploma,1,0,1
27274,25,State - DAMAN & DIU,Rural,19,Non-Technical Diploma,1,0,1
27275,25,State - DAMAN & DIU,Rural,20-24,Non-Technical Diploma,5,1,6
27276,25,State - DAMAN & DIU,Rural,25-29,Non-Technical Diploma,3,1,4
27277,25,State - DAMAN & DIU,Rural,30-34,Non-Technical Diploma,3,0,3
27278,25,State - DAMAN & DIU,Rural,35-39,Non-Technical Diploma,1,0,1
27279,25,State - DAMAN & DIU,Rural,40-44,Non-Technical Diploma,0,1,1
27280,25,State - DAMAN & DIU,Rural,45-49,Non-Technical Diploma,0,0,0
27281,25,State - DAMAN & DIU,Rural,50-54,Non-Technical Diploma,1,1,2
27282,25,State - DAMAN & DIU,Rural,55-59,Non-Technical Diploma,0,0,0
27283,25,State - DAMAN & DIU,Rural,60-64,Non-Technical Diploma,0,0,0
27284,25,State - DAMAN & DIU,Rural,65-69,Non-Technical Diploma,0,0,0
27285,25,State - DAMAN & DIU,Rural,70-74,Non-Technical Diploma,0,0,0
27286,25,State - DAMAN & DIU,Rural,75-79,Non-Technical Diploma,0,0,0
27287,25,State - DAMAN & DIU,Rural,80+,Non-Technical Diploma,0,1,1
27288,25,State - DAMAN & DIU,Rural,Age not stated,Non-Technical Diploma,0,0,0
27289,25,State - DAMAN & DIU,Urban,All ages,Non-Technical Diploma,105,37,142
27290,25,State - DAMAN & DIU,Urban,0-6,Non-Technical Diploma,0,0,0
27291,25,State - DAMAN & DIU,Urban,7,Non-Technical Diploma,0,0,0
27292,25,State - DAMAN & DIU,Urban,8,Non-Technical Diploma,0,0,0
27293,25,State - DAMAN & DIU,Urban,9,Non-Technical Diploma,0,0,0
27294,25,State - DAMAN & DIU,Urban,10,Non-Technical Diploma,0,0,0
27295,25,State - DAMAN & DIU,Urban,11,Non-Technical Diploma,0,0,0
27296,25,State - DAMAN & DIU,Urban,12,Non-Technical Diploma,0,0,0
27297,25,State - DAMAN & DIU,Urban,13,Non-Technical Diploma,0,0,0
27298,25,State - DAMAN & DIU,Urban,14,Non-Technical Diploma,0,0,0
27299,25,State - DAMAN & DIU,Urban,15,Non-Technical Diploma,0,0,0
27300,25,State - DAMAN & DIU,Urban,16,Non-Technical Diploma,0,0,0
27301,25,State - DAMAN & DIU,Urban,17,Non-Technical Diploma,0,0,0
27302,25,State - DAMAN & DIU,Urban,18,Non-Technical Diploma,1,1,2
27303,25,State - DAMAN & DIU,Urban,19,Non-Technical Diploma,2,3,5
27304,25,State - DAMAN & DIU,Urban,20-24,Non-Technical Diploma,18,12,30
27305,25,State - DAMAN & DIU,Urban,25-29,Non-Technical Diploma,15,5,20
27306,25,State - DAMAN & DIU,Urban,30-34,Non-Technical Diploma,17,6,23
27307,25,State - DAMAN & DIU,Urban,35-39,Non-Technical Diploma,22,5,27
27308,25,State - DAMAN & DIU,Urban,40-44,Non-Technical Diploma,14,2,16
27309,25,State - DAMAN & DIU,Urban,45-49,Non-Technical Diploma,3,3,6
27310,25,State - DAMAN & DIU,Urban,50-54,Non-Technical Diploma,3,0,3
27311,25,State - DAMAN & DIU,Urban,55-59,Non-Technical Diploma,3,0,3
27312,25,State - DAMAN & DIU,Urban,60-64,Non-Technical Diploma,1,0,1
27313,25,State - DAMAN & DIU,Urban,65-69,Non-Technical Diploma,4,0,4
27314,25,State - DAMAN & DIU,Urban,70-74,Non-Technical Diploma,2,0,2
27315,25,State - DAMAN & DIU,Urban,75-79,Non-Technical Diploma,0,0,0
27316,25,State - DAMAN & DIU,Urban,80+,Non-Technical Diploma,0,0,0
27317,25,State - DAMAN & DIU,Urban,Age not stated,Non-Technical Diploma,0,0,0
27318,26,State - DADRA & NAGAR HAVELI,Total,All ages,Non-Technical Diploma,275,69,344
27319,26,State - DADRA & NAGAR HAVELI,Total,0-6,Non-Technical Diploma,0,0,0
27320,26,State - DADRA & NAGAR HAVELI,Total,7,Non-Technical Diploma,0,0,0
27321,26,State - DADRA & NAGAR HAVELI,Total,8,Non-Technical Diploma,0,0,0
27322,26,State - DADRA & NAGAR HAVELI,Total,9,Non-Technical Diploma,0,0,0
27323,26,State - DADRA & NAGAR HAVELI,Total,10,Non-Technical Diploma,0,0,0
27324,26,State - DADRA & NAGAR HAVELI,Total,11,Non-Technical Diploma,0,0,0
27325,26,State - DADRA & NAGAR HAVELI,Total,12,Non-Technical Diploma,0,0,0
27326,26,State - DADRA & NAGAR HAVELI,Total,13,Non-Technical Diploma,0,0,0
27327,26,State - DADRA & NAGAR HAVELI,Total,14,Non-Technical Diploma,0,0,0
27328,26,State - DADRA & NAGAR HAVELI,Total,15,Non-Technical Diploma,0,0,0
27329,26,State - DADRA & NAGAR HAVELI,Total,16,Non-Technical Diploma,0,0,0
27330,26,State - DADRA & NAGAR HAVELI,Total,17,Non-Technical Diploma,0,0,0
27331,26,State - DADRA & NAGAR HAVELI,Total,18,Non-Technical Diploma,5,2,7
27332,26,State - DADRA & NAGAR HAVELI,Total,19,Non-Technical Diploma,9,3,12
27333,26,State - DADRA & NAGAR HAVELI,Total,20-24,Non-Technical Diploma,50,13,63
27334,26,State - DADRA & NAGAR HAVELI,Total,25-29,Non-Technical Diploma,60,12,72
27335,26,State - DADRA & NAGAR HAVELI,Total,30-34,Non-Technical Diploma,54,14,68
27336,26,State - DADRA & NAGAR HAVELI,Total,35-39,Non-Technical Diploma,42,14,56
27337,26,State - DADRA & NAGAR HAVELI,Total,40-44,Non-Technical Diploma,26,6,32
27338,26,State - DADRA & NAGAR HAVELI,Total,45-49,Non-Technical Diploma,10,5,15
27339,26,State - DADRA & NAGAR HAVELI,Total,50-54,Non-Technical Diploma,6,0,6
27340,26,State - DADRA & NAGAR HAVELI,Total,55-59,Non-Technical Diploma,2,0,2
27341,26,State - DADRA & NAGAR HAVELI,Total,60-64,Non-Technical Diploma,8,0,8
27342,26,State - DADRA & NAGAR HAVELI,Total,65-69,Non-Technical Diploma,2,0,2
27343,26,State - DADRA & NAGAR HAVELI,Total,70-74,Non-Technical Diploma,0,0,0
27344,26,State - DADRA & NAGAR HAVELI,Total,75-79,Non-Technical Diploma,1,0,1
27345,26,State - DADRA & NAGAR HAVELI,Total,80+,Non-Technical Diploma,0,0,0
27346,26,State - DADRA & NAGAR HAVELI,Total,Age not stated,Non-Technical Diploma,0,0,0
27347,26,State - DADRA & NAGAR HAVELI,Rural,All ages,Non-Technical Diploma,65,12,77
27348,26,State - DADRA & NAGAR HAVELI,Rural,0-6,Non-Technical Diploma,0,0,0
27349,26,State - DADRA & NAGAR HAVELI,Rural,7,Non-Technical Diploma,0,0,0
27350,26,State - DADRA & NAGAR HAVELI,Rural,8,Non-Technical Diploma,0,0,0
27351,26,State - DADRA & NAGAR HAVELI,Rural,9,Non-Technical Diploma,0,0,0
27352,26,State - DADRA & NAGAR HAVELI,Rural,10,Non-Technical Diploma,0,0,0
27353,26,State - DADRA & NAGAR HAVELI,Rural,11,Non-Technical Diploma,0,0,0
27354,26,State - DADRA & NAGAR HAVELI,Rural,12,Non-Technical Diploma,0,0,0
27355,26,State - DADRA & NAGAR HAVELI,Rural,13,Non-Technical Diploma,0,0,0
27356,26,State - DADRA & NAGAR HAVELI,Rural,14,Non-Technical Diploma,0,0,0
27357,26,State - DADRA & NAGAR HAVELI,Rural,15,Non-Technical Diploma,0,0,0
27358,26,State - DADRA & NAGAR HAVELI,Rural,16,Non-Technical Diploma,0,0,0
27359,26,State - DADRA & NAGAR HAVELI,Rural,17,Non-Technical Diploma,0,0,0
27360,26,State - DADRA & NAGAR HAVELI,Rural,18,Non-Technical Diploma,0,0,0
27361,26,State - DADRA & NAGAR HAVELI,Rural,19,Non-Technical Diploma,2,1,3
27362,26,State - DADRA & NAGAR HAVELI,Rural,20-24,Non-Technical Diploma,8,2,10
27363,26,State - DADRA & NAGAR HAVELI,Rural,25-29,Non-Technical Diploma,15,4,19
27364,26,State - DADRA & NAGAR HAVELI,Rural,30-34,Non-Technical Diploma,18,2,20
27365,26,State - DADRA & NAGAR HAVELI,Rural,35-39,Non-Technical Diploma,10,1,11
27366,26,State - DADRA & NAGAR HAVELI,Rural,40-44,Non-Technical Diploma,5,2,7
27367,26,State - DADRA & NAGAR HAVELI,Rural,45-49,Non-Technical Diploma,3,0,3
27368,26,State - DADRA & NAGAR HAVELI,Rural,50-54,Non-Technical Diploma,2,0,2
27369,26,State - DADRA & NAGAR HAVELI,Rural,55-59,Non-Technical Diploma,1,0,1
27370,26,State - DADRA & NAGAR HAVELI,Rural,60-64,Non-Technical Diploma,1,0,1
27371,26,State - DADRA & NAGAR HAVELI,Rural,65-69,Non-Technical Diploma,0,0,0
27372,26,State - DADRA & NAGAR HAVELI,Rural,70-74,Non-Technical Diploma,0,0,0
27373,26,State - DADRA & NAGAR HAVELI,Rural,75-79,Non-Technical Diploma,0,0,0
27374,26,State - DADRA & NAGAR HAVELI,Rural,80+,Non-Technical Diploma,0,0,0
27375,26,State - DADRA & NAGAR HAVELI,Rural,Age not stated,Non-Technical Diploma,0,0,0
27376,26,State - DADRA & NAGAR HAVELI,Urban,All ages,Non-Technical Diploma,210,57,267
27377,26,State - DADRA & NAGAR HAVELI,Urban,0-6,Non-Technical Diploma,0,0,0
27378,26,State - DADRA & NAGAR HAVELI,Urban,7,Non-Technical Diploma,0,0,0
27379,26,State - DADRA & NAGAR HAVELI,Urban,8,Non-Technical Diploma,0,0,0
27380,26,State - DADRA & NAGAR HAVELI,Urban,9,Non-Technical Diploma,0,0,0
27381,26,State - DADRA & NAGAR HAVELI,Urban,10,Non-Technical Diploma,0,0,0
27382,26,State - DADRA & NAGAR HAVELI,Urban,11,Non-Technical Diploma,0,0,0
27383,26,State - DADRA & NAGAR HAVELI,Urban,12,Non-Technical Diploma,0,0,0
27384,26,State - DADRA & NAGAR HAVELI,Urban,13,Non-Technical Diploma,0,0,0
27385,26,State - DADRA & NAGAR HAVELI,Urban,14,Non-Technical Diploma,0,0,0
27386,26,State - DADRA & NAGAR HAVELI,Urban,15,Non-Technical Diploma,0,0,0
27387,26,State - DADRA & NAGAR HAVELI,Urban,16,Non-Technical Diploma,0,0,0
27388,26,State - DADRA & NAGAR HAVELI,Urban,17,Non-Technical Diploma,0,0,0
27389,26,State - DADRA & NAGAR HAVELI,Urban,18,Non-Technical Diploma,5,2,7
27390,26,State - DADRA & NAGAR HAVELI,Urban,19,Non-Technical Diploma,7,2,9
27391,26,State - DADRA & NAGAR HAVELI,Urban,20-24,Non-Technical Diploma,42,11,53
27392,26,State - DADRA & NAGAR HAVELI,Urban,25-29,Non-Technical Diploma,45,8,53
27393,26,State - DADRA & NAGAR HAVELI,Urban,30-34,Non-Technical Diploma,36,12,48
27394,26,State - DADRA & NAGAR HAVELI,Urban,35-39,Non-Technical Diploma,32,13,45
27395,26,State - DADRA & NAGAR HAVELI,Urban,40-44,Non-Technical Diploma,21,4,25
27396,26,State - DADRA & NAGAR HAVELI,Urban,45-49,Non-Technical Diploma,7,5,12
27397,26,State - DADRA & NAGAR HAVELI,Urban,50-54,Non-Technical Diploma,4,0,4
27398,26,State - DADRA & NAGAR HAVELI,Urban,55-59,Non-Technical Diploma,1,0,1
27399,26,State - DADRA & NAGAR HAVELI,Urban,60-64,Non-Technical Diploma,7,0,7
27400,26,State - DADRA & NAGAR HAVELI,Urban,65-69,Non-Technical Diploma,2,0,2
27401,26,State - DADRA & NAGAR HAVELI,Urban,70-74,Non-Technical Diploma,0,0,0
27402,26,State - DADRA & NAGAR HAVELI,Urban,75-79,Non-Technical Diploma,1,0,1
27403,26,State - DADRA & NAGAR HAVELI,Urban,80+,Non-Technical Diploma,0,0,0
27404,26,State - DADRA & NAGAR HAVELI,Urban,Age not stated,Non-Technical Diploma,0,0,0
27405,27,State - MAHARASHTRA,Total,All ages,Non-Technical Diploma,58561,24973,83534
27406,27,State - MAHARASHTRA,Total,0-6,Non-Technical Diploma,0,0,0
27407,27,State - MAHARASHTRA,Total,7,Non-Technical Diploma,0,0,0
27408,27,State - MAHARASHTRA,Total,8,Non-Technical Diploma,0,0,0
27409,27,State - MAHARASHTRA,Total,9,Non-Technical Diploma,0,0,0
27410,27,State - MAHARASHTRA,Total,10,Non-Technical Diploma,0,0,0
27411,27,State - MAHARASHTRA,Total,11,Non-Technical Diploma,0,0,0
27412,27,State - MAHARASHTRA,Total,12,Non-Technical Diploma,0,0,0
27413,27,State - MAHARASHTRA,Total,13,Non-Technical Diploma,0,0,0
27414,27,State - MAHARASHTRA,Total,14,Non-Technical Diploma,0,0,0
27415,27,State - MAHARASHTRA,Total,15,Non-Technical Diploma,0,0,0
27416,27,State - MAHARASHTRA,Total,16,Non-Technical Diploma,0,0,0
27417,27,State - MAHARASHTRA,Total,17,Non-Technical Diploma,0,0,0
27418,27,State - MAHARASHTRA,Total,18,Non-Technical Diploma,3585,1776,5361
27419,27,State - MAHARASHTRA,Total,19,Non-Technical Diploma,3339,1550,4889
27420,27,State - MAHARASHTRA,Total,20-24,Non-Technical Diploma,12121,6457,18578
27421,27,State - MAHARASHTRA,Total,25-29,Non-Technical Diploma,8446,4717,13163
27422,27,State - MAHARASHTRA,Total,30-34,Non-Technical Diploma,7642,3349,10991
27423,27,State - MAHARASHTRA,Total,35-39,Non-Technical Diploma,6025,2395,8420
27424,27,State - MAHARASHTRA,Total,40-44,Non-Technical Diploma,4695,1391,6086
27425,27,State - MAHARASHTRA,Total,45-49,Non-Technical Diploma,3436,918,4354
27426,27,State - MAHARASHTRA,Total,50-54,Non-Technical Diploma,2535,663,3198
27427,27,State - MAHARASHTRA,Total,55-59,Non-Technical Diploma,1824,541,2365
27428,27,State - MAHARASHTRA,Total,60-64,Non-Technical Diploma,1647,381,2028
27429,27,State - MAHARASHTRA,Total,65-69,Non-Technical Diploma,1324,312,1636
27430,27,State - MAHARASHTRA,Total,70-74,Non-Technical Diploma,818,181,999
27431,27,State - MAHARASHTRA,Total,75-79,Non-Technical Diploma,426,101,527
27432,27,State - MAHARASHTRA,Total,80+,Non-Technical Diploma,443,145,588
27433,27,State - MAHARASHTRA,Total,Age not stated,Non-Technical Diploma,255,96,351
27434,27,State - MAHARASHTRA,Rural,All ages,Non-Technical Diploma,12338,3815,16153
27435,27,State - MAHARASHTRA,Rural,0-6,Non-Technical Diploma,0,0,0
27436,27,State - MAHARASHTRA,Rural,7,Non-Technical Diploma,0,0,0
27437,27,State - MAHARASHTRA,Rural,8,Non-Technical Diploma,0,0,0
27438,27,State - MAHARASHTRA,Rural,9,Non-Technical Diploma,0,0,0
27439,27,State - MAHARASHTRA,Rural,10,Non-Technical Diploma,0,0,0
27440,27,State - MAHARASHTRA,Rural,11,Non-Technical Diploma,0,0,0
27441,27,State - MAHARASHTRA,Rural,12,Non-Technical Diploma,0,0,0
27442,27,State - MAHARASHTRA,Rural,13,Non-Technical Diploma,0,0,0
27443,27,State - MAHARASHTRA,Rural,14,Non-Technical Diploma,0,0,0
27444,27,State - MAHARASHTRA,Rural,15,Non-Technical Diploma,0,0,0
27445,27,State - MAHARASHTRA,Rural,16,Non-Technical Diploma,0,0,0
27446,27,State - MAHARASHTRA,Rural,17,Non-Technical Diploma,0,0,0
27447,27,State - MAHARASHTRA,Rural,18,Non-Technical Diploma,1248,531,1779
27448,27,State - MAHARASHTRA,Rural,19,Non-Technical Diploma,1223,462,1685
27449,27,State - MAHARASHTRA,Rural,20-24,Non-Technical Diploma,3840,1471,5311
27450,27,State - MAHARASHTRA,Rural,25-29,Non-Technical Diploma,1842,520,2362
27451,27,State - MAHARASHTRA,Rural,30-34,Non-Technical Diploma,1239,304,1543
27452,27,State - MAHARASHTRA,Rural,35-39,Non-Technical Diploma,855,179,1034
27453,27,State - MAHARASHTRA,Rural,40-44,Non-Technical Diploma,663,87,750
27454,27,State - MAHARASHTRA,Rural,45-49,Non-Technical Diploma,445,78,523
27455,27,State - MAHARASHTRA,Rural,50-54,Non-Technical Diploma,281,46,327
27456,27,State - MAHARASHTRA,Rural,55-59,Non-Technical Diploma,194,37,231
27457,27,State - MAHARASHTRA,Rural,60-64,Non-Technical Diploma,148,24,172
27458,27,State - MAHARASHTRA,Rural,65-69,Non-Technical Diploma,151,31,182
27459,27,State - MAHARASHTRA,Rural,70-74,Non-Technical Diploma,70,11,81
27460,27,State - MAHARASHTRA,Rural,75-79,Non-Technical Diploma,33,8,41
27461,27,State - MAHARASHTRA,Rural,80+,Non-Technical Diploma,48,14,62
27462,27,State - MAHARASHTRA,Rural,Age not stated,Non-Technical Diploma,58,12,70
27463,27,State - MAHARASHTRA,Urban,All ages,Non-Technical Diploma,46223,21158,67381
27464,27,State - MAHARASHTRA,Urban,0-6,Non-Technical Diploma,0,0,0
27465,27,State - MAHARASHTRA,Urban,7,Non-Technical Diploma,0,0,0
27466,27,State - MAHARASHTRA,Urban,8,Non-Technical Diploma,0,0,0
27467,27,State - MAHARASHTRA,Urban,9,Non-Technical Diploma,0,0,0
27468,27,State - MAHARASHTRA,Urban,10,Non-Technical Diploma,0,0,0
27469,27,State - MAHARASHTRA,Urban,11,Non-Technical Diploma,0,0,0
27470,27,State - MAHARASHTRA,Urban,12,Non-Technical Diploma,0,0,0
27471,27,State - MAHARASHTRA,Urban,13,Non-Technical Diploma,0,0,0
27472,27,State - MAHARASHTRA,Urban,14,Non-Technical Diploma,0,0,0
27473,27,State - MAHARASHTRA,Urban,15,Non-Technical Diploma,0,0,0
27474,27,State - MAHARASHTRA,Urban,16,Non-Technical Diploma,0,0,0
27475,27,State - MAHARASHTRA,Urban,17,Non-Technical Diploma,0,0,0
27476,27,State - MAHARASHTRA,Urban,18,Non-Technical Diploma,2337,1245,3582
27477,27,State - MAHARASHTRA,Urban,19,Non-Technical Diploma,2116,1088,3204
27478,27,State - MAHARASHTRA,Urban,20-24,Non-Technical Diploma,8281,4986,13267
27479,27,State - MAHARASHTRA,Urban,25-29,Non-Technical Diploma,6604,4197,10801
27480,27,State - MAHARASHTRA,Urban,30-34,Non-Technical Diploma,6403,3045,9448
27481,27,State - MAHARASHTRA,Urban,35-39,Non-Technical Diploma,5170,2216,7386
27482,27,State - MAHARASHTRA,Urban,40-44,Non-Technical Diploma,4032,1304,5336
27483,27,State - MAHARASHTRA,Urban,45-49,Non-Technical Diploma,2991,840,3831
27484,27,State - MAHARASHTRA,Urban,50-54,Non-Technical Diploma,2254,617,2871
27485,27,State - MAHARASHTRA,Urban,55-59,Non-Technical Diploma,1630,504,2134
27486,27,State - MAHARASHTRA,Urban,60-64,Non-Technical Diploma,1499,357,1856
27487,27,State - MAHARASHTRA,Urban,65-69,Non-Technical Diploma,1173,281,1454
27488,27,State - MAHARASHTRA,Urban,70-74,Non-Technical Diploma,748,170,918
27489,27,State - MAHARASHTRA,Urban,75-79,Non-Technical Diploma,393,93,486
27490,27,State - MAHARASHTRA,Urban,80+,Non-Technical Diploma,395,131,526
27491,27,State - MAHARASHTRA,Urban,Age not stated,Non-Technical Diploma,197,84,281
27492,28,State - ANDHRA PRADESH,Total,All ages,Non-Technical Diploma,72832,21666,94498
27493,28,State - ANDHRA PRADESH,Total,0-6,Non-Technical Diploma,0,0,0
27494,28,State - ANDHRA PRADESH,Total,7,Non-Technical Diploma,0,0,0
27495,28,State - ANDHRA PRADESH,Total,8,Non-Technical Diploma,0,0,0
27496,28,State - ANDHRA PRADESH,Total,9,Non-Technical Diploma,0,0,0
27497,28,State - ANDHRA PRADESH,Total,10,Non-Technical Diploma,0,0,0
27498,28,State - ANDHRA PRADESH,Total,11,Non-Technical Diploma,0,0,0
27499,28,State - ANDHRA PRADESH,Total,12,Non-Technical Diploma,0,0,0
27500,28,State - ANDHRA PRADESH,Total,13,Non-Technical Diploma,0,0,0
27501,28,State - ANDHRA PRADESH,Total,14,Non-Technical Diploma,0,0,0
27502,28,State - ANDHRA PRADESH,Total,15,Non-Technical Diploma,0,0,0
27503,28,State - ANDHRA PRADESH,Total,16,Non-Technical Diploma,0,0,0
27504,28,State - ANDHRA PRADESH,Total,17,Non-Technical Diploma,0,0,0
27505,28,State - ANDHRA PRADESH,Total,18,Non-Technical Diploma,4161,1879,6040
27506,28,State - ANDHRA PRADESH,Total,19,Non-Technical Diploma,3325,1309,4634
27507,28,State - ANDHRA PRADESH,Total,20-24,Non-Technical Diploma,12751,4562,17313
27508,28,State - ANDHRA PRADESH,Total,25-29,Non-Technical Diploma,9101,3321,12422
27509,28,State - ANDHRA PRADESH,Total,30-34,Non-Technical Diploma,8870,2609,11479
27510,28,State - ANDHRA PRADESH,Total,35-39,Non-Technical Diploma,8667,2424,11091
27511,28,State - ANDHRA PRADESH,Total,40-44,Non-Technical Diploma,7101,1458,8559
27512,28,State - ANDHRA PRADESH,Total,45-49,Non-Technical Diploma,4912,1014,5926
27513,28,State - ANDHRA PRADESH,Total,50-54,Non-Technical Diploma,3491,760,4251
27514,28,State - ANDHRA PRADESH,Total,55-59,Non-Technical Diploma,2791,671,3462
27515,28,State - ANDHRA PRADESH,Total,60-64,Non-Technical Diploma,2728,570,3298
27516,28,State - ANDHRA PRADESH,Total,65-69,Non-Technical Diploma,1945,319,2264
27517,28,State - ANDHRA PRADESH,Total,70-74,Non-Technical Diploma,949,201,1150
27518,28,State - ANDHRA PRADESH,Total,75-79,Non-Technical Diploma,426,90,516
27519,28,State - ANDHRA PRADESH,Total,80+,Non-Technical Diploma,476,145,621
27520,28,State - ANDHRA PRADESH,Total,Age not stated,Non-Technical Diploma,1138,334,1472
27521,28,State - ANDHRA PRADESH,Rural,All ages,Non-Technical Diploma,19905,5014,24919
27522,28,State - ANDHRA PRADESH,Rural,0-6,Non-Technical Diploma,0,0,0
27523,28,State - ANDHRA PRADESH,Rural,7,Non-Technical Diploma,0,0,0
27524,28,State - ANDHRA PRADESH,Rural,8,Non-Technical Diploma,0,0,0
27525,28,State - ANDHRA PRADESH,Rural,9,Non-Technical Diploma,0,0,0
27526,28,State - ANDHRA PRADESH,Rural,10,Non-Technical Diploma,0,0,0
27527,28,State - ANDHRA PRADESH,Rural,11,Non-Technical Diploma,0,0,0
27528,28,State - ANDHRA PRADESH,Rural,12,Non-Technical Diploma,0,0,0
27529,28,State - ANDHRA PRADESH,Rural,13,Non-Technical Diploma,0,0,0
27530,28,State - ANDHRA PRADESH,Rural,14,Non-Technical Diploma,0,0,0
27531,28,State - ANDHRA PRADESH,Rural,15,Non-Technical Diploma,0,0,0
27532,28,State - ANDHRA PRADESH,Rural,16,Non-Technical Diploma,0,0,0
27533,28,State - ANDHRA PRADESH,Rural,17,Non-Technical Diploma,0,0,0
27534,28,State - ANDHRA PRADESH,Rural,18,Non-Technical Diploma,2060,745,2805
27535,28,State - ANDHRA PRADESH,Rural,19,Non-Technical Diploma,1647,491,2138
27536,28,State - ANDHRA PRADESH,Rural,20-24,Non-Technical Diploma,5527,1371,6898
27537,28,State - ANDHRA PRADESH,Rural,25-29,Non-Technical Diploma,3014,836,3850
27538,28,State - ANDHRA PRADESH,Rural,30-34,Non-Technical Diploma,2088,470,2558
27539,28,State - ANDHRA PRADESH,Rural,35-39,Non-Technical Diploma,1801,364,2165
27540,28,State - ANDHRA PRADESH,Rural,40-44,Non-Technical Diploma,1192,192,1384
27541,28,State - ANDHRA PRADESH,Rural,45-49,Non-Technical Diploma,659,134,793
27542,28,State - ANDHRA PRADESH,Rural,50-54,Non-Technical Diploma,413,97,510
27543,28,State - ANDHRA PRADESH,Rural,55-59,Non-Technical Diploma,363,70,433
27544,28,State - ANDHRA PRADESH,Rural,60-64,Non-Technical Diploma,396,84,480
27545,28,State - ANDHRA PRADESH,Rural,65-69,Non-Technical Diploma,232,42,274
27546,28,State - ANDHRA PRADESH,Rural,70-74,Non-Technical Diploma,137,21,158
27547,28,State - ANDHRA PRADESH,Rural,75-79,Non-Technical Diploma,93,15,108
27548,28,State - ANDHRA PRADESH,Rural,80+,Non-Technical Diploma,96,22,118
27549,28,State - ANDHRA PRADESH,Rural,Age not stated,Non-Technical Diploma,187,60,247
27550,28,State - ANDHRA PRADESH,Urban,All ages,Non-Technical Diploma,52927,16652,69579
27551,28,State - ANDHRA PRADESH,Urban,0-6,Non-Technical Diploma,0,0,0
27552,28,State - ANDHRA PRADESH,Urban,7,Non-Technical Diploma,0,0,0
27553,28,State - ANDHRA PRADESH,Urban,8,Non-Technical Diploma,0,0,0
27554,28,State - ANDHRA PRADESH,Urban,9,Non-Technical Diploma,0,0,0
27555,28,State - ANDHRA PRADESH,Urban,10,Non-Technical Diploma,0,0,0
27556,28,State - ANDHRA PRADESH,Urban,11,Non-Technical Diploma,0,0,0
27557,28,State - ANDHRA PRADESH,Urban,12,Non-Technical Diploma,0,0,0
27558,28,State - ANDHRA PRADESH,Urban,13,Non-Technical Diploma,0,0,0
27559,28,State - ANDHRA PRADESH,Urban,14,Non-Technical Diploma,0,0,0
27560,28,State - ANDHRA PRADESH,Urban,15,Non-Technical Diploma,0,0,0
27561,28,State - ANDHRA PRADESH,Urban,16,Non-Technical Diploma,0,0,0
27562,28,State - ANDHRA PRADESH,Urban,17,Non-Technical Diploma,0,0,0
27563,28,State - ANDHRA PRADESH,Urban,18,Non-Technical Diploma,2101,1134,3235
27564,28,State - ANDHRA PRADESH,Urban,19,Non-Technical Diploma,1678,818,2496
27565,28,State - ANDHRA PRADESH,Urban,20-24,Non-Technical Diploma,7224,3191,10415
27566,28,State - ANDHRA PRADESH,Urban,25-29,Non-Technical Diploma,6087,2485,8572
27567,28,State - ANDHRA PRADESH,Urban,30-34,Non-Technical Diploma,6782,2139,8921
27568,28,State - ANDHRA PRADESH,Urban,35-39,Non-Technical Diploma,6866,2060,8926
27569,28,State - ANDHRA PRADESH,Urban,40-44,Non-Technical Diploma,5909,1266,7175
27570,28,State - ANDHRA PRADESH,Urban,45-49,Non-Technical Diploma,4253,880,5133
27571,28,State - ANDHRA PRADESH,Urban,50-54,Non-Technical Diploma,3078,663,3741
27572,28,State - ANDHRA PRADESH,Urban,55-59,Non-Technical Diploma,2428,601,3029
27573,28,State - ANDHRA PRADESH,Urban,60-64,Non-Technical Diploma,2332,486,2818
27574,28,State - ANDHRA PRADESH,Urban,65-69,Non-Technical Diploma,1713,277,1990
27575,28,State - ANDHRA PRADESH,Urban,70-74,Non-Technical Diploma,812,180,992
27576,28,State - ANDHRA PRADESH,Urban,75-79,Non-Technical Diploma,333,75,408
27577,28,State - ANDHRA PRADESH,Urban,80+,Non-Technical Diploma,380,123,503
27578,28,State - ANDHRA PRADESH,Urban,Age not stated,Non-Technical Diploma,951,274,1225
27579,29,State - KARNATAKA,Total,All ages,Non-Technical Diploma,159259,46956,206215
27580,29,State - KARNATAKA,Total,0-6,Non-Technical Diploma,0,0,0
27581,29,State - KARNATAKA,Total,7,Non-Technical Diploma,0,0,0
27582,29,State - KARNATAKA,Total,8,Non-Technical Diploma,0,0,0
27583,29,State - KARNATAKA,Total,9,Non-Technical Diploma,0,0,0
27584,29,State - KARNATAKA,Total,10,Non-Technical Diploma,0,0,0
27585,29,State - KARNATAKA,Total,11,Non-Technical Diploma,0,0,0
27586,29,State - KARNATAKA,Total,12,Non-Technical Diploma,0,0,0
27587,29,State - KARNATAKA,Total,13,Non-Technical Diploma,0,0,0
27588,29,State - KARNATAKA,Total,14,Non-Technical Diploma,0,0,0
27589,29,State - KARNATAKA,Total,15,Non-Technical Diploma,0,0,0
27590,29,State - KARNATAKA,Total,16,Non-Technical Diploma,0,0,0
27591,29,State - KARNATAKA,Total,17,Non-Technical Diploma,0,0,0
27592,29,State - KARNATAKA,Total,18,Non-Technical Diploma,7319,3141,10460
27593,29,State - KARNATAKA,Total,19,Non-Technical Diploma,8205,3474,11679
27594,29,State - KARNATAKA,Total,20-24,Non-Technical Diploma,35918,13552,49470
27595,29,State - KARNATAKA,Total,25-29,Non-Technical Diploma,23695,8787,32482
27596,29,State - KARNATAKA,Total,30-34,Non-Technical Diploma,20674,6696,27370
27597,29,State - KARNATAKA,Total,35-39,Non-Technical Diploma,18711,4586,23297
27598,29,State - KARNATAKA,Total,40-44,Non-Technical Diploma,13757,2536,16293
27599,29,State - KARNATAKA,Total,45-49,Non-Technical Diploma,8679,1431,10110
27600,29,State - KARNATAKA,Total,50-54,Non-Technical Diploma,5652,932,6584
27601,29,State - KARNATAKA,Total,55-59,Non-Technical Diploma,4121,591,4712
27602,29,State - KARNATAKA,Total,60-64,Non-Technical Diploma,4442,460,4902
27603,29,State - KARNATAKA,Total,65-69,Non-Technical Diploma,3683,325,4008
27604,29,State - KARNATAKA,Total,70-74,Non-Technical Diploma,2246,156,2402
27605,29,State - KARNATAKA,Total,75-79,Non-Technical Diploma,1112,79,1191
27606,29,State - KARNATAKA,Total,80+,Non-Technical Diploma,962,176,1138
27607,29,State - KARNATAKA,Total,Age not stated,Non-Technical Diploma,83,34,117
27608,29,State - KARNATAKA,Rural,All ages,Non-Technical Diploma,40597,8821,49418
27609,29,State - KARNATAKA,Rural,0-6,Non-Technical Diploma,0,0,0
27610,29,State - KARNATAKA,Rural,7,Non-Technical Diploma,0,0,0
27611,29,State - KARNATAKA,Rural,8,Non-Technical Diploma,0,0,0
27612,29,State - KARNATAKA,Rural,9,Non-Technical Diploma,0,0,0
27613,29,State - KARNATAKA,Rural,10,Non-Technical Diploma,0,0,0
27614,29,State - KARNATAKA,Rural,11,Non-Technical Diploma,0,0,0
27615,29,State - KARNATAKA,Rural,12,Non-Technical Diploma,0,0,0
27616,29,State - KARNATAKA,Rural,13,Non-Technical Diploma,0,0,0
27617,29,State - KARNATAKA,Rural,14,Non-Technical Diploma,0,0,0
27618,29,State - KARNATAKA,Rural,15,Non-Technical Diploma,0,0,0
27619,29,State - KARNATAKA,Rural,16,Non-Technical Diploma,0,0,0
27620,29,State - KARNATAKA,Rural,17,Non-Technical Diploma,0,0,0
27621,29,State - KARNATAKA,Rural,18,Non-Technical Diploma,3011,1023,4034
27622,29,State - KARNATAKA,Rural,19,Non-Technical Diploma,3252,1118,4370
27623,29,State - KARNATAKA,Rural,20-24,Non-Technical Diploma,13919,3627,17546
27624,29,State - KARNATAKA,Rural,25-29,Non-Technical Diploma,6248,1347,7595
27625,29,State - KARNATAKA,Rural,30-34,Non-Technical Diploma,4192,701,4893
27626,29,State - KARNATAKA,Rural,35-39,Non-Technical Diploma,3718,430,4148
27627,29,State - KARNATAKA,Rural,40-44,Non-Technical Diploma,2575,253,2828
27628,29,State - KARNATAKA,Rural,45-49,Non-Technical Diploma,1306,118,1424
27629,29,State - KARNATAKA,Rural,50-54,Non-Technical Diploma,642,64,706
27630,29,State - KARNATAKA,Rural,55-59,Non-Technical Diploma,443,41,484
27631,29,State - KARNATAKA,Rural,60-64,Non-Technical Diploma,405,24,429
27632,29,State - KARNATAKA,Rural,65-69,Non-Technical Diploma,350,33,383
27633,29,State - KARNATAKA,Rural,70-74,Non-Technical Diploma,242,16,258
27634,29,State - KARNATAKA,Rural,75-79,Non-Technical Diploma,140,5,145
27635,29,State - KARNATAKA,Rural,80+,Non-Technical Diploma,132,17,149
27636,29,State - KARNATAKA,Rural,Age not stated,Non-Technical Diploma,22,4,26
27637,29,State - KARNATAKA,Urban,All ages,Non-Technical Diploma,118662,38135,156797
27638,29,State - KARNATAKA,Urban,0-6,Non-Technical Diploma,0,0,0
27639,29,State - KARNATAKA,Urban,7,Non-Technical Diploma,0,0,0
27640,29,State - KARNATAKA,Urban,8,Non-Technical Diploma,0,0,0
27641,29,State - KARNATAKA,Urban,9,Non-Technical Diploma,0,0,0
27642,29,State - KARNATAKA,Urban,10,Non-Technical Diploma,0,0,0
27643,29,State - KARNATAKA,Urban,11,Non-Technical Diploma,0,0,0
27644,29,State - KARNATAKA,Urban,12,Non-Technical Diploma,0,0,0
27645,29,State - KARNATAKA,Urban,13,Non-Technical Diploma,0,0,0
27646,29,State - KARNATAKA,Urban,14,Non-Technical Diploma,0,0,0
27647,29,State - KARNATAKA,Urban,15,Non-Technical Diploma,0,0,0
27648,29,State - KARNATAKA,Urban,16,Non-Technical Diploma,0,0,0
27649,29,State - KARNATAKA,Urban,17,Non-Technical Diploma,0,0,0
27650,29,State - KARNATAKA,Urban,18,Non-Technical Diploma,4308,2118,6426
27651,29,State - KARNATAKA,Urban,19,Non-Technical Diploma,4953,2356,7309
27652,29,State - KARNATAKA,Urban,20-24,Non-Technical Diploma,21999,9925,31924
27653,29,State - KARNATAKA,Urban,25-29,Non-Technical Diploma,17447,7440,24887
27654,29,State - KARNATAKA,Urban,30-34,Non-Technical Diploma,16482,5995,22477
27655,29,State - KARNATAKA,Urban,35-39,Non-Technical Diploma,14993,4156,19149
27656,29,State - KARNATAKA,Urban,40-44,Non-Technical Diploma,11182,2283,13465
27657,29,State - KARNATAKA,Urban,45-49,Non-Technical Diploma,7373,1313,8686
27658,29,State - KARNATAKA,Urban,50-54,Non-Technical Diploma,5010,868,5878
27659,29,State - KARNATAKA,Urban,55-59,Non-Technical Diploma,3678,550,4228
27660,29,State - KARNATAKA,Urban,60-64,Non-Technical Diploma,4037,436,4473
27661,29,State - KARNATAKA,Urban,65-69,Non-Technical Diploma,3333,292,3625
27662,29,State - KARNATAKA,Urban,70-74,Non-Technical Diploma,2004,140,2144
27663,29,State - KARNATAKA,Urban,75-79,Non-Technical Diploma,972,74,1046
27664,29,State - KARNATAKA,Urban,80+,Non-Technical Diploma,830,159,989
27665,29,State - KARNATAKA,Urban,Age not stated,Non-Technical Diploma,61,30,91
27666,30,State - GOA,Total,All ages,Non-Technical Diploma,1160,796,1956
27667,30,State - GOA,Total,0-6,Non-Technical Diploma,0,0,0
27668,30,State - GOA,Total,7,Non-Technical Diploma,0,0,0
27669,30,State - GOA,Total,8,Non-Technical Diploma,0,0,0
27670,30,State - GOA,Total,9,Non-Technical Diploma,0,0,0
27671,30,State - GOA,Total,10,Non-Technical Diploma,0,0,0
27672,30,State - GOA,Total,11,Non-Technical Diploma,0,0,0
27673,30,State - GOA,Total,12,Non-Technical Diploma,0,0,0
27674,30,State - GOA,Total,13,Non-Technical Diploma,0,0,0
27675,30,State - GOA,Total,14,Non-Technical Diploma,0,0,0
27676,30,State - GOA,Total,15,Non-Technical Diploma,0,0,0
27677,30,State - GOA,Total,16,Non-Technical Diploma,0,0,0
27678,30,State - GOA,Total,17,Non-Technical Diploma,0,0,0
27679,30,State - GOA,Total,18,Non-Technical Diploma,44,27,71
27680,30,State - GOA,Total,19,Non-Technical Diploma,47,18,65
27681,30,State - GOA,Total,20-24,Non-Technical Diploma,258,139,397
27682,30,State - GOA,Total,25-29,Non-Technical Diploma,171,119,290
27683,30,State - GOA,Total,30-34,Non-Technical Diploma,136,84,220
27684,30,State - GOA,Total,35-39,Non-Technical Diploma,104,68,172
27685,30,State - GOA,Total,40-44,Non-Technical Diploma,87,56,143
27686,30,State - GOA,Total,45-49,Non-Technical Diploma,76,49,125
27687,30,State - GOA,Total,50-54,Non-Technical Diploma,41,59,100
27688,30,State - GOA,Total,55-59,Non-Technical Diploma,49,49,98
27689,30,State - GOA,Total,60-64,Non-Technical Diploma,33,32,65
27690,30,State - GOA,Total,65-69,Non-Technical Diploma,33,28,61
27691,30,State - GOA,Total,70-74,Non-Technical Diploma,29,24,53
27692,30,State - GOA,Total,75-79,Non-Technical Diploma,27,18,45
27693,30,State - GOA,Total,80+,Non-Technical Diploma,25,25,50
27694,30,State - GOA,Total,Age not stated,Non-Technical Diploma,0,1,1
27695,30,State - GOA,Rural,All ages,Non-Technical Diploma,276,180,456
27696,30,State - GOA,Rural,0-6,Non-Technical Diploma,0,0,0
27697,30,State - GOA,Rural,7,Non-Technical Diploma,0,0,0
27698,30,State - GOA,Rural,8,Non-Technical Diploma,0,0,0
27699,30,State - GOA,Rural,9,Non-Technical Diploma,0,0,0
27700,30,State - GOA,Rural,10,Non-Technical Diploma,0,0,0
27701,30,State - GOA,Rural,11,Non-Technical Diploma,0,0,0
27702,30,State - GOA,Rural,12,Non-Technical Diploma,0,0,0
27703,30,State - GOA,Rural,13,Non-Technical Diploma,0,0,0
27704,30,State - GOA,Rural,14,Non-Technical Diploma,0,0,0
27705,30,State - GOA,Rural,15,Non-Technical Diploma,0,0,0
27706,30,State - GOA,Rural,16,Non-Technical Diploma,0,0,0
27707,30,State - GOA,Rural,17,Non-Technical Diploma,0,0,0
27708,30,State - GOA,Rural,18,Non-Technical Diploma,17,7,24
27709,30,State - GOA,Rural,19,Non-Technical Diploma,14,5,19
27710,30,State - GOA,Rural,20-24,Non-Technical Diploma,71,43,114
27711,30,State - GOA,Rural,25-29,Non-Technical Diploma,42,36,78
27712,30,State - GOA,Rural,30-34,Non-Technical Diploma,39,15,54
27713,30,State - GOA,Rural,35-39,Non-Technical Diploma,25,17,42
27714,30,State - GOA,Rural,40-44,Non-Technical Diploma,14,11,25
27715,30,State - GOA,Rural,45-49,Non-Technical Diploma,12,4,16
27716,30,State - GOA,Rural,50-54,Non-Technical Diploma,8,6,14
27717,30,State - GOA,Rural,55-59,Non-Technical Diploma,9,13,22
27718,30,State - GOA,Rural,60-64,Non-Technical Diploma,7,5,12
27719,30,State - GOA,Rural,65-69,Non-Technical Diploma,3,7,10
27720,30,State - GOA,Rural,70-74,Non-Technical Diploma,6,7,13
27721,30,State - GOA,Rural,75-79,Non-Technical Diploma,4,3,7
27722,30,State - GOA,Rural,80+,Non-Technical Diploma,5,0,5
27723,30,State - GOA,Rural,Age not stated,Non-Technical Diploma,0,1,1
27724,30,State - GOA,Urban,All ages,Non-Technical Diploma,884,616,1500
27725,30,State - GOA,Urban,0-6,Non-Technical Diploma,0,0,0
27726,30,State - GOA,Urban,7,Non-Technical Diploma,0,0,0
27727,30,State - GOA,Urban,8,Non-Technical Diploma,0,0,0
27728,30,State - GOA,Urban,9,Non-Technical Diploma,0,0,0
27729,30,State - GOA,Urban,10,Non-Technical Diploma,0,0,0
27730,30,State - GOA,Urban,11,Non-Technical Diploma,0,0,0
27731,30,State - GOA,Urban,12,Non-Technical Diploma,0,0,0
27732,30,State - GOA,Urban,13,Non-Technical Diploma,0,0,0
27733,30,State - GOA,Urban,14,Non-Technical Diploma,0,0,0
27734,30,State - GOA,Urban,15,Non-Technical Diploma,0,0,0
27735,30,State - GOA,Urban,16,Non-Technical Diploma,0,0,0
27736,30,State - GOA,Urban,17,Non-Technical Diploma,0,0,0
27737,30,State - GOA,Urban,18,Non-Technical Diploma,27,20,47
27738,30,State - GOA,Urban,19,Non-Technical Diploma,33,13,46
27739,30,State - GOA,Urban,20-24,Non-Technical Diploma,187,96,283
27740,30,State - GOA,Urban,25-29,Non-Technical Diploma,129,83,212
27741,30,State - GOA,Urban,30-34,Non-Technical Diploma,97,69,166
27742,30,State - GOA,Urban,35-39,Non-Technical Diploma,79,51,130
27743,30,State - GOA,Urban,40-44,Non-Technical Diploma,73,45,118
27744,30,State - GOA,Urban,45-49,Non-Technical Diploma,64,45,109
27745,30,State - GOA,Urban,50-54,Non-Technical Diploma,33,53,86
27746,30,State - GOA,Urban,55-59,Non-Technical Diploma,40,36,76
27747,30,State - GOA,Urban,60-64,Non-Technical Diploma,26,27,53
27748,30,State - GOA,Urban,65-69,Non-Technical Diploma,30,21,51
27749,30,State - GOA,Urban,70-74,Non-Technical Diploma,23,17,40
27750,30,State - GOA,Urban,75-79,Non-Technical Diploma,23,15,38
27751,30,State - GOA,Urban,80+,Non-Technical Diploma,20,25,45
27752,30,State - GOA,Urban,Age not stated,Non-Technical Diploma,0,0,0
27753,31,State - LAKSHADWEEP,Total,All ages,Non-Technical Diploma,77,35,112
27754,31,State - LAKSHADWEEP,Total,0-6,Non-Technical Diploma,0,0,0
27755,31,State - LAKSHADWEEP,Total,7,Non-Technical Diploma,0,0,0
27756,31,State - LAKSHADWEEP,Total,8,Non-Technical Diploma,0,0,0
27757,31,State - LAKSHADWEEP,Total,9,Non-Technical Diploma,0,0,0
27758,31,State - LAKSHADWEEP,Total,10,Non-Technical Diploma,0,0,0
27759,31,State - LAKSHADWEEP,Total,11,Non-Technical Diploma,0,0,0
27760,31,State - LAKSHADWEEP,Total,12,Non-Technical Diploma,0,0,0
27761,31,State - LAKSHADWEEP,Total,13,Non-Technical Diploma,0,0,0
27762,31,State - LAKSHADWEEP,Total,14,Non-Technical Diploma,0,0,0
27763,31,State - LAKSHADWEEP,Total,15,Non-Technical Diploma,0,0,0
27764,31,State - LAKSHADWEEP,Total,16,Non-Technical Diploma,0,0,0
27765,31,State - LAKSHADWEEP,Total,17,Non-Technical Diploma,0,0,0
27766,31,State - LAKSHADWEEP,Total,18,Non-Technical Diploma,0,0,0
27767,31,State - LAKSHADWEEP,Total,19,Non-Technical Diploma,0,0,0
27768,31,State - LAKSHADWEEP,Total,20-24,Non-Technical Diploma,4,2,6
27769,31,State - LAKSHADWEEP,Total,25-29,Non-Technical Diploma,8,6,14
27770,31,State - LAKSHADWEEP,Total,30-34,Non-Technical Diploma,7,4,11
27771,31,State - LAKSHADWEEP,Total,35-39,Non-Technical Diploma,10,6,16
27772,31,State - LAKSHADWEEP,Total,40-44,Non-Technical Diploma,11,6,17
27773,31,State - LAKSHADWEEP,Total,45-49,Non-Technical Diploma,13,6,19
27774,31,State - LAKSHADWEEP,Total,50-54,Non-Technical Diploma,9,2,11
27775,31,State - LAKSHADWEEP,Total,55-59,Non-Technical Diploma,7,3,10
27776,31,State - LAKSHADWEEP,Total,60-64,Non-Technical Diploma,5,0,5
27777,31,State - LAKSHADWEEP,Total,65-69,Non-Technical Diploma,2,0,2
27778,31,State - LAKSHADWEEP,Total,70-74,Non-Technical Diploma,0,0,0
27779,31,State - LAKSHADWEEP,Total,75-79,Non-Technical Diploma,1,0,1
27780,31,State - LAKSHADWEEP,Total,80+,Non-Technical Diploma,0,0,0
27781,31,State - LAKSHADWEEP,Total,Age not stated,Non-Technical Diploma,0,0,0
27782,31,State - LAKSHADWEEP,Rural,All ages,Non-Technical Diploma,23,7,30
27783,31,State - LAKSHADWEEP,Rural,0-6,Non-Technical Diploma,0,0,0
27784,31,State - LAKSHADWEEP,Rural,7,Non-Technical Diploma,0,0,0
27785,31,State - LAKSHADWEEP,Rural,8,Non-Technical Diploma,0,0,0
27786,31,State - LAKSHADWEEP,Rural,9,Non-Technical Diploma,0,0,0
27787,31,State - LAKSHADWEEP,Rural,10,Non-Technical Diploma,0,0,0
27788,31,State - LAKSHADWEEP,Rural,11,Non-Technical Diploma,0,0,0
27789,31,State - LAKSHADWEEP,Rural,12,Non-Technical Diploma,0,0,0
27790,31,State - LAKSHADWEEP,Rural,13,Non-Technical Diploma,0,0,0
27791,31,State - LAKSHADWEEP,Rural,14,Non-Technical Diploma,0,0,0
27792,31,State - LAKSHADWEEP,Rural,15,Non-Technical Diploma,0,0,0
27793,31,State - LAKSHADWEEP,Rural,16,Non-Technical Diploma,0,0,0
27794,31,State - LAKSHADWEEP,Rural,17,Non-Technical Diploma,0,0,0
27795,31,State - LAKSHADWEEP,Rural,18,Non-Technical Diploma,0,0,0
27796,31,State - LAKSHADWEEP,Rural,19,Non-Technical Diploma,0,0,0
27797,31,State - LAKSHADWEEP,Rural,20-24,Non-Technical Diploma,2,0,2
27798,31,State - LAKSHADWEEP,Rural,25-29,Non-Technical Diploma,1,1,2
27799,31,State - LAKSHADWEEP,Rural,30-34,Non-Technical Diploma,3,0,3
27800,31,State - LAKSHADWEEP,Rural,35-39,Non-Technical Diploma,2,2,4
27801,31,State - LAKSHADWEEP,Rural,40-44,Non-Technical Diploma,3,3,6
27802,31,State - LAKSHADWEEP,Rural,45-49,Non-Technical Diploma,5,1,6
27803,31,State - LAKSHADWEEP,Rural,50-54,Non-Technical Diploma,2,0,2
27804,31,State - LAKSHADWEEP,Rural,55-59,Non-Technical Diploma,4,0,4
27805,31,State - LAKSHADWEEP,Rural,60-64,Non-Technical Diploma,1,0,1
27806,31,State - LAKSHADWEEP,Rural,65-69,Non-Technical Diploma,0,0,0
27807,31,State - LAKSHADWEEP,Rural,70-74,Non-Technical Diploma,0,0,0
27808,31,State - LAKSHADWEEP,Rural,75-79,Non-Technical Diploma,0,0,0
27809,31,State - LAKSHADWEEP,Rural,80+,Non-Technical Diploma,0,0,0
27810,31,State - LAKSHADWEEP,Rural,Age not stated,Non-Technical Diploma,0,0,0
27811,31,State - LAKSHADWEEP,Urban,All ages,Non-Technical Diploma,54,28,82
27812,31,State - LAKSHADWEEP,Urban,0-6,Non-Technical Diploma,0,0,0
27813,31,State - LAKSHADWEEP,Urban,7,Non-Technical Diploma,0,0,0
27814,31,State - LAKSHADWEEP,Urban,8,Non-Technical Diploma,0,0,0
27815,31,State - LAKSHADWEEP,Urban,9,Non-Technical Diploma,0,0,0
27816,31,State - LAKSHADWEEP,Urban,10,Non-Technical Diploma,0,0,0
27817,31,State - LAKSHADWEEP,Urban,11,Non-Technical Diploma,0,0,0
27818,31,State - LAKSHADWEEP,Urban,12,Non-Technical Diploma,0,0,0
27819,31,State - LAKSHADWEEP,Urban,13,Non-Technical Diploma,0,0,0
27820,31,State - LAKSHADWEEP,Urban,14,Non-Technical Diploma,0,0,0
27821,31,State - LAKSHADWEEP,Urban,15,Non-Technical Diploma,0,0,0
27822,31,State - LAKSHADWEEP,Urban,16,Non-Technical Diploma,0,0,0
27823,31,State - LAKSHADWEEP,Urban,17,Non-Technical Diploma,0,0,0
27824,31,State - LAKSHADWEEP,Urban,18,Non-Technical Diploma,0,0,0
27825,31,State - LAKSHADWEEP,Urban,19,Non-Technical Diploma,0,0,0
27826,31,State - LAKSHADWEEP,Urban,20-24,Non-Technical Diploma,2,2,4
27827,31,State - LAKSHADWEEP,Urban,25-29,Non-Technical Diploma,7,5,12
27828,31,State - LAKSHADWEEP,Urban,30-34,Non-Technical Diploma,4,4,8
27829,31,State - LAKSHADWEEP,Urban,35-39,Non-Technical Diploma,8,4,12
27830,31,State - LAKSHADWEEP,Urban,40-44,Non-Technical Diploma,8,3,11
27831,31,State - LAKSHADWEEP,Urban,45-49,Non-Technical Diploma,8,5,13
27832,31,State - LAKSHADWEEP,Urban,50-54,Non-Technical Diploma,7,2,9
27833,31,State - LAKSHADWEEP,Urban,55-59,Non-Technical Diploma,3,3,6
27834,31,State - LAKSHADWEEP,Urban,60-64,Non-Technical Diploma,4,0,4
27835,31,State - LAKSHADWEEP,Urban,65-69,Non-Technical Diploma,2,0,2
27836,31,State - LAKSHADWEEP,Urban,70-74,Non-Technical Diploma,0,0,0
27837,31,State - LAKSHADWEEP,Urban,75-79,Non-Technical Diploma,1,0,1
27838,31,State - LAKSHADWEEP,Urban,80+,Non-Technical Diploma,0,0,0
27839,31,State - LAKSHADWEEP,Urban,Age not stated,Non-Technical Diploma,0,0,0
27840,32,State - KERALA,Total,All ages,Non-Technical Diploma,34264,39593,73857
27841,32,State - KERALA,Total,0-6,Non-Technical Diploma,0,0,0
27842,32,State - KERALA,Total,7,Non-Technical Diploma,0,0,0
27843,32,State - KERALA,Total,8,Non-Technical Diploma,0,0,0
27844,32,State - KERALA,Total,9,Non-Technical Diploma,0,0,0
27845,32,State - KERALA,Total,10,Non-Technical Diploma,0,0,0
27846,32,State - KERALA,Total,11,Non-Technical Diploma,0,0,0
27847,32,State - KERALA,Total,12,Non-Technical Diploma,0,0,0
27848,32,State - KERALA,Total,13,Non-Technical Diploma,0,0,0
27849,32,State - KERALA,Total,14,Non-Technical Diploma,0,0,0
27850,32,State - KERALA,Total,15,Non-Technical Diploma,0,0,0
27851,32,State - KERALA,Total,16,Non-Technical Diploma,0,0,0
27852,32,State - KERALA,Total,17,Non-Technical Diploma,0,0,0
27853,32,State - KERALA,Total,18,Non-Technical Diploma,691,794,1485
27854,32,State - KERALA,Total,19,Non-Technical Diploma,1032,1103,2135
27855,32,State - KERALA,Total,20-24,Non-Technical Diploma,6222,5939,12161
27856,32,State - KERALA,Total,25-29,Non-Technical Diploma,3939,4643,8582
27857,32,State - KERALA,Total,30-34,Non-Technical Diploma,3189,3396,6585
27858,32,State - KERALA,Total,35-39,Non-Technical Diploma,2651,4025,6676
27859,32,State - KERALA,Total,40-44,Non-Technical Diploma,2445,3611,6056
27860,32,State - KERALA,Total,45-49,Non-Technical Diploma,2260,2821,5081
27861,32,State - KERALA,Total,50-54,Non-Technical Diploma,2161,2225,4386
27862,32,State - KERALA,Total,55-59,Non-Technical Diploma,2641,3237,5878
27863,32,State - KERALA,Total,60-64,Non-Technical Diploma,2717,3658,6375
27864,32,State - KERALA,Total,65-69,Non-Technical Diploma,1858,2191,4049
27865,32,State - KERALA,Total,70-74,Non-Technical Diploma,1134,1089,2223
27866,32,State - KERALA,Total,75-79,Non-Technical Diploma,643,482,1125
27867,32,State - KERALA,Total,80+,Non-Technical Diploma,655,353,1008
27868,32,State - KERALA,Total,Age not stated,Non-Technical Diploma,26,26,52
27869,32,State - KERALA,Rural,All ages,Non-Technical Diploma,15733,19315,35048
27870,32,State - KERALA,Rural,0-6,Non-Technical Diploma,0,0,0
27871,32,State - KERALA,Rural,7,Non-Technical Diploma,0,0,0
27872,32,State - KERALA,Rural,8,Non-Technical Diploma,0,0,0
27873,32,State - KERALA,Rural,9,Non-Technical Diploma,0,0,0
27874,32,State - KERALA,Rural,10,Non-Technical Diploma,0,0,0
27875,32,State - KERALA,Rural,11,Non-Technical Diploma,0,0,0
27876,32,State - KERALA,Rural,12,Non-Technical Diploma,0,0,0
27877,32,State - KERALA,Rural,13,Non-Technical Diploma,0,0,0
27878,32,State - KERALA,Rural,14,Non-Technical Diploma,0,0,0
27879,32,State - KERALA,Rural,15,Non-Technical Diploma,0,0,0
27880,32,State - KERALA,Rural,16,Non-Technical Diploma,0,0,0
27881,32,State - KERALA,Rural,17,Non-Technical Diploma,0,0,0
27882,32,State - KERALA,Rural,18,Non-Technical Diploma,324,365,689
27883,32,State - KERALA,Rural,19,Non-Technical Diploma,534,507,1041
27884,32,State - KERALA,Rural,20-24,Non-Technical Diploma,2921,2762,5683
27885,32,State - KERALA,Rural,25-29,Non-Technical Diploma,1780,2169,3949
27886,32,State - KERALA,Rural,30-34,Non-Technical Diploma,1415,1631,3046
27887,32,State - KERALA,Rural,35-39,Non-Technical Diploma,1141,1968,3109
27888,32,State - KERALA,Rural,40-44,Non-Technical Diploma,1088,1885,2973
27889,32,State - KERALA,Rural,45-49,Non-Technical Diploma,1054,1350,2404
27890,32,State - KERALA,Rural,50-54,Non-Technical Diploma,976,1020,1996
27891,32,State - KERALA,Rural,55-59,Non-Technical Diploma,1292,1674,2966
27892,32,State - KERALA,Rural,60-64,Non-Technical Diploma,1248,1946,3194
27893,32,State - KERALA,Rural,65-69,Non-Technical Diploma,839,1123,1962
27894,32,State - KERALA,Rural,70-74,Non-Technical Diploma,502,524,1026
27895,32,State - KERALA,Rural,75-79,Non-Technical Diploma,296,227,523
27896,32,State - KERALA,Rural,80+,Non-Technical Diploma,311,153,464
27897,32,State - KERALA,Rural,Age not stated,Non-Technical Diploma,12,11,23
27898,32,State - KERALA,Urban,All ages,Non-Technical Diploma,18531,20278,38809
27899,32,State - KERALA,Urban,0-6,Non-Technical Diploma,0,0,0
27900,32,State - KERALA,Urban,7,Non-Technical Diploma,0,0,0
27901,32,State - KERALA,Urban,8,Non-Technical Diploma,0,0,0
27902,32,State - KERALA,Urban,9,Non-Technical Diploma,0,0,0
27903,32,State - KERALA,Urban,10,Non-Technical Diploma,0,0,0
27904,32,State - KERALA,Urban,11,Non-Technical Diploma,0,0,0
27905,32,State - KERALA,Urban,12,Non-Technical Diploma,0,0,0
27906,32,State - KERALA,Urban,13,Non-Technical Diploma,0,0,0
27907,32,State - KERALA,Urban,14,Non-Technical Diploma,0,0,0
27908,32,State - KERALA,Urban,15,Non-Technical Diploma,0,0,0
27909,32,State - KERALA,Urban,16,Non-Technical Diploma,0,0,0
27910,32,State - KERALA,Urban,17,Non-Technical Diploma,0,0,0
27911,32,State - KERALA,Urban,18,Non-Technical Diploma,367,429,796
27912,32,State - KERALA,Urban,19,Non-Technical Diploma,498,596,1094
27913,32,State - KERALA,Urban,20-24,Non-Technical Diploma,3301,3177,6478
27914,32,State - KERALA,Urban,25-29,Non-Technical Diploma,2159,2474,4633
27915,32,State - KERALA,Urban,30-34,Non-Technical Diploma,1774,1765,3539
27916,32,State - KERALA,Urban,35-39,Non-Technical Diploma,1510,2057,3567
27917,32,State - KERALA,Urban,40-44,Non-Technical Diploma,1357,1726,3083
27918,32,State - KERALA,Urban,45-49,Non-Technical Diploma,1206,1471,2677
27919,32,State - KERALA,Urban,50-54,Non-Technical Diploma,1185,1205,2390
27920,32,State - KERALA,Urban,55-59,Non-Technical Diploma,1349,1563,2912
27921,32,State - KERALA,Urban,60-64,Non-Technical Diploma,1469,1712,3181
27922,32,State - KERALA,Urban,65-69,Non-Technical Diploma,1019,1068,2087
27923,32,State - KERALA,Urban,70-74,Non-Technical Diploma,632,565,1197
27924,32,State - KERALA,Urban,75-79,Non-Technical Diploma,347,255,602
27925,32,State - KERALA,Urban,80+,Non-Technical Diploma,344,200,544
27926,32,State - KERALA,Urban,Age not stated,Non-Technical Diploma,14,15,29
27927,33,State - TAMIL NADU,Total,All ages,Non-Technical Diploma,116345,33741,150086
27928,33,State - TAMIL NADU,Total,0-6,Non-Technical Diploma,0,0,0
27929,33,State - TAMIL NADU,Total,7,Non-Technical Diploma,0,0,0
27930,33,State - TAMIL NADU,Total,8,Non-Technical Diploma,0,0,0
27931,33,State - TAMIL NADU,Total,9,Non-Technical Diploma,0,0,0
27932,33,State - TAMIL NADU,Total,10,Non-Technical Diploma,0,0,0
27933,33,State - TAMIL NADU,Total,11,Non-Technical Diploma,0,0,0
27934,33,State - TAMIL NADU,Total,12,Non-Technical Diploma,0,0,0
27935,33,State - TAMIL NADU,Total,13,Non-Technical Diploma,0,0,0
27936,33,State - TAMIL NADU,Total,14,Non-Technical Diploma,0,0,0
27937,33,State - TAMIL NADU,Total,15,Non-Technical Diploma,0,0,0
27938,33,State - TAMIL NADU,Total,16,Non-Technical Diploma,0,0,0
27939,33,State - TAMIL NADU,Total,17,Non-Technical Diploma,0,0,0
27940,33,State - TAMIL NADU,Total,18,Non-Technical Diploma,8860,1901,10761
27941,33,State - TAMIL NADU,Total,19,Non-Technical Diploma,9182,1924,11106
27942,33,State - TAMIL NADU,Total,20-24,Non-Technical Diploma,33085,8673,41758
27943,33,State - TAMIL NADU,Total,25-29,Non-Technical Diploma,18332,6574,24906
27944,33,State - TAMIL NADU,Total,30-34,Non-Technical Diploma,13470,4649,18119
27945,33,State - TAMIL NADU,Total,35-39,Non-Technical Diploma,10414,3988,14402
27946,33,State - TAMIL NADU,Total,40-44,Non-Technical Diploma,7849,2777,10626
27947,33,State - TAMIL NADU,Total,45-49,Non-Technical Diploma,4424,1216,5640
27948,33,State - TAMIL NADU,Total,50-54,Non-Technical Diploma,2855,662,3517
27949,33,State - TAMIL NADU,Total,55-59,Non-Technical Diploma,2271,469,2740
27950,33,State - TAMIL NADU,Total,60-64,Non-Technical Diploma,2063,383,2446
27951,33,State - TAMIL NADU,Total,65-69,Non-Technical Diploma,1551,189,1740
27952,33,State - TAMIL NADU,Total,70-74,Non-Technical Diploma,1013,141,1154
27953,33,State - TAMIL NADU,Total,75-79,Non-Technical Diploma,458,90,548
27954,33,State - TAMIL NADU,Total,80+,Non-Technical Diploma,444,77,521
27955,33,State - TAMIL NADU,Total,Age not stated,Non-Technical Diploma,74,28,102
27956,33,State - TAMIL NADU,Rural,All ages,Non-Technical Diploma,40493,10260,50753
27957,33,State - TAMIL NADU,Rural,0-6,Non-Technical Diploma,0,0,0
27958,33,State - TAMIL NADU,Rural,7,Non-Technical Diploma,0,0,0
27959,33,State - TAMIL NADU,Rural,8,Non-Technical Diploma,0,0,0
27960,33,State - TAMIL NADU,Rural,9,Non-Technical Diploma,0,0,0
27961,33,State - TAMIL NADU,Rural,10,Non-Technical Diploma,0,0,0
27962,33,State - TAMIL NADU,Rural,11,Non-Technical Diploma,0,0,0
27963,33,State - TAMIL NADU,Rural,12,Non-Technical Diploma,0,0,0
27964,33,State - TAMIL NADU,Rural,13,Non-Technical Diploma,0,0,0
27965,33,State - TAMIL NADU,Rural,14,Non-Technical Diploma,0,0,0
27966,33,State - TAMIL NADU,Rural,15,Non-Technical Diploma,0,0,0
27967,33,State - TAMIL NADU,Rural,16,Non-Technical Diploma,0,0,0
27968,33,State - TAMIL NADU,Rural,17,Non-Technical Diploma,0,0,0
27969,33,State - TAMIL NADU,Rural,18,Non-Technical Diploma,4245,734,4979
27970,33,State - TAMIL NADU,Rural,19,Non-Technical Diploma,4580,832,5412
27971,33,State - TAMIL NADU,Rural,20-24,Non-Technical Diploma,14845,3340,18185
27972,33,State - TAMIL NADU,Rural,25-29,Non-Technical Diploma,6607,1998,8605
27973,33,State - TAMIL NADU,Rural,30-34,Non-Technical Diploma,3860,1208,5068
27974,33,State - TAMIL NADU,Rural,35-39,Non-Technical Diploma,2487,1010,3497
27975,33,State - TAMIL NADU,Rural,40-44,Non-Technical Diploma,1683,655,2338
27976,33,State - TAMIL NADU,Rural,45-49,Non-Technical Diploma,771,219,990
27977,33,State - TAMIL NADU,Rural,50-54,Non-Technical Diploma,385,85,470
27978,33,State - TAMIL NADU,Rural,55-59,Non-Technical Diploma,289,63,352
27979,33,State - TAMIL NADU,Rural,60-64,Non-Technical Diploma,268,47,315
27980,33,State - TAMIL NADU,Rural,65-69,Non-Technical Diploma,193,21,214
27981,33,State - TAMIL NADU,Rural,70-74,Non-Technical Diploma,139,14,153
27982,33,State - TAMIL NADU,Rural,75-79,Non-Technical Diploma,41,13,54
27983,33,State - TAMIL NADU,Rural,80+,Non-Technical Diploma,70,15,85
27984,33,State - TAMIL NADU,Rural,Age not stated,Non-Technical Diploma,30,6,36
27985,33,State - TAMIL NADU,Urban,All ages,Non-Technical Diploma,75852,23481,99333
27986,33,State - TAMIL NADU,Urban,0-6,Non-Technical Diploma,0,0,0
27987,33,State - TAMIL NADU,Urban,7,Non-Technical Diploma,0,0,0
27988,33,State - TAMIL NADU,Urban,8,Non-Technical Diploma,0,0,0
27989,33,State - TAMIL NADU,Urban,9,Non-Technical Diploma,0,0,0
27990,33,State - TAMIL NADU,Urban,10,Non-Technical Diploma,0,0,0
27991,33,State - TAMIL NADU,Urban,11,Non-Technical Diploma,0,0,0
27992,33,State - TAMIL NADU,Urban,12,Non-Technical Diploma,0,0,0
27993,33,State - TAMIL NADU,Urban,13,Non-Technical Diploma,0,0,0
27994,33,State - TAMIL NADU,Urban,14,Non-Technical Diploma,0,0,0
27995,33,State - TAMIL NADU,Urban,15,Non-Technical Diploma,0,0,0
27996,33,State - TAMIL NADU,Urban,16,Non-Technical Diploma,0,0,0
27997,33,State - TAMIL NADU,Urban,17,Non-Technical Diploma,0,0,0
27998,33,State - TAMIL NADU,Urban,18,Non-Technical Diploma,4615,1167,5782
27999,33,State - TAMIL NADU,Urban,19,Non-Technical Diploma,4602,1092,5694
28000,33,State - TAMIL NADU,Urban,20-24,Non-Technical Diploma,18240,5333,23573
28001,33,State - TAMIL NADU,Urban,25-29,Non-Technical Diploma,11725,4576,16301
28002,33,State - TAMIL NADU,Urban,30-34,Non-Technical Diploma,9610,3441,13051
28003,33,State - TAMIL NADU,Urban,35-39,Non-Technical Diploma,7927,2978,10905
28004,33,State - TAMIL NADU,Urban,40-44,Non-Technical Diploma,6166,2122,8288
28005,33,State - TAMIL NADU,Urban,45-49,Non-Technical Diploma,3653,997,4650
28006,33,State - TAMIL NADU,Urban,50-54,Non-Technical Diploma,2470,577,3047
28007,33,State - TAMIL NADU,Urban,55-59,Non-Technical Diploma,1982,406,2388
28008,33,State - TAMIL NADU,Urban,60-64,Non-Technical Diploma,1795,336,2131
28009,33,State - TAMIL NADU,Urban,65-69,Non-Technical Diploma,1358,168,1526
28010,33,State - TAMIL NADU,Urban,70-74,Non-Technical Diploma,874,127,1001
28011,33,State - TAMIL NADU,Urban,75-79,Non-Technical Diploma,417,77,494
28012,33,State - TAMIL NADU,Urban,80+,Non-Technical Diploma,374,62,436
28013,33,State - TAMIL NADU,Urban,Age not stated,Non-Technical Diploma,44,22,66
28014,34,State - PUDUCHERRY,Total,All ages,Non-Technical Diploma,1293,911,2204
28015,34,State - PUDUCHERRY,Total,0-6,Non-Technical Diploma,0,0,0
28016,34,State - PUDUCHERRY,Total,7,Non-Technical Diploma,0,0,0
28017,34,State - PUDUCHERRY,Total,8,Non-Technical Diploma,0,0,0
28018,34,State - PUDUCHERRY,Total,9,Non-Technical Diploma,0,0,0
28019,34,State - PUDUCHERRY,Total,10,Non-Technical Diploma,0,0,0
28020,34,State - PUDUCHERRY,Total,11,Non-Technical Diploma,0,0,0
28021,34,State - PUDUCHERRY,Total,12,Non-Technical Diploma,0,0,0
28022,34,State - PUDUCHERRY,Total,13,Non-Technical Diploma,0,0,0
28023,34,State - PUDUCHERRY,Total,14,Non-Technical Diploma,0,0,0
28024,34,State - PUDUCHERRY,Total,15,Non-Technical Diploma,0,0,0
28025,34,State - PUDUCHERRY,Total,16,Non-Technical Diploma,0,0,0
28026,34,State - PUDUCHERRY,Total,17,Non-Technical Diploma,0,0,0
28027,34,State - PUDUCHERRY,Total,18,Non-Technical Diploma,67,43,110
28028,34,State - PUDUCHERRY,Total,19,Non-Technical Diploma,69,58,127
28029,34,State - PUDUCHERRY,Total,20-24,Non-Technical Diploma,276,230,506
28030,34,State - PUDUCHERRY,Total,25-29,Non-Technical Diploma,169,151,320
28031,34,State - PUDUCHERRY,Total,30-34,Non-Technical Diploma,150,123,273
28032,34,State - PUDUCHERRY,Total,35-39,Non-Technical Diploma,112,81,193
28033,34,State - PUDUCHERRY,Total,40-44,Non-Technical Diploma,83,37,120
28034,34,State - PUDUCHERRY,Total,45-49,Non-Technical Diploma,45,30,75
28035,34,State - PUDUCHERRY,Total,50-54,Non-Technical Diploma,43,15,58
28036,34,State - PUDUCHERRY,Total,55-59,Non-Technical Diploma,30,15,45
28037,34,State - PUDUCHERRY,Total,60-64,Non-Technical Diploma,39,24,63
28038,34,State - PUDUCHERRY,Total,65-69,Non-Technical Diploma,47,28,75
28039,34,State - PUDUCHERRY,Total,70-74,Non-Technical Diploma,70,30,100
28040,34,State - PUDUCHERRY,Total,75-79,Non-Technical Diploma,48,20,68
28041,34,State - PUDUCHERRY,Total,80+,Non-Technical Diploma,45,26,71
28042,34,State - PUDUCHERRY,Total,Age not stated,Non-Technical Diploma,0,0,0
28043,34,State - PUDUCHERRY,Rural,All ages,Non-Technical Diploma,319,186,505
28044,34,State - PUDUCHERRY,Rural,0-6,Non-Technical Diploma,0,0,0
28045,34,State - PUDUCHERRY,Rural,7,Non-Technical Diploma,0,0,0
28046,34,State - PUDUCHERRY,Rural,8,Non-Technical Diploma,0,0,0
28047,34,State - PUDUCHERRY,Rural,9,Non-Technical Diploma,0,0,0
28048,34,State - PUDUCHERRY,Rural,10,Non-Technical Diploma,0,0,0
28049,34,State - PUDUCHERRY,Rural,11,Non-Technical Diploma,0,0,0
28050,34,State - PUDUCHERRY,Rural,12,Non-Technical Diploma,0,0,0
28051,34,State - PUDUCHERRY,Rural,13,Non-Technical Diploma,0,0,0
28052,34,State - PUDUCHERRY,Rural,14,Non-Technical Diploma,0,0,0
28053,34,State - PUDUCHERRY,Rural,15,Non-Technical Diploma,0,0,0
28054,34,State - PUDUCHERRY,Rural,16,Non-Technical Diploma,0,0,0
28055,34,State - PUDUCHERRY,Rural,17,Non-Technical Diploma,0,0,0
28056,34,State - PUDUCHERRY,Rural,18,Non-Technical Diploma,22,15,37
28057,34,State - PUDUCHERRY,Rural,19,Non-Technical Diploma,21,23,44
28058,34,State - PUDUCHERRY,Rural,20-24,Non-Technical Diploma,101,76,177
28059,34,State - PUDUCHERRY,Rural,25-29,Non-Technical Diploma,53,25,78
28060,34,State - PUDUCHERRY,Rural,30-34,Non-Technical Diploma,38,22,60
28061,34,State - PUDUCHERRY,Rural,35-39,Non-Technical Diploma,22,15,37
28062,34,State - PUDUCHERRY,Rural,40-44,Non-Technical Diploma,15,2,17
28063,34,State - PUDUCHERRY,Rural,45-49,Non-Technical Diploma,6,2,8
28064,34,State - PUDUCHERRY,Rural,50-54,Non-Technical Diploma,7,2,9
28065,34,State - PUDUCHERRY,Rural,55-59,Non-Technical Diploma,5,2,7
28066,34,State - PUDUCHERRY,Rural,60-64,Non-Technical Diploma,5,2,7
28067,34,State - PUDUCHERRY,Rural,65-69,Non-Technical Diploma,5,0,5
28068,34,State - PUDUCHERRY,Rural,70-74,Non-Technical Diploma,9,0,9
28069,34,State - PUDUCHERRY,Rural,75-79,Non-Technical Diploma,2,0,2
28070,34,State - PUDUCHERRY,Rural,80+,Non-Technical Diploma,8,0,8
28071,34,State - PUDUCHERRY,Rural,Age not stated,Non-Technical Diploma,0,0,0
28072,34,State - PUDUCHERRY,Urban,All ages,Non-Technical Diploma,974,725,1699
28073,34,State - PUDUCHERRY,Urban,0-6,Non-Technical Diploma,0,0,0
28074,34,State - PUDUCHERRY,Urban,7,Non-Technical Diploma,0,0,0
28075,34,State - PUDUCHERRY,Urban,8,Non-Technical Diploma,0,0,0
28076,34,State - PUDUCHERRY,Urban,9,Non-Technical Diploma,0,0,0
28077,34,State - PUDUCHERRY,Urban,10,Non-Technical Diploma,0,0,0
28078,34,State - PUDUCHERRY,Urban,11,Non-Technical Diploma,0,0,0
28079,34,State - PUDUCHERRY,Urban,12,Non-Technical Diploma,0,0,0
28080,34,State - PUDUCHERRY,Urban,13,Non-Technical Diploma,0,0,0
28081,34,State - PUDUCHERRY,Urban,14,Non-Technical Diploma,0,0,0
28082,34,State - PUDUCHERRY,Urban,15,Non-Technical Diploma,0,0,0
28083,34,State - PUDUCHERRY,Urban,16,Non-Technical Diploma,0,0,0
28084,34,State - PUDUCHERRY,Urban,17,Non-Technical Diploma,0,0,0
28085,34,State - PUDUCHERRY,Urban,18,Non-Technical Diploma,45,28,73
28086,34,State - PUDUCHERRY,Urban,19,Non-Technical Diploma,48,35,83
28087,34,State - PUDUCHERRY,Urban,20-24,Non-Technical Diploma,175,154,329
28088,34,State - PUDUCHERRY,Urban,25-29,Non-Technical Diploma,116,126,242
28089,34,State - PUDUCHERRY,Urban,30-34,Non-Technical Diploma,112,101,213
28090,34,State - PUDUCHERRY,Urban,35-39,Non-Technical Diploma,90,66,156
28091,34,State - PUDUCHERRY,Urban,40-44,Non-Technical Diploma,68,35,103
28092,34,State - PUDUCHERRY,Urban,45-49,Non-Technical Diploma,39,28,67
28093,34,State - PUDUCHERRY,Urban,50-54,Non-Technical Diploma,36,13,49
28094,34,State - PUDUCHERRY,Urban,55-59,Non-Technical Diploma,25,13,38
28095,34,State - PUDUCHERRY,Urban,60-64,Non-Technical Diploma,34,22,56
28096,34,State - PUDUCHERRY,Urban,65-69,Non-Technical Diploma,42,28,70
28097,34,State - PUDUCHERRY,Urban,70-74,Non-Technical Diploma,61,30,91
28098,34,State - PUDUCHERRY,Urban,75-79,Non-Technical Diploma,46,20,66
28099,34,State - PUDUCHERRY,Urban,80+,Non-Technical Diploma,37,26,63
28100,34,State - PUDUCHERRY,Urban,Age not stated,Non-Technical Diploma,0,0,0
28101,35,State - ANDAMAN & NICOBAR ISLANDS,Total,All ages,Non-Technical Diploma,180,121,301
28102,35,State - ANDAMAN & NICOBAR ISLANDS,Total,0-6,Non-Technical Diploma,0,0,0
28103,35,State - ANDAMAN & NICOBAR ISLANDS,Total,7,Non-Technical Diploma,0,0,0
28104,35,State - ANDAMAN & NICOBAR ISLANDS,Total,8,Non-Technical Diploma,0,0,0
28105,35,State - ANDAMAN & NICOBAR ISLANDS,Total,9,Non-Technical Diploma,0,0,0
28106,35,State - ANDAMAN & NICOBAR ISLANDS,Total,10,Non-Technical Diploma,0,0,0
28107,35,State - ANDAMAN & NICOBAR ISLANDS,Total,11,Non-Technical Diploma,0,0,0
28108,35,State - ANDAMAN & NICOBAR ISLANDS,Total,12,Non-Technical Diploma,0,0,0
28109,35,State - ANDAMAN & NICOBAR ISLANDS,Total,13,Non-Technical Diploma,0,0,0
28110,35,State - ANDAMAN & NICOBAR ISLANDS,Total,14,Non-Technical Diploma,0,0,0
28111,35,State - ANDAMAN & NICOBAR ISLANDS,Total,15,Non-Technical Diploma,0,0,0
28112,35,State - ANDAMAN & NICOBAR ISLANDS,Total,16,Non-Technical Diploma,0,0,0
28113,35,State - ANDAMAN & NICOBAR ISLANDS,Total,17,Non-Technical Diploma,0,0,0
28114,35,State - ANDAMAN & NICOBAR ISLANDS,Total,18,Non-Technical Diploma,3,4,7
28115,35,State - ANDAMAN & NICOBAR ISLANDS,Total,19,Non-Technical Diploma,6,5,11
28116,35,State - ANDAMAN & NICOBAR ISLANDS,Total,20-24,Non-Technical Diploma,31,30,61
28117,35,State - ANDAMAN & NICOBAR ISLANDS,Total,25-29,Non-Technical Diploma,30,22,52
28118,35,State - ANDAMAN & NICOBAR ISLANDS,Total,30-34,Non-Technical Diploma,34,17,51
28119,35,State - ANDAMAN & NICOBAR ISLANDS,Total,35-39,Non-Technical Diploma,19,15,34
28120,35,State - ANDAMAN & NICOBAR ISLANDS,Total,40-44,Non-Technical Diploma,17,11,28
28121,35,State - ANDAMAN & NICOBAR ISLANDS,Total,45-49,Non-Technical Diploma,16,4,20
28122,35,State - ANDAMAN & NICOBAR ISLANDS,Total,50-54,Non-Technical Diploma,10,3,13
28123,35,State - ANDAMAN & NICOBAR ISLANDS,Total,55-59,Non-Technical Diploma,8,2,10
28124,35,State - ANDAMAN & NICOBAR ISLANDS,Total,60-64,Non-Technical Diploma,3,4,7
28125,35,State - ANDAMAN & NICOBAR ISLANDS,Total,65-69,Non-Technical Diploma,2,0,2
28126,35,State - ANDAMAN & NICOBAR ISLANDS,Total,70-74,Non-Technical Diploma,1,4,5
28127,35,State - ANDAMAN & NICOBAR ISLANDS,Total,75-79,Non-Technical Diploma,0,0,0
28128,35,State - ANDAMAN & NICOBAR ISLANDS,Total,80+,Non-Technical Diploma,0,0,0
28129,35,State - ANDAMAN & NICOBAR ISLANDS,Total,Age not stated,Non-Technical Diploma,0,0,0
28130,35,State - ANDAMAN & NICOBAR ISLANDS,Rural,All ages,Non-Technical Diploma,50,38,88
28131,35,State - ANDAMAN & NICOBAR ISLANDS,Rural,0-6,Non-Technical Diploma,0,0,0
28132,35,State - ANDAMAN & NICOBAR ISLANDS,Rural,7,Non-Technical Diploma,0,0,0
28133,35,State - ANDAMAN & NICOBAR ISLANDS,Rural,8,Non-Technical Diploma,0,0,0
28134,35,State - ANDAMAN & NICOBAR ISLANDS,Rural,9,Non-Technical Diploma,0,0,0
28135,35,State - ANDAMAN & NICOBAR ISLANDS,Rural,10,Non-Technical Diploma,0,0,0
28136,35,State - ANDAMAN & NICOBAR ISLANDS,Rural,11,Non-Technical Diploma,0,0,0
28137,35,State - ANDAMAN & NICOBAR ISLANDS,Rural,12,Non-Technical Diploma,0,0,0
28138,35,State - ANDAMAN & NICOBAR ISLANDS,Rural,13,Non-Technical Diploma,0,0,0
28139,35,State - ANDAMAN & NICOBAR ISLANDS,Rural,14,Non-Technical Diploma,0,0,0
28140,35,State - ANDAMAN & NICOBAR ISLANDS,Rural,15,Non-Technical Diploma,0,0,0
28141,35,State - ANDAMAN & NICOBAR ISLANDS,Rural,16,Non-Technical Diploma,0,0,0
28142,35,State - ANDAMAN & NICOBAR ISLANDS,Rural,17,Non-Technical Diploma,0,0,0
28143,35,State - ANDAMAN & NICOBAR ISLANDS,Rural,18,Non-Technical Diploma,1,1,2
28144,35,State - ANDAMAN & NICOBAR ISLANDS,Rural,19,Non-Technical Diploma,3,1,4
28145,35,State - ANDAMAN & NICOBAR ISLANDS,Rural,20-24,Non-Technical Diploma,13,13,26
28146,35,State - ANDAMAN & NICOBAR ISLANDS,Rural,25-29,Non-Technical Diploma,9,7,16
28147,35,State - ANDAMAN & NICOBAR ISLANDS,Rural,30-34,Non-Technical Diploma,9,6,15
28148,35,State - ANDAMAN & NICOBAR ISLANDS,Rural,35-39,Non-Technical Diploma,2,4,6
28149,35,State - ANDAMAN & NICOBAR ISLANDS,Rural,40-44,Non-Technical Diploma,5,1,6
28150,35,State - ANDAMAN & NICOBAR ISLANDS,Rural,45-49,Non-Technical Diploma,3,2,5
28151,35,State - ANDAMAN & NICOBAR ISLANDS,Rural,50-54,Non-Technical Diploma,3,0,3
28152,35,State - ANDAMAN & NICOBAR ISLANDS,Rural,55-59,Non-Technical Diploma,1,0,1
28153,35,State - ANDAMAN & NICOBAR ISLANDS,Rural,60-64,Non-Technical Diploma,1,3,4
28154,35,State - ANDAMAN & NICOBAR ISLANDS,Rural,65-69,Non-Technical Diploma,0,0,0
28155,35,State - ANDAMAN & NICOBAR ISLANDS,Rural,70-74,Non-Technical Diploma,0,0,0
28156,35,State - ANDAMAN & NICOBAR ISLANDS,Rural,75-79,Non-Technical Diploma,0,0,0
28157,35,State - ANDAMAN & NICOBAR ISLANDS,Rural,80+,Non-Technical Diploma,0,0,0
28158,35,State - ANDAMAN & NICOBAR ISLANDS,Rural,Age not stated,Non-Technical Diploma,0,0,0
28159,35,State - ANDAMAN & NICOBAR ISLANDS,Urban,All ages,Non-Technical Diploma,130,83,213
28160,35,State - ANDAMAN & NICOBAR ISLANDS,Urban,0-6,Non-Technical Diploma,0,0,0
28161,35,State - ANDAMAN & NICOBAR ISLANDS,Urban,7,Non-Technical Diploma,0,0,0
28162,35,State - ANDAMAN & NICOBAR ISLANDS,Urban,8,Non-Technical Diploma,0,0,0
28163,35,State - ANDAMAN & NICOBAR ISLANDS,Urban,9,Non-Technical Diploma,0,0,0
28164,35,State - ANDAMAN & NICOBAR ISLANDS,Urban,10,Non-Technical Diploma,0,0,0
28165,35,State - ANDAMAN & NICOBAR ISLANDS,Urban,11,Non-Technical Diploma,0,0,0
28166,35,State - ANDAMAN & NICOBAR ISLANDS,Urban,12,Non-Technical Diploma,0,0,0
28167,35,State - ANDAMAN & NICOBAR ISLANDS,Urban,13,Non-Technical Diploma,0,0,0
28168,35,State - ANDAMAN & NICOBAR ISLANDS,Urban,14,Non-Technical Diploma,0,0,0
28169,35,State - ANDAMAN & NICOBAR ISLANDS,Urban,15,Non-Technical Diploma,0,0,0
28170,35,State - ANDAMAN & NICOBAR ISLANDS,Urban,16,Non-Technical Diploma,0,0,0
28171,35,State - ANDAMAN & NICOBAR ISLANDS,Urban,17,Non-Technical Diploma,0,0,0
28172,35,State - ANDAMAN & NICOBAR ISLANDS,Urban,18,Non-Technical Diploma,2,3,5
28173,35,State - ANDAMAN & NICOBAR ISLANDS,Urban,19,Non-Technical Diploma,3,4,7
28174,35,State - ANDAMAN & NICOBAR ISLANDS,Urban,20-24,Non-Technical Diploma,18,17,35
28175,35,State - ANDAMAN & NICOBAR ISLANDS,Urban,25-29,Non-Technical Diploma,21,15,36
28176,35,State - ANDAMAN & NICOBAR ISLANDS,Urban,30-34,Non-Technical Diploma,25,11,36
28177,35,State - ANDAMAN & NICOBAR ISLANDS,Urban,35-39,Non-Technical Diploma,17,11,28
28178,35,State - ANDAMAN & NICOBAR ISLANDS,Urban,40-44,Non-Technical Diploma,12,10,22
28179,35,State - ANDAMAN & NICOBAR ISLANDS,Urban,45-49,Non-Technical Diploma,13,2,15
28180,35,State - ANDAMAN & NICOBAR ISLANDS,Urban,50-54,Non-Technical Diploma,7,3,10
28181,35,State - ANDAMAN & NICOBAR ISLANDS,Urban,55-59,Non-Technical Diploma,7,2,9
28182,35,State - ANDAMAN & NICOBAR ISLANDS,Urban,60-64,Non-Technical Diploma,2,1,3
28183,35,State - ANDAMAN & NICOBAR ISLANDS,Urban,65-69,Non-Technical Diploma,2,0,2
28184,35,State - ANDAMAN & NICOBAR ISLANDS,Urban,70-74,Non-Technical Diploma,1,4,5
28185,35,State - ANDAMAN & NICOBAR ISLANDS,Urban,75-79,Non-Technical Diploma,0,0,0
28186,35,State - ANDAMAN & NICOBAR ISLANDS,Urban,80+,Non-Technical Diploma,0,0,0
28187,35,State - ANDAMAN & NICOBAR ISLANDS,Urban,Age not stated,Non-Technical Diploma,0,0,0
28188,0,INDIA,Total,All ages,Graduate,42120460,26168511,68288971
28189,0,INDIA,Total,0-6,Graduate,0,0,0
28190,0,INDIA,Total,7,Graduate,0,0,0
28191,0,INDIA,Total,8,Graduate,0,0,0
28192,0,INDIA,Total,9,Graduate,0,0,0
28193,0,INDIA,Total,10,Graduate,0,0,0
28194,0,INDIA,Total,11,Graduate,0,0,0
28195,0,INDIA,Total,12,Graduate,0,0,0
28196,0,INDIA,Total,13,Graduate,0,0,0
28197,0,INDIA,Total,14,Graduate,0,0,0
28198,0,INDIA,Total,15,Graduate,0,0,0
28199,0,INDIA,Total,16,Graduate,0,0,0
28200,0,INDIA,Total,17,Graduate,0,0,0
28201,0,INDIA,Total,18,Graduate,0,0,0
28202,0,INDIA,Total,19,Graduate,0,0,0
28203,0,INDIA,Total,20-24,Graduate,7029489,6140539,13170028
28204,0,INDIA,Total,25-29,Graduate,7903752,6216022,14119774
28205,0,INDIA,Total,30-34,Graduate,6112575,4229413,10341988
28206,0,INDIA,Total,35-39,Graduate,5121959,3051411,8173370
28207,0,INDIA,Total,40-44,Graduate,4202356,2124230,6326586
28208,0,INDIA,Total,45-49,Graduate,3395939,1523512,4919451
28209,0,INDIA,Total,50-54,Graduate,2628625,1065395,3694020
28210,0,INDIA,Total,55-59,Graduate,2120540,747940,2868480
28211,0,INDIA,Total,60-64,Graduate,1514324,459643,1973967
28212,0,INDIA,Total,65-69,Graduate,864263,225290,1089553
28213,0,INDIA,Total,70-74,Graduate,535931,126010,661941
28214,0,INDIA,Total,75-79,Graduate,268932,59066,327998
28215,0,INDIA,Total,80+,Graduate,250257,89372,339629
28216,0,INDIA,Total,Age not stated,Graduate,171518,110668,282186
28217,0,INDIA,Rural,All ages,Graduate,15659295,6680672,22339967
28218,0,INDIA,Rural,0-6,Graduate,0,0,0
28219,0,INDIA,Rural,7,Graduate,0,0,0
28220,0,INDIA,Rural,8,Graduate,0,0,0
28221,0,INDIA,Rural,9,Graduate,0,0,0
28222,0,INDIA,Rural,10,Graduate,0,0,0
28223,0,INDIA,Rural,11,Graduate,0,0,0
28224,0,INDIA,Rural,12,Graduate,0,0,0
28225,0,INDIA,Rural,13,Graduate,0,0,0
28226,0,INDIA,Rural,14,Graduate,0,0,0
28227,0,INDIA,Rural,15,Graduate,0,0,0
28228,0,INDIA,Rural,16,Graduate,0,0,0
28229,0,INDIA,Rural,17,Graduate,0,0,0
28230,0,INDIA,Rural,18,Graduate,0,0,0
28231,0,INDIA,Rural,19,Graduate,0,0,0
28232,0,INDIA,Rural,20-24,Graduate,3243921,2226229,5470150
28233,0,INDIA,Rural,25-29,Graduate,3318985,1847988,5166973
28234,0,INDIA,Rural,30-34,Graduate,2357229,1047345,3404574
28235,0,INDIA,Rural,35-39,Graduate,1921704,643183,2564887
28236,0,INDIA,Rural,40-44,Graduate,1481737,369269,1851006
28237,0,INDIA,Rural,45-49,Graduate,1077689,213835,1291524
28238,0,INDIA,Rural,50-54,Graduate,737347,123390,860737
28239,0,INDIA,Rural,55-59,Graduate,575487,81064,656551
28240,0,INDIA,Rural,60-64,Graduate,412171,45586,457757
28241,0,INDIA,Rural,65-69,Graduate,229291,21340,250631
28242,0,INDIA,Rural,70-74,Graduate,127638,11798,139436
28243,0,INDIA,Rural,75-79,Graduate,53628,5445,59073
28244,0,INDIA,Rural,80+,Graduate,59683,15806,75489
28245,0,INDIA,Rural,Age not stated,Graduate,62785,28394,91179
28246,0,INDIA,Urban,All ages,Graduate,26461165,19487839,45949004
28247,0,INDIA,Urban,0-6,Graduate,0,0,0
28248,0,INDIA,Urban,7,Graduate,0,0,0
28249,0,INDIA,Urban,8,Graduate,0,0,0
28250,0,INDIA,Urban,9,Graduate,0,0,0
28251,0,INDIA,Urban,10,Graduate,0,0,0
28252,0,INDIA,Urban,11,Graduate,0,0,0
28253,0,INDIA,Urban,12,Graduate,0,0,0
28254,0,INDIA,Urban,13,Graduate,0,0,0
28255,0,INDIA,Urban,14,Graduate,0,0,0
28256,0,INDIA,Urban,15,Graduate,0,0,0
28257,0,INDIA,Urban,16,Graduate,0,0,0
28258,0,INDIA,Urban,17,Graduate,0,0,0
28259,0,INDIA,Urban,18,Graduate,0,0,0
28260,0,INDIA,Urban,19,Graduate,0,0,0
28261,0,INDIA,Urban,20-24,Graduate,3785568,3914310,7699878
28262,0,INDIA,Urban,25-29,Graduate,4584767,4368034,8952801
28263,0,INDIA,Urban,30-34,Graduate,3755346,3182068,6937414
28264,0,INDIA,Urban,35-39,Graduate,3200255,2408228,5608483
28265,0,INDIA,Urban,40-44,Graduate,2720619,1754961,4475580
28266,0,INDIA,Urban,45-49,Graduate,2318250,1309677,3627927
28267,0,INDIA,Urban,50-54,Graduate,1891278,942005,2833283
28268,0,INDIA,Urban,55-59,Graduate,1545053,666876,2211929
28269,0,INDIA,Urban,60-64,Graduate,1102153,414057,1516210
28270,0,INDIA,Urban,65-69,Graduate,634972,203950,838922
28271,0,INDIA,Urban,70-74,Graduate,408293,114212,522505
28272,0,INDIA,Urban,75-79,Graduate,215304,53621,268925
28273,0,INDIA,Urban,80+,Graduate,190574,73566,264140
28274,0,INDIA,Urban,Age not stated,Graduate,108733,82274,191007
28275,1,State - JAMMU & KASHMIR,Total,All ages,Graduate,401279,252485,653764
28276,1,State - JAMMU & KASHMIR,Total,0-6,Graduate,0,0,0
28277,1,State - JAMMU & KASHMIR,Total,7,Graduate,0,0,0
28278,1,State - JAMMU & KASHMIR,Total,8,Graduate,0,0,0
28279,1,State - JAMMU & KASHMIR,Total,9,Graduate,0,0,0
28280,1,State - JAMMU & KASHMIR,Total,10,Graduate,0,0,0
28281,1,State - JAMMU & KASHMIR,Total,11,Graduate,0,0,0
28282,1,State - JAMMU & KASHMIR,Total,12,Graduate,0,0,0
28283,1,State - JAMMU & KASHMIR,Total,13,Graduate,0,0,0
28284,1,State - JAMMU & KASHMIR,Total,14,Graduate,0,0,0
28285,1,State - JAMMU & KASHMIR,Total,15,Graduate,0,0,0
28286,1,State - JAMMU & KASHMIR,Total,16,Graduate,0,0,0
28287,1,State - JAMMU & KASHMIR,Total,17,Graduate,0,0,0
28288,1,State - JAMMU & KASHMIR,Total,18,Graduate,0,0,0
28289,1,State - JAMMU & KASHMIR,Total,19,Graduate,0,0,0
28290,1,State - JAMMU & KASHMIR,Total,20-24,Graduate,73058,62767,135825
28291,1,State - JAMMU & KASHMIR,Total,25-29,Graduate,84212,66552,150764
28292,1,State - JAMMU & KASHMIR,Total,30-34,Graduate,58000,40874,98874
28293,1,State - JAMMU & KASHMIR,Total,35-39,Graduate,46303,27174,73477
28294,1,State - JAMMU & KASHMIR,Total,40-44,Graduate,38268,18973,57241
28295,1,State - JAMMU & KASHMIR,Total,45-49,Graduate,30950,14242,45192
28296,1,State - JAMMU & KASHMIR,Total,50-54,Graduate,22526,9084,31610
28297,1,State - JAMMU & KASHMIR,Total,55-59,Graduate,18154,6116,24270
28298,1,State - JAMMU & KASHMIR,Total,60-64,Graduate,13622,3316,16938
28299,1,State - JAMMU & KASHMIR,Total,65-69,Graduate,7705,1501,9206
28300,1,State - JAMMU & KASHMIR,Total,70-74,Graduate,4451,677,5128
28301,1,State - JAMMU & KASHMIR,Total,75-79,Graduate,1767,257,2024
28302,1,State - JAMMU & KASHMIR,Total,80+,Graduate,1911,715,2626
28303,1,State - JAMMU & KASHMIR,Total,Age not stated,Graduate,352,237,589
28304,1,State - JAMMU & KASHMIR,Rural,All ages,Graduate,173914,80374,254288
28305,1,State - JAMMU & KASHMIR,Rural,0-6,Graduate,0,0,0
28306,1,State - JAMMU & KASHMIR,Rural,7,Graduate,0,0,0
28307,1,State - JAMMU & KASHMIR,Rural,8,Graduate,0,0,0
28308,1,State - JAMMU & KASHMIR,Rural,9,Graduate,0,0,0
28309,1,State - JAMMU & KASHMIR,Rural,10,Graduate,0,0,0
28310,1,State - JAMMU & KASHMIR,Rural,11,Graduate,0,0,0
28311,1,State - JAMMU & KASHMIR,Rural,12,Graduate,0,0,0
28312,1,State - JAMMU & KASHMIR,Rural,13,Graduate,0,0,0
28313,1,State - JAMMU & KASHMIR,Rural,14,Graduate,0,0,0
28314,1,State - JAMMU & KASHMIR,Rural,15,Graduate,0,0,0
28315,1,State - JAMMU & KASHMIR,Rural,16,Graduate,0,0,0
28316,1,State - JAMMU & KASHMIR,Rural,17,Graduate,0,0,0
28317,1,State - JAMMU & KASHMIR,Rural,18,Graduate,0,0,0
28318,1,State - JAMMU & KASHMIR,Rural,19,Graduate,0,0,0
28319,1,State - JAMMU & KASHMIR,Rural,20-24,Graduate,39142,26803,65945
28320,1,State - JAMMU & KASHMIR,Rural,25-29,Graduate,41495,24640,66135
28321,1,State - JAMMU & KASHMIR,Rural,30-34,Graduate,26142,12767,38909
28322,1,State - JAMMU & KASHMIR,Rural,35-39,Graduate,19497,7166,26663
28323,1,State - JAMMU & KASHMIR,Rural,40-44,Graduate,16328,4360,20688
28324,1,State - JAMMU & KASHMIR,Rural,45-49,Graduate,11464,2354,13818
28325,1,State - JAMMU & KASHMIR,Rural,50-54,Graduate,7056,1077,8133
28326,1,State - JAMMU & KASHMIR,Rural,55-59,Graduate,4925,530,5455
28327,1,State - JAMMU & KASHMIR,Rural,60-64,Graduate,3710,250,3960
28328,1,State - JAMMU & KASHMIR,Rural,65-69,Graduate,2091,91,2182
28329,1,State - JAMMU & KASHMIR,Rural,70-74,Graduate,1054,51,1105
28330,1,State - JAMMU & KASHMIR,Rural,75-79,Graduate,312,29,341
28331,1,State - JAMMU & KASHMIR,Rural,80+,Graduate,498,168,666
28332,1,State - JAMMU & KASHMIR,Rural,Age not stated,Graduate,200,88,288
28333,1,State - JAMMU & KASHMIR,Urban,All ages,Graduate,227365,172111,399476
28334,1,State - JAMMU & KASHMIR,Urban,0-6,Graduate,0,0,0
28335,1,State - JAMMU & KASHMIR,Urban,7,Graduate,0,0,0
28336,1,State - JAMMU & KASHMIR,Urban,8,Graduate,0,0,0
28337,1,State - JAMMU & KASHMIR,Urban,9,Graduate,0,0,0
28338,1,State - JAMMU & KASHMIR,Urban,10,Graduate,0,0,0
28339,1,State - JAMMU & KASHMIR,Urban,11,Graduate,0,0,0
28340,1,State - JAMMU & KASHMIR,Urban,12,Graduate,0,0,0
28341,1,State - JAMMU & KASHMIR,Urban,13,Graduate,0,0,0
28342,1,State - JAMMU & KASHMIR,Urban,14,Graduate,0,0,0
28343,1,State - JAMMU & KASHMIR,Urban,15,Graduate,0,0,0
28344,1,State - JAMMU & KASHMIR,Urban,16,Graduate,0,0,0
28345,1,State - JAMMU & KASHMIR,Urban,17,Graduate,0,0,0
28346,1,State - JAMMU & KASHMIR,Urban,18,Graduate,0,0,0
28347,1,State - JAMMU & KASHMIR,Urban,19,Graduate,0,0,0
28348,1,State - JAMMU & KASHMIR,Urban,20-24,Graduate,33916,35964,69880
28349,1,State - JAMMU & KASHMIR,Urban,25-29,Graduate,42717,41912,84629
28350,1,State - JAMMU & KASHMIR,Urban,30-34,Graduate,31858,28107,59965
28351,1,State - JAMMU & KASHMIR,Urban,35-39,Graduate,26806,20008,46814
28352,1,State - JAMMU & KASHMIR,Urban,40-44,Graduate,21940,14613,36553
28353,1,State - JAMMU & KASHMIR,Urban,45-49,Graduate,19486,11888,31374
28354,1,State - JAMMU & KASHMIR,Urban,50-54,Graduate,15470,8007,23477
28355,1,State - JAMMU & KASHMIR,Urban,55-59,Graduate,13229,5586,18815
28356,1,State - JAMMU & KASHMIR,Urban,60-64,Graduate,9912,3066,12978
28357,1,State - JAMMU & KASHMIR,Urban,65-69,Graduate,5614,1410,7024
28358,1,State - JAMMU & KASHMIR,Urban,70-74,Graduate,3397,626,4023
28359,1,State - JAMMU & KASHMIR,Urban,75-79,Graduate,1455,228,1683
28360,1,State - JAMMU & KASHMIR,Urban,80+,Graduate,1413,547,1960
28361,1,State - JAMMU & KASHMIR,Urban,Age not stated,Graduate,152,149,301
28362,2,State - HIMACHAL PRADESH,Total,All ages,Graduate,251164,195445,446609
28363,2,State - HIMACHAL PRADESH,Total,0-6,Graduate,0,0,0
28364,2,State - HIMACHAL PRADESH,Total,7,Graduate,0,0,0
28365,2,State - HIMACHAL PRADESH,Total,8,Graduate,0,0,0
28366,2,State - HIMACHAL PRADESH,Total,9,Graduate,0,0,0
28367,2,State - HIMACHAL PRADESH,Total,10,Graduate,0,0,0
28368,2,State - HIMACHAL PRADESH,Total,11,Graduate,0,0,0
28369,2,State - HIMACHAL PRADESH,Total,12,Graduate,0,0,0
28370,2,State - HIMACHAL PRADESH,Total,13,Graduate,0,0,0
28371,2,State - HIMACHAL PRADESH,Total,14,Graduate,0,0,0
28372,2,State - HIMACHAL PRADESH,Total,15,Graduate,0,0,0
28373,2,State - HIMACHAL PRADESH,Total,16,Graduate,0,0,0
28374,2,State - HIMACHAL PRADESH,Total,17,Graduate,0,0,0
28375,2,State - HIMACHAL PRADESH,Total,18,Graduate,0,0,0
28376,2,State - HIMACHAL PRADESH,Total,19,Graduate,0,0,0
28377,2,State - HIMACHAL PRADESH,Total,20-24,Graduate,34713,48402,83115
28378,2,State - HIMACHAL PRADESH,Total,25-29,Graduate,50093,56102,106195
28379,2,State - HIMACHAL PRADESH,Total,30-34,Graduate,43008,35618,78626
28380,2,State - HIMACHAL PRADESH,Total,35-39,Graduate,32578,21124,53702
28381,2,State - HIMACHAL PRADESH,Total,40-44,Graduate,23318,11800,35118
28382,2,State - HIMACHAL PRADESH,Total,45-49,Graduate,18528,8119,26647
28383,2,State - HIMACHAL PRADESH,Total,50-54,Graduate,14391,5691,20082
28384,2,State - HIMACHAL PRADESH,Total,55-59,Graduate,13215,3912,17127
28385,2,State - HIMACHAL PRADESH,Total,60-64,Graduate,9916,2234,12150
28386,2,State - HIMACHAL PRADESH,Total,65-69,Graduate,5367,1045,6412
28387,2,State - HIMACHAL PRADESH,Total,70-74,Graduate,3140,570,3710
28388,2,State - HIMACHAL PRADESH,Total,75-79,Graduate,1484,216,1700
28389,2,State - HIMACHAL PRADESH,Total,80+,Graduate,1073,329,1402
28390,2,State - HIMACHAL PRADESH,Total,Age not stated,Graduate,340,283,623
28391,2,State - HIMACHAL PRADESH,Rural,All ages,Graduate,181122,134818,315940
28392,2,State - HIMACHAL PRADESH,Rural,0-6,Graduate,0,0,0
28393,2,State - HIMACHAL PRADESH,Rural,7,Graduate,0,0,0
28394,2,State - HIMACHAL PRADESH,Rural,8,Graduate,0,0,0
28395,2,State - HIMACHAL PRADESH,Rural,9,Graduate,0,0,0
28396,2,State - HIMACHAL PRADESH,Rural,10,Graduate,0,0,0
28397,2,State - HIMACHAL PRADESH,Rural,11,Graduate,0,0,0
28398,2,State - HIMACHAL PRADESH,Rural,12,Graduate,0,0,0
28399,2,State - HIMACHAL PRADESH,Rural,13,Graduate,0,0,0
28400,2,State - HIMACHAL PRADESH,Rural,14,Graduate,0,0,0
28401,2,State - HIMACHAL PRADESH,Rural,15,Graduate,0,0,0
28402,2,State - HIMACHAL PRADESH,Rural,16,Graduate,0,0,0
28403,2,State - HIMACHAL PRADESH,Rural,17,Graduate,0,0,0
28404,2,State - HIMACHAL PRADESH,Rural,18,Graduate,0,0,0
28405,2,State - HIMACHAL PRADESH,Rural,19,Graduate,0,0,0
28406,2,State - HIMACHAL PRADESH,Rural,20-24,Graduate,27286,38215,65501
28407,2,State - HIMACHAL PRADESH,Rural,25-29,Graduate,39462,43246,82708
28408,2,State - HIMACHAL PRADESH,Rural,30-34,Graduate,33264,25112,58376
28409,2,State - HIMACHAL PRADESH,Rural,35-39,Graduate,23662,12860,36522
28410,2,State - HIMACHAL PRADESH,Rural,40-44,Graduate,15532,5881,21413
28411,2,State - HIMACHAL PRADESH,Rural,45-49,Graduate,11448,3599,15047
28412,2,State - HIMACHAL PRADESH,Rural,50-54,Graduate,8407,2335,10742
28413,2,State - HIMACHAL PRADESH,Rural,55-59,Graduate,8049,1635,9684
28414,2,State - HIMACHAL PRADESH,Rural,60-64,Graduate,6744,891,7635
28415,2,State - HIMACHAL PRADESH,Rural,65-69,Graduate,3605,398,4003
28416,2,State - HIMACHAL PRADESH,Rural,70-74,Graduate,1935,190,2125
28417,2,State - HIMACHAL PRADESH,Rural,75-79,Graduate,842,68,910
28418,2,State - HIMACHAL PRADESH,Rural,80+,Graduate,612,168,780
28419,2,State - HIMACHAL PRADESH,Rural,Age not stated,Graduate,274,220,494
28420,2,State - HIMACHAL PRADESH,Urban,All ages,Graduate,70042,60627,130669
28421,2,State - HIMACHAL PRADESH,Urban,0-6,Graduate,0,0,0
28422,2,State - HIMACHAL PRADESH,Urban,7,Graduate,0,0,0
28423,2,State - HIMACHAL PRADESH,Urban,8,Graduate,0,0,0
28424,2,State - HIMACHAL PRADESH,Urban,9,Graduate,0,0,0
28425,2,State - HIMACHAL PRADESH,Urban,10,Graduate,0,0,0
28426,2,State - HIMACHAL PRADESH,Urban,11,Graduate,0,0,0
28427,2,State - HIMACHAL PRADESH,Urban,12,Graduate,0,0,0
28428,2,State - HIMACHAL PRADESH,Urban,13,Graduate,0,0,0
28429,2,State - HIMACHAL PRADESH,Urban,14,Graduate,0,0,0
28430,2,State - HIMACHAL PRADESH,Urban,15,Graduate,0,0,0
28431,2,State - HIMACHAL PRADESH,Urban,16,Graduate,0,0,0
28432,2,State - HIMACHAL PRADESH,Urban,17,Graduate,0,0,0
28433,2,State - HIMACHAL PRADESH,Urban,18,Graduate,0,0,0
28434,2,State - HIMACHAL PRADESH,Urban,19,Graduate,0,0,0
28435,2,State - HIMACHAL PRADESH,Urban,20-24,Graduate,7427,10187,17614
28436,2,State - HIMACHAL PRADESH,Urban,25-29,Graduate,10631,12856,23487
28437,2,State - HIMACHAL PRADESH,Urban,30-34,Graduate,9744,10506,20250
28438,2,State - HIMACHAL PRADESH,Urban,35-39,Graduate,8916,8264,17180
28439,2,State - HIMACHAL PRADESH,Urban,40-44,Graduate,7786,5919,13705
28440,2,State - HIMACHAL PRADESH,Urban,45-49,Graduate,7080,4520,11600
28441,2,State - HIMACHAL PRADESH,Urban,50-54,Graduate,5984,3356,9340
28442,2,State - HIMACHAL PRADESH,Urban,55-59,Graduate,5166,2277,7443
28443,2,State - HIMACHAL PRADESH,Urban,60-64,Graduate,3172,1343,4515
28444,2,State - HIMACHAL PRADESH,Urban,65-69,Graduate,1762,647,2409
28445,2,State - HIMACHAL PRADESH,Urban,70-74,Graduate,1205,380,1585
28446,2,State - HIMACHAL PRADESH,Urban,75-79,Graduate,642,148,790
28447,2,State - HIMACHAL PRADESH,Urban,80+,Graduate,461,161,622
28448,2,State - HIMACHAL PRADESH,Urban,Age not stated,Graduate,66,63,129
28449,3,State - PUNJAB,Total,All ages,Graduate,873776,887070,1760846
28450,3,State - PUNJAB,Total,0-6,Graduate,0,0,0
28451,3,State - PUNJAB,Total,7,Graduate,0,0,0
28452,3,State - PUNJAB,Total,8,Graduate,0,0,0
28453,3,State - PUNJAB,Total,9,Graduate,0,0,0
28454,3,State - PUNJAB,Total,10,Graduate,0,0,0
28455,3,State - PUNJAB,Total,11,Graduate,0,0,0
28456,3,State - PUNJAB,Total,12,Graduate,0,0,0
28457,3,State - PUNJAB,Total,13,Graduate,0,0,0
28458,3,State - PUNJAB,Total,14,Graduate,0,0,0
28459,3,State - PUNJAB,Total,15,Graduate,0,0,0
28460,3,State - PUNJAB,Total,16,Graduate,0,0,0
28461,3,State - PUNJAB,Total,17,Graduate,0,0,0
28462,3,State - PUNJAB,Total,18,Graduate,0,0,0
28463,3,State - PUNJAB,Total,19,Graduate,0,0,0
28464,3,State - PUNJAB,Total,20-24,Graduate,143180,209395,352575
28465,3,State - PUNJAB,Total,25-29,Graduate,159158,212757,371915
28466,3,State - PUNJAB,Total,30-34,Graduate,117380,137655,255035
28467,3,State - PUNJAB,Total,35-39,Graduate,88405,93907,182312
28468,3,State - PUNJAB,Total,40-44,Graduate,79613,69724,149337
28469,3,State - PUNJAB,Total,45-49,Graduate,70391,54701,125092
28470,3,State - PUNJAB,Total,50-54,Graduate,64002,43682,107684
28471,3,State - PUNJAB,Total,55-59,Graduate,60341,31612,91953
28472,3,State - PUNJAB,Total,60-64,Graduate,42444,17769,60213
28473,3,State - PUNJAB,Total,65-69,Graduate,22541,7423,29964
28474,3,State - PUNJAB,Total,70-74,Graduate,13702,3876,17578
28475,3,State - PUNJAB,Total,75-79,Graduate,6448,1445,7893
28476,3,State - PUNJAB,Total,80+,Graduate,5268,2059,7327
28477,3,State - PUNJAB,Total,Age not stated,Graduate,903,1065,1968
28478,3,State - PUNJAB,Rural,All ages,Graduate,227170,233815,460985
28479,3,State - PUNJAB,Rural,0-6,Graduate,0,0,0
28480,3,State - PUNJAB,Rural,7,Graduate,0,0,0
28481,3,State - PUNJAB,Rural,8,Graduate,0,0,0
28482,3,State - PUNJAB,Rural,9,Graduate,0,0,0
28483,3,State - PUNJAB,Rural,10,Graduate,0,0,0
28484,3,State - PUNJAB,Rural,11,Graduate,0,0,0
28485,3,State - PUNJAB,Rural,12,Graduate,0,0,0
28486,3,State - PUNJAB,Rural,13,Graduate,0,0,0
28487,3,State - PUNJAB,Rural,14,Graduate,0,0,0
28488,3,State - PUNJAB,Rural,15,Graduate,0,0,0
28489,3,State - PUNJAB,Rural,16,Graduate,0,0,0
28490,3,State - PUNJAB,Rural,17,Graduate,0,0,0
28491,3,State - PUNJAB,Rural,18,Graduate,0,0,0
28492,3,State - PUNJAB,Rural,19,Graduate,0,0,0
28493,3,State - PUNJAB,Rural,20-24,Graduate,44708,82866,127574
28494,3,State - PUNJAB,Rural,25-29,Graduate,47007,68794,115801
28495,3,State - PUNJAB,Rural,30-34,Graduate,30708,33476,64184
28496,3,State - PUNJAB,Rural,35-39,Graduate,20378,17581,37959
28497,3,State - PUNJAB,Rural,40-44,Graduate,19393,11115,30508
28498,3,State - PUNJAB,Rural,45-49,Graduate,16753,7501,24254
28499,3,State - PUNJAB,Rural,50-54,Graduate,14851,5211,20062
28500,3,State - PUNJAB,Rural,55-59,Graduate,14080,3491,17571
28501,3,State - PUNJAB,Rural,60-64,Graduate,9274,1703,10977
28502,3,State - PUNJAB,Rural,65-69,Graduate,4681,670,5351
28503,3,State - PUNJAB,Rural,70-74,Graduate,2668,368,3036
28504,3,State - PUNJAB,Rural,75-79,Graduate,1183,160,1343
28505,3,State - PUNJAB,Rural,80+,Graduate,1143,462,1605
28506,3,State - PUNJAB,Rural,Age not stated,Graduate,343,417,760
28507,3,State - PUNJAB,Urban,All ages,Graduate,646606,653255,1299861
28508,3,State - PUNJAB,Urban,0-6,Graduate,0,0,0
28509,3,State - PUNJAB,Urban,7,Graduate,0,0,0
28510,3,State - PUNJAB,Urban,8,Graduate,0,0,0
28511,3,State - PUNJAB,Urban,9,Graduate,0,0,0
28512,3,State - PUNJAB,Urban,10,Graduate,0,0,0
28513,3,State - PUNJAB,Urban,11,Graduate,0,0,0
28514,3,State - PUNJAB,Urban,12,Graduate,0,0,0
28515,3,State - PUNJAB,Urban,13,Graduate,0,0,0
28516,3,State - PUNJAB,Urban,14,Graduate,0,0,0
28517,3,State - PUNJAB,Urban,15,Graduate,0,0,0
28518,3,State - PUNJAB,Urban,16,Graduate,0,0,0
28519,3,State - PUNJAB,Urban,17,Graduate,0,0,0
28520,3,State - PUNJAB,Urban,18,Graduate,0,0,0
28521,3,State - PUNJAB,Urban,19,Graduate,0,0,0
28522,3,State - PUNJAB,Urban,20-24,Graduate,98472,126529,225001
28523,3,State - PUNJAB,Urban,25-29,Graduate,112151,143963,256114
28524,3,State - PUNJAB,Urban,30-34,Graduate,86672,104179,190851
28525,3,State - PUNJAB,Urban,35-39,Graduate,68027,76326,144353
28526,3,State - PUNJAB,Urban,40-44,Graduate,60220,58609,118829
28527,3,State - PUNJAB,Urban,45-49,Graduate,53638,47200,100838
28528,3,State - PUNJAB,Urban,50-54,Graduate,49151,38471,87622
28529,3,State - PUNJAB,Urban,55-59,Graduate,46261,28121,74382
28530,3,State - PUNJAB,Urban,60-64,Graduate,33170,16066,49236
28531,3,State - PUNJAB,Urban,65-69,Graduate,17860,6753,24613
28532,3,State - PUNJAB,Urban,70-74,Graduate,11034,3508,14542
28533,3,State - PUNJAB,Urban,75-79,Graduate,5265,1285,6550
28534,3,State - PUNJAB,Urban,80+,Graduate,4125,1597,5722
28535,3,State - PUNJAB,Urban,Age not stated,Graduate,560,648,1208
28536,4,State - CHANDIGARH,Total,All ages,Graduate,104748,89705,194453
28537,4,State - CHANDIGARH,Total,0-6,Graduate,0,0,0
28538,4,State - CHANDIGARH,Total,7,Graduate,0,0,0
28539,4,State - CHANDIGARH,Total,8,Graduate,0,0,0
28540,4,State - CHANDIGARH,Total,9,Graduate,0,0,0
28541,4,State - CHANDIGARH,Total,10,Graduate,0,0,0
28542,4,State - CHANDIGARH,Total,11,Graduate,0,0,0
28543,4,State - CHANDIGARH,Total,12,Graduate,0,0,0
28544,4,State - CHANDIGARH,Total,13,Graduate,0,0,0
28545,4,State - CHANDIGARH,Total,14,Graduate,0,0,0
28546,4,State - CHANDIGARH,Total,15,Graduate,0,0,0
28547,4,State - CHANDIGARH,Total,16,Graduate,0,0,0
28548,4,State - CHANDIGARH,Total,17,Graduate,0,0,0
28549,4,State - CHANDIGARH,Total,18,Graduate,0,0,0
28550,4,State - CHANDIGARH,Total,19,Graduate,0,0,0
28551,4,State - CHANDIGARH,Total,20-24,Graduate,14051,15234,29285
28552,4,State - CHANDIGARH,Total,25-29,Graduate,17857,17797,35654
28553,4,State - CHANDIGARH,Total,30-34,Graduate,13526,12811,26337
28554,4,State - CHANDIGARH,Total,35-39,Graduate,11258,10174,21432
28555,4,State - CHANDIGARH,Total,40-44,Graduate,9352,8332,17684
28556,4,State - CHANDIGARH,Total,45-49,Graduate,9066,7591,16657
28557,4,State - CHANDIGARH,Total,50-54,Graduate,8558,6427,14985
28558,4,State - CHANDIGARH,Total,55-59,Graduate,7913,4803,12716
28559,4,State - CHANDIGARH,Total,60-64,Graduate,5079,3011,8090
28560,4,State - CHANDIGARH,Total,65-69,Graduate,3057,1591,4648
28561,4,State - CHANDIGARH,Total,70-74,Graduate,2257,999,3256
28562,4,State - CHANDIGARH,Total,75-79,Graduate,1378,519,1897
28563,4,State - CHANDIGARH,Total,80+,Graduate,1368,395,1763
28564,4,State - CHANDIGARH,Total,Age not stated,Graduate,28,21,49
28565,4,State - CHANDIGARH,Rural,All ages,Graduate,1195,677,1872
28566,4,State - CHANDIGARH,Rural,0-6,Graduate,0,0,0
28567,4,State - CHANDIGARH,Rural,7,Graduate,0,0,0
28568,4,State - CHANDIGARH,Rural,8,Graduate,0,0,0
28569,4,State - CHANDIGARH,Rural,9,Graduate,0,0,0
28570,4,State - CHANDIGARH,Rural,10,Graduate,0,0,0
28571,4,State - CHANDIGARH,Rural,11,Graduate,0,0,0
28572,4,State - CHANDIGARH,Rural,12,Graduate,0,0,0
28573,4,State - CHANDIGARH,Rural,13,Graduate,0,0,0
28574,4,State - CHANDIGARH,Rural,14,Graduate,0,0,0
28575,4,State - CHANDIGARH,Rural,15,Graduate,0,0,0
28576,4,State - CHANDIGARH,Rural,16,Graduate,0,0,0
28577,4,State - CHANDIGARH,Rural,17,Graduate,0,0,0
28578,4,State - CHANDIGARH,Rural,18,Graduate,0,0,0
28579,4,State - CHANDIGARH,Rural,19,Graduate,0,0,0
28580,4,State - CHANDIGARH,Rural,20-24,Graduate,189,162,351
28581,4,State - CHANDIGARH,Rural,25-29,Graduate,355,220,575
28582,4,State - CHANDIGARH,Rural,30-34,Graduate,272,165,437
28583,4,State - CHANDIGARH,Rural,35-39,Graduate,145,56,201
28584,4,State - CHANDIGARH,Rural,40-44,Graduate,77,26,103
28585,4,State - CHANDIGARH,Rural,45-49,Graduate,41,17,58
28586,4,State - CHANDIGARH,Rural,50-54,Graduate,40,12,52
28587,4,State - CHANDIGARH,Rural,55-59,Graduate,33,9,42
28588,4,State - CHANDIGARH,Rural,60-64,Graduate,27,9,36
28589,4,State - CHANDIGARH,Rural,65-69,Graduate,11,1,12
28590,4,State - CHANDIGARH,Rural,70-74,Graduate,4,0,4
28591,4,State - CHANDIGARH,Rural,75-79,Graduate,1,0,1
28592,4,State - CHANDIGARH,Rural,80+,Graduate,0,0,0
28593,4,State - CHANDIGARH,Rural,Age not stated,Graduate,0,0,0
28594,4,State - CHANDIGARH,Urban,All ages,Graduate,103553,89028,192581
28595,4,State - CHANDIGARH,Urban,0-6,Graduate,0,0,0
28596,4,State - CHANDIGARH,Urban,7,Graduate,0,0,0
28597,4,State - CHANDIGARH,Urban,8,Graduate,0,0,0
28598,4,State - CHANDIGARH,Urban,9,Graduate,0,0,0
28599,4,State - CHANDIGARH,Urban,10,Graduate,0,0,0
28600,4,State - CHANDIGARH,Urban,11,Graduate,0,0,0
28601,4,State - CHANDIGARH,Urban,12,Graduate,0,0,0
28602,4,State - CHANDIGARH,Urban,13,Graduate,0,0,0
28603,4,State - CHANDIGARH,Urban,14,Graduate,0,0,0
28604,4,State - CHANDIGARH,Urban,15,Graduate,0,0,0
28605,4,State - CHANDIGARH,Urban,16,Graduate,0,0,0
28606,4,State - CHANDIGARH,Urban,17,Graduate,0,0,0
28607,4,State - CHANDIGARH,Urban,18,Graduate,0,0,0
28608,4,State - CHANDIGARH,Urban,19,Graduate,0,0,0
28609,4,State - CHANDIGARH,Urban,20-24,Graduate,13862,15072,28934
28610,4,State - CHANDIGARH,Urban,25-29,Graduate,17502,17577,35079
28611,4,State - CHANDIGARH,Urban,30-34,Graduate,13254,12646,25900
28612,4,State - CHANDIGARH,Urban,35-39,Graduate,11113,10118,21231
28613,4,State - CHANDIGARH,Urban,40-44,Graduate,9275,8306,17581
28614,4,State - CHANDIGARH,Urban,45-49,Graduate,9025,7574,16599
28615,4,State - CHANDIGARH,Urban,50-54,Graduate,8518,6415,14933
28616,4,State - CHANDIGARH,Urban,55-59,Graduate,7880,4794,12674
28617,4,State - CHANDIGARH,Urban,60-64,Graduate,5052,3002,8054
28618,4,State - CHANDIGARH,Urban,65-69,Graduate,3046,1590,4636
28619,4,State - CHANDIGARH,Urban,70-74,Graduate,2253,999,3252
28620,4,State - CHANDIGARH,Urban,75-79,Graduate,1377,519,1896
28621,4,State - CHANDIGARH,Urban,80+,Graduate,1368,395,1763
28622,4,State - CHANDIGARH,Urban,Age not stated,Graduate,28,21,49
28623,5,State - UTTARAKHAND,Total,All ages,Graduate,512068,398220,910288
28624,5,State - UTTARAKHAND,Total,0-6,Graduate,0,0,0
28625,5,State - UTTARAKHAND,Total,7,Graduate,0,0,0
28626,5,State - UTTARAKHAND,Total,8,Graduate,0,0,0
28627,5,State - UTTARAKHAND,Total,9,Graduate,0,0,0
28628,5,State - UTTARAKHAND,Total,10,Graduate,0,0,0
28629,5,State - UTTARAKHAND,Total,11,Graduate,0,0,0
28630,5,State - UTTARAKHAND,Total,12,Graduate,0,0,0
28631,5,State - UTTARAKHAND,Total,13,Graduate,0,0,0
28632,5,State - UTTARAKHAND,Total,14,Graduate,0,0,0
28633,5,State - UTTARAKHAND,Total,15,Graduate,0,0,0
28634,5,State - UTTARAKHAND,Total,16,Graduate,0,0,0
28635,5,State - UTTARAKHAND,Total,17,Graduate,0,0,0
28636,5,State - UTTARAKHAND,Total,18,Graduate,0,0,0
28637,5,State - UTTARAKHAND,Total,19,Graduate,0,0,0
28638,5,State - UTTARAKHAND,Total,20-24,Graduate,91453,103174,194627
28639,5,State - UTTARAKHAND,Total,25-29,Graduate,91236,95586,186822
28640,5,State - UTTARAKHAND,Total,30-34,Graduate,77903,65949,143852
28641,5,State - UTTARAKHAND,Total,35-39,Graduate,62959,44453,107412
28642,5,State - UTTARAKHAND,Total,40-44,Graduate,48904,29341,78245
28643,5,State - UTTARAKHAND,Total,45-49,Graduate,40756,20655,61411
28644,5,State - UTTARAKHAND,Total,50-54,Graduate,34002,15028,49030
28645,5,State - UTTARAKHAND,Total,55-59,Graduate,24710,10202,34912
28646,5,State - UTTARAKHAND,Total,60-64,Graduate,16955,6304,23259
28647,5,State - UTTARAKHAND,Total,65-69,Graduate,10069,3013,13082
28648,5,State - UTTARAKHAND,Total,70-74,Graduate,6047,1671,7718
28649,5,State - UTTARAKHAND,Total,75-79,Graduate,3044,748,3792
28650,5,State - UTTARAKHAND,Total,80+,Graduate,3050,1337,4387
28651,5,State - UTTARAKHAND,Total,Age not stated,Graduate,980,759,1739
28652,5,State - UTTARAKHAND,Rural,All ages,Graduate,231662,154392,386054
28653,5,State - UTTARAKHAND,Rural,0-6,Graduate,0,0,0
28654,5,State - UTTARAKHAND,Rural,7,Graduate,0,0,0
28655,5,State - UTTARAKHAND,Rural,8,Graduate,0,0,0
28656,5,State - UTTARAKHAND,Rural,9,Graduate,0,0,0
28657,5,State - UTTARAKHAND,Rural,10,Graduate,0,0,0
28658,5,State - UTTARAKHAND,Rural,11,Graduate,0,0,0
28659,5,State - UTTARAKHAND,Rural,12,Graduate,0,0,0
28660,5,State - UTTARAKHAND,Rural,13,Graduate,0,0,0
28661,5,State - UTTARAKHAND,Rural,14,Graduate,0,0,0
28662,5,State - UTTARAKHAND,Rural,15,Graduate,0,0,0
28663,5,State - UTTARAKHAND,Rural,16,Graduate,0,0,0
28664,5,State - UTTARAKHAND,Rural,17,Graduate,0,0,0
28665,5,State - UTTARAKHAND,Rural,18,Graduate,0,0,0
28666,5,State - UTTARAKHAND,Rural,19,Graduate,0,0,0
28667,5,State - UTTARAKHAND,Rural,20-24,Graduate,47523,52916,100439
28668,5,State - UTTARAKHAND,Rural,25-29,Graduate,45013,41953,86966
28669,5,State - UTTARAKHAND,Rural,30-34,Graduate,37549,25203,62752
28670,5,State - UTTARAKHAND,Rural,35-39,Graduate,28855,14457,43312
28671,5,State - UTTARAKHAND,Rural,40-44,Graduate,20857,7783,28640
28672,5,State - UTTARAKHAND,Rural,45-49,Graduate,15884,4656,20540
28673,5,State - UTTARAKHAND,Rural,50-54,Graduate,12905,2931,15836
28674,5,State - UTTARAKHAND,Rural,55-59,Graduate,9501,1877,11378
28675,5,State - UTTARAKHAND,Rural,60-64,Graduate,6246,991,7237
28676,5,State - UTTARAKHAND,Rural,65-69,Graduate,3292,464,3756
28677,5,State - UTTARAKHAND,Rural,70-74,Graduate,1759,289,2048
28678,5,State - UTTARAKHAND,Rural,75-79,Graduate,833,131,964
28679,5,State - UTTARAKHAND,Rural,80+,Graduate,992,439,1431
28680,5,State - UTTARAKHAND,Rural,Age not stated,Graduate,453,302,755
28681,5,State - UTTARAKHAND,Urban,All ages,Graduate,280406,243828,524234
28682,5,State - UTTARAKHAND,Urban,0-6,Graduate,0,0,0
28683,5,State - UTTARAKHAND,Urban,7,Graduate,0,0,0
28684,5,State - UTTARAKHAND,Urban,8,Graduate,0,0,0
28685,5,State - UTTARAKHAND,Urban,9,Graduate,0,0,0
28686,5,State - UTTARAKHAND,Urban,10,Graduate,0,0,0
28687,5,State - UTTARAKHAND,Urban,11,Graduate,0,0,0
28688,5,State - UTTARAKHAND,Urban,12,Graduate,0,0,0
28689,5,State - UTTARAKHAND,Urban,13,Graduate,0,0,0
28690,5,State - UTTARAKHAND,Urban,14,Graduate,0,0,0
28691,5,State - UTTARAKHAND,Urban,15,Graduate,0,0,0
28692,5,State - UTTARAKHAND,Urban,16,Graduate,0,0,0
28693,5,State - UTTARAKHAND,Urban,17,Graduate,0,0,0
28694,5,State - UTTARAKHAND,Urban,18,Graduate,0,0,0
28695,5,State - UTTARAKHAND,Urban,19,Graduate,0,0,0
28696,5,State - UTTARAKHAND,Urban,20-24,Graduate,43930,50258,94188
28697,5,State - UTTARAKHAND,Urban,25-29,Graduate,46223,53633,99856
28698,5,State - UTTARAKHAND,Urban,30-34,Graduate,40354,40746,81100
28699,5,State - UTTARAKHAND,Urban,35-39,Graduate,34104,29996,64100
28700,5,State - UTTARAKHAND,Urban,40-44,Graduate,28047,21558,49605
28701,5,State - UTTARAKHAND,Urban,45-49,Graduate,24872,15999,40871
28702,5,State - UTTARAKHAND,Urban,50-54,Graduate,21097,12097,33194
28703,5,State - UTTARAKHAND,Urban,55-59,Graduate,15209,8325,23534
28704,5,State - UTTARAKHAND,Urban,60-64,Graduate,10709,5313,16022
28705,5,State - UTTARAKHAND,Urban,65-69,Graduate,6777,2549,9326
28706,5,State - UTTARAKHAND,Urban,70-74,Graduate,4288,1382,5670
28707,5,State - UTTARAKHAND,Urban,75-79,Graduate,2211,617,2828
28708,5,State - UTTARAKHAND,Urban,80+,Graduate,2058,898,2956
28709,5,State - UTTARAKHAND,Urban,Age not stated,Graduate,527,457,984
28710,6,State - HARYANA,Total,All ages,Graduate,1102809,774276,1877085
28711,6,State - HARYANA,Total,0-6,Graduate,0,0,0
28712,6,State - HARYANA,Total,7,Graduate,0,0,0
28713,6,State - HARYANA,Total,8,Graduate,0,0,0
28714,6,State - HARYANA,Total,9,Graduate,0,0,0
28715,6,State - HARYANA,Total,10,Graduate,0,0,0
28716,6,State - HARYANA,Total,11,Graduate,0,0,0
28717,6,State - HARYANA,Total,12,Graduate,0,0,0
28718,6,State - HARYANA,Total,13,Graduate,0,0,0
28719,6,State - HARYANA,Total,14,Graduate,0,0,0
28720,6,State - HARYANA,Total,15,Graduate,0,0,0
28721,6,State - HARYANA,Total,16,Graduate,0,0,0
28722,6,State - HARYANA,Total,17,Graduate,0,0,0
28723,6,State - HARYANA,Total,18,Graduate,0,0,0
28724,6,State - HARYANA,Total,19,Graduate,0,0,0
28725,6,State - HARYANA,Total,20-24,Graduate,214527,198287,412814
28726,6,State - HARYANA,Total,25-29,Graduate,233409,196151,429560
28727,6,State - HARYANA,Total,30-34,Graduate,164848,123437,288285
28728,6,State - HARYANA,Total,35-39,Graduate,122738,81365,204103
28729,6,State - HARYANA,Total,40-44,Graduate,94167,53998,148165
28730,6,State - HARYANA,Total,45-49,Graduate,73792,39581,113373
28731,6,State - HARYANA,Total,50-54,Graduate,60356,30178,90534
28732,6,State - HARYANA,Total,55-59,Graduate,53130,22132,75262
28733,6,State - HARYANA,Total,60-64,Graduate,39081,14161,53242
28734,6,State - HARYANA,Total,65-69,Graduate,21335,6735,28070
28735,6,State - HARYANA,Total,70-74,Graduate,12906,3782,16688
28736,6,State - HARYANA,Total,75-79,Graduate,6062,1520,7582
28737,6,State - HARYANA,Total,80+,Graduate,5257,1953,7210
28738,6,State - HARYANA,Total,Age not stated,Graduate,1201,996,2197
28739,6,State - HARYANA,Rural,All ages,Graduate,381815,183246,565061
28740,6,State - HARYANA,Rural,0-6,Graduate,0,0,0
28741,6,State - HARYANA,Rural,7,Graduate,0,0,0
28742,6,State - HARYANA,Rural,8,Graduate,0,0,0
28743,6,State - HARYANA,Rural,9,Graduate,0,0,0
28744,6,State - HARYANA,Rural,10,Graduate,0,0,0
28745,6,State - HARYANA,Rural,11,Graduate,0,0,0
28746,6,State - HARYANA,Rural,12,Graduate,0,0,0
28747,6,State - HARYANA,Rural,13,Graduate,0,0,0
28748,6,State - HARYANA,Rural,14,Graduate,0,0,0
28749,6,State - HARYANA,Rural,15,Graduate,0,0,0
28750,6,State - HARYANA,Rural,16,Graduate,0,0,0
28751,6,State - HARYANA,Rural,17,Graduate,0,0,0
28752,6,State - HARYANA,Rural,18,Graduate,0,0,0
28753,6,State - HARYANA,Rural,19,Graduate,0,0,0
28754,6,State - HARYANA,Rural,20-24,Graduate,98275,77177,175452
28755,6,State - HARYANA,Rural,25-29,Graduate,98513,58417,156930
28756,6,State - HARYANA,Rural,30-34,Graduate,60117,25246,85363
28757,6,State - HARYANA,Rural,35-39,Graduate,38303,10651,48954
28758,6,State - HARYANA,Rural,40-44,Graduate,26366,4922,31288
28759,6,State - HARYANA,Rural,45-49,Graduate,17876,2606,20482
28760,6,State - HARYANA,Rural,50-54,Graduate,13211,1572,14783
28761,6,State - HARYANA,Rural,55-59,Graduate,12187,1007,13194
28762,6,State - HARYANA,Rural,60-64,Graduate,8904,560,9464
28763,6,State - HARYANA,Rural,65-69,Graduate,3866,248,4114
28764,6,State - HARYANA,Rural,70-74,Graduate,2095,180,2275
28765,6,State - HARYANA,Rural,75-79,Graduate,757,77,834
28766,6,State - HARYANA,Rural,80+,Graduate,904,288,1192
28767,6,State - HARYANA,Rural,Age not stated,Graduate,441,295,736
28768,6,State - HARYANA,Urban,All ages,Graduate,720994,591030,1312024
28769,6,State - HARYANA,Urban,0-6,Graduate,0,0,0
28770,6,State - HARYANA,Urban,7,Graduate,0,0,0
28771,6,State - HARYANA,Urban,8,Graduate,0,0,0
28772,6,State - HARYANA,Urban,9,Graduate,0,0,0
28773,6,State - HARYANA,Urban,10,Graduate,0,0,0
28774,6,State - HARYANA,Urban,11,Graduate,0,0,0
28775,6,State - HARYANA,Urban,12,Graduate,0,0,0
28776,6,State - HARYANA,Urban,13,Graduate,0,0,0
28777,6,State - HARYANA,Urban,14,Graduate,0,0,0
28778,6,State - HARYANA,Urban,15,Graduate,0,0,0
28779,6,State - HARYANA,Urban,16,Graduate,0,0,0
28780,6,State - HARYANA,Urban,17,Graduate,0,0,0
28781,6,State - HARYANA,Urban,18,Graduate,0,0,0
28782,6,State - HARYANA,Urban,19,Graduate,0,0,0
28783,6,State - HARYANA,Urban,20-24,Graduate,116252,121110,237362
28784,6,State - HARYANA,Urban,25-29,Graduate,134896,137734,272630
28785,6,State - HARYANA,Urban,30-34,Graduate,104731,98191,202922
28786,6,State - HARYANA,Urban,35-39,Graduate,84435,70714,155149
28787,6,State - HARYANA,Urban,40-44,Graduate,67801,49076,116877
28788,6,State - HARYANA,Urban,45-49,Graduate,55916,36975,92891
28789,6,State - HARYANA,Urban,50-54,Graduate,47145,28606,75751
28790,6,State - HARYANA,Urban,55-59,Graduate,40943,21125,62068
28791,6,State - HARYANA,Urban,60-64,Graduate,30177,13601,43778
28792,6,State - HARYANA,Urban,65-69,Graduate,17469,6487,23956
28793,6,State - HARYANA,Urban,70-74,Graduate,10811,3602,14413
28794,6,State - HARYANA,Urban,75-79,Graduate,5305,1443,6748
28795,6,State - HARYANA,Urban,80+,Graduate,4353,1665,6018
28796,6,State - HARYANA,Urban,Age not stated,Graduate,760,701,1461
28797,7,State - NCT OF DELHI,Total,All ages,Graduate,1535972,1221872,2757844
28798,7,State - NCT OF DELHI,Total,0-6,Graduate,0,0,0
28799,7,State - NCT OF DELHI,Total,7,Graduate,0,0,0
28800,7,State - NCT OF DELHI,Total,8,Graduate,0,0,0
28801,7,State - NCT OF DELHI,Total,9,Graduate,0,0,0
28802,7,State - NCT OF DELHI,Total,10,Graduate,0,0,0
28803,7,State - NCT OF DELHI,Total,11,Graduate,0,0,0
28804,7,State - NCT OF DELHI,Total,12,Graduate,0,0,0
28805,7,State - NCT OF DELHI,Total,13,Graduate,0,0,0
28806,7,State - NCT OF DELHI,Total,14,Graduate,0,0,0
28807,7,State - NCT OF DELHI,Total,15,Graduate,0,0,0
28808,7,State - NCT OF DELHI,Total,16,Graduate,0,0,0
28809,7,State - NCT OF DELHI,Total,17,Graduate,0,0,0
28810,7,State - NCT OF DELHI,Total,18,Graduate,0,0,0
28811,7,State - NCT OF DELHI,Total,19,Graduate,0,0,0
28812,7,State - NCT OF DELHI,Total,20-24,Graduate,221761,214401,436162
28813,7,State - NCT OF DELHI,Total,25-29,Graduate,263302,254006,517308
28814,7,State - NCT OF DELHI,Total,30-34,Graduate,217390,190049,407439
28815,7,State - NCT OF DELHI,Total,35-39,Graduate,181501,147033,328534
28816,7,State - NCT OF DELHI,Total,40-44,Graduate,154585,114763,269348
28817,7,State - NCT OF DELHI,Total,45-49,Graduate,132551,95365,227916
28818,7,State - NCT OF DELHI,Total,50-54,Graduate,116046,77122,193168
28819,7,State - NCT OF DELHI,Total,55-59,Graduate,92365,55414,147779
28820,7,State - NCT OF DELHI,Total,60-64,Graduate,63261,34455,97716
28821,7,State - NCT OF DELHI,Total,65-69,Graduate,37771,17710,55481
28822,7,State - NCT OF DELHI,Total,70-74,Graduate,25900,10798,36698
28823,7,State - NCT OF DELHI,Total,75-79,Graduate,15314,5029,20343
28824,7,State - NCT OF DELHI,Total,80+,Graduate,13112,4709,17821
28825,7,State - NCT OF DELHI,Total,Age not stated,Graduate,1113,1018,2131
28826,7,State - NCT OF DELHI,Rural,All ages,Graduate,17725,10833,28558
28827,7,State - NCT OF DELHI,Rural,0-6,Graduate,0,0,0
28828,7,State - NCT OF DELHI,Rural,7,Graduate,0,0,0
28829,7,State - NCT OF DELHI,Rural,8,Graduate,0,0,0
28830,7,State - NCT OF DELHI,Rural,9,Graduate,0,0,0
28831,7,State - NCT OF DELHI,Rural,10,Graduate,0,0,0
28832,7,State - NCT OF DELHI,Rural,11,Graduate,0,0,0
28833,7,State - NCT OF DELHI,Rural,12,Graduate,0,0,0
28834,7,State - NCT OF DELHI,Rural,13,Graduate,0,0,0
28835,7,State - NCT OF DELHI,Rural,14,Graduate,0,0,0
28836,7,State - NCT OF DELHI,Rural,15,Graduate,0,0,0
28837,7,State - NCT OF DELHI,Rural,16,Graduate,0,0,0
28838,7,State - NCT OF DELHI,Rural,17,Graduate,0,0,0
28839,7,State - NCT OF DELHI,Rural,18,Graduate,0,0,0
28840,7,State - NCT OF DELHI,Rural,19,Graduate,0,0,0
28841,7,State - NCT OF DELHI,Rural,20-24,Graduate,3516,3295,6811
28842,7,State - NCT OF DELHI,Rural,25-29,Graduate,3823,3267,7090
28843,7,State - NCT OF DELHI,Rural,30-34,Graduate,2709,1852,4561
28844,7,State - NCT OF DELHI,Rural,35-39,Graduate,2163,1044,3207
28845,7,State - NCT OF DELHI,Rural,40-44,Graduate,1645,518,2163
28846,7,State - NCT OF DELHI,Rural,45-49,Graduate,1068,280,1348
28847,7,State - NCT OF DELHI,Rural,50-54,Graduate,885,229,1114
28848,7,State - NCT OF DELHI,Rural,55-59,Graduate,764,144,908
28849,7,State - NCT OF DELHI,Rural,60-64,Graduate,561,109,670
28850,7,State - NCT OF DELHI,Rural,65-69,Graduate,265,31,296
28851,7,State - NCT OF DELHI,Rural,70-74,Graduate,171,21,192
28852,7,State - NCT OF DELHI,Rural,75-79,Graduate,69,11,80
28853,7,State - NCT OF DELHI,Rural,80+,Graduate,68,18,86
28854,7,State - NCT OF DELHI,Rural,Age not stated,Graduate,18,14,32
28855,7,State - NCT OF DELHI,Urban,All ages,Graduate,1518247,1211039,2729286
28856,7,State - NCT OF DELHI,Urban,0-6,Graduate,0,0,0
28857,7,State - NCT OF DELHI,Urban,7,Graduate,0,0,0
28858,7,State - NCT OF DELHI,Urban,8,Graduate,0,0,0
28859,7,State - NCT OF DELHI,Urban,9,Graduate,0,0,0
28860,7,State - NCT OF DELHI,Urban,10,Graduate,0,0,0
28861,7,State - NCT OF DELHI,Urban,11,Graduate,0,0,0
28862,7,State - NCT OF DELHI,Urban,12,Graduate,0,0,0
28863,7,State - NCT OF DELHI,Urban,13,Graduate,0,0,0
28864,7,State - NCT OF DELHI,Urban,14,Graduate,0,0,0
28865,7,State - NCT OF DELHI,Urban,15,Graduate,0,0,0
28866,7,State - NCT OF DELHI,Urban,16,Graduate,0,0,0
28867,7,State - NCT OF DELHI,Urban,17,Graduate,0,0,0
28868,7,State - NCT OF DELHI,Urban,18,Graduate,0,0,0
28869,7,State - NCT OF DELHI,Urban,19,Graduate,0,0,0
28870,7,State - NCT OF DELHI,Urban,20-24,Graduate,218245,211106,429351
28871,7,State - NCT OF DELHI,Urban,25-29,Graduate,259479,250739,510218
28872,7,State - NCT OF DELHI,Urban,30-34,Graduate,214681,188197,402878
28873,7,State - NCT OF DELHI,Urban,35-39,Graduate,179338,145989,325327
28874,7,State - NCT OF DELHI,Urban,40-44,Graduate,152940,114245,267185
28875,7,State - NCT OF DELHI,Urban,45-49,Graduate,131483,95085,226568
28876,7,State - NCT OF DELHI,Urban,50-54,Graduate,115161,76893,192054
28877,7,State - NCT OF DELHI,Urban,55-59,Graduate,91601,55270,146871
28878,7,State - NCT OF DELHI,Urban,60-64,Graduate,62700,34346,97046
28879,7,State - NCT OF DELHI,Urban,65-69,Graduate,37506,17679,55185
28880,7,State - NCT OF DELHI,Urban,70-74,Graduate,25729,10777,36506
28881,7,State - NCT OF DELHI,Urban,75-79,Graduate,15245,5018,20263
28882,7,State - NCT OF DELHI,Urban,80+,Graduate,13044,4691,17735
28883,7,State - NCT OF DELHI,Urban,Age not stated,Graduate,1095,1004,2099
28884,8,State - RAJASTHAN,Total,All ages,Graduate,2086247,977035,3063282
28885,8,State - RAJASTHAN,Total,0-6,Graduate,0,0,0
28886,8,State - RAJASTHAN,Total,7,Graduate,0,0,0
28887,8,State - RAJASTHAN,Total,8,Graduate,0,0,0
28888,8,State - RAJASTHAN,Total,9,Graduate,0,0,0
28889,8,State - RAJASTHAN,Total,10,Graduate,0,0,0
28890,8,State - RAJASTHAN,Total,11,Graduate,0,0,0
28891,8,State - RAJASTHAN,Total,12,Graduate,0,0,0
28892,8,State - RAJASTHAN,Total,13,Graduate,0,0,0
28893,8,State - RAJASTHAN,Total,14,Graduate,0,0,0
28894,8,State - RAJASTHAN,Total,15,Graduate,0,0,0
28895,8,State - RAJASTHAN,Total,16,Graduate,0,0,0
28896,8,State - RAJASTHAN,Total,17,Graduate,0,0,0
28897,8,State - RAJASTHAN,Total,18,Graduate,0,0,0
28898,8,State - RAJASTHAN,Total,19,Graduate,0,0,0
28899,8,State - RAJASTHAN,Total,20-24,Graduate,424844,270194,695038
28900,8,State - RAJASTHAN,Total,25-29,Graduate,429503,242427,671930
28901,8,State - RAJASTHAN,Total,30-34,Graduate,309955,153982,463937
28902,8,State - RAJASTHAN,Total,35-39,Graduate,236398,102443,338841
28903,8,State - RAJASTHAN,Total,40-44,Graduate,190917,71236,262153
28904,8,State - RAJASTHAN,Total,45-49,Graduate,157341,50907,208248
28905,8,State - RAJASTHAN,Total,50-54,Graduate,120083,35048,155131
28906,8,State - RAJASTHAN,Total,55-59,Graduate,81912,21834,103746
28907,8,State - RAJASTHAN,Total,60-64,Graduate,54223,12453,66676
28908,8,State - RAJASTHAN,Total,65-69,Graduate,31937,5853,37790
28909,8,State - RAJASTHAN,Total,70-74,Graduate,21497,3357,24854
28910,8,State - RAJASTHAN,Total,75-79,Graduate,10919,1477,12396
28911,8,State - RAJASTHAN,Total,80+,Graduate,8671,2051,10722
28912,8,State - RAJASTHAN,Total,Age not stated,Graduate,8047,3773,11820
28913,8,State - RAJASTHAN,Rural,All ages,Graduate,905012,225802,1130814
28914,8,State - RAJASTHAN,Rural,0-6,Graduate,0,0,0
28915,8,State - RAJASTHAN,Rural,7,Graduate,0,0,0
28916,8,State - RAJASTHAN,Rural,8,Graduate,0,0,0
28917,8,State - RAJASTHAN,Rural,9,Graduate,0,0,0
28918,8,State - RAJASTHAN,Rural,10,Graduate,0,0,0
28919,8,State - RAJASTHAN,Rural,11,Graduate,0,0,0
28920,8,State - RAJASTHAN,Rural,12,Graduate,0,0,0
28921,8,State - RAJASTHAN,Rural,13,Graduate,0,0,0
28922,8,State - RAJASTHAN,Rural,14,Graduate,0,0,0
28923,8,State - RAJASTHAN,Rural,15,Graduate,0,0,0
28924,8,State - RAJASTHAN,Rural,16,Graduate,0,0,0
28925,8,State - RAJASTHAN,Rural,17,Graduate,0,0,0
28926,8,State - RAJASTHAN,Rural,18,Graduate,0,0,0
28927,8,State - RAJASTHAN,Rural,19,Graduate,0,0,0
28928,8,State - RAJASTHAN,Rural,20-24,Graduate,234867,96482,331349
28929,8,State - RAJASTHAN,Rural,25-29,Graduate,214388,65898,280286
28930,8,State - RAJASTHAN,Rural,30-34,Graduate,143762,31562,175324
28931,8,State - RAJASTHAN,Rural,35-39,Graduate,101309,14830,116139
28932,8,State - RAJASTHAN,Rural,40-44,Graduate,72315,7399,79714
28933,8,State - RAJASTHAN,Rural,45-49,Graduate,52080,3754,55834
28934,8,State - RAJASTHAN,Rural,50-54,Graduate,33431,1957,35388
28935,8,State - RAJASTHAN,Rural,55-59,Graduate,19614,1037,20651
28936,8,State - RAJASTHAN,Rural,60-64,Graduate,12408,521,12929
28937,8,State - RAJASTHAN,Rural,65-69,Graduate,7604,292,7896
28938,8,State - RAJASTHAN,Rural,70-74,Graduate,4860,220,5080
28939,8,State - RAJASTHAN,Rural,75-79,Graduate,1933,85,2018
28940,8,State - RAJASTHAN,Rural,80+,Graduate,1851,284,2135
28941,8,State - RAJASTHAN,Rural,Age not stated,Graduate,4590,1481,6071
28942,8,State - RAJASTHAN,Urban,All ages,Graduate,1181235,751233,1932468
28943,8,State - RAJASTHAN,Urban,0-6,Graduate,0,0,0
28944,8,State - RAJASTHAN,Urban,7,Graduate,0,0,0
28945,8,State - RAJASTHAN,Urban,8,Graduate,0,0,0
28946,8,State - RAJASTHAN,Urban,9,Graduate,0,0,0
28947,8,State - RAJASTHAN,Urban,10,Graduate,0,0,0
28948,8,State - RAJASTHAN,Urban,11,Graduate,0,0,0
28949,8,State - RAJASTHAN,Urban,12,Graduate,0,0,0
28950,8,State - RAJASTHAN,Urban,13,Graduate,0,0,0
28951,8,State - RAJASTHAN,Urban,14,Graduate,0,0,0
28952,8,State - RAJASTHAN,Urban,15,Graduate,0,0,0
28953,8,State - RAJASTHAN,Urban,16,Graduate,0,0,0
28954,8,State - RAJASTHAN,Urban,17,Graduate,0,0,0
28955,8,State - RAJASTHAN,Urban,18,Graduate,0,0,0
28956,8,State - RAJASTHAN,Urban,19,Graduate,0,0,0
28957,8,State - RAJASTHAN,Urban,20-24,Graduate,189977,173712,363689
28958,8,State - RAJASTHAN,Urban,25-29,Graduate,215115,176529,391644
28959,8,State - RAJASTHAN,Urban,30-34,Graduate,166193,122420,288613
28960,8,State - RAJASTHAN,Urban,35-39,Graduate,135089,87613,222702
28961,8,State - RAJASTHAN,Urban,40-44,Graduate,118602,63837,182439
28962,8,State - RAJASTHAN,Urban,45-49,Graduate,105261,47153,152414
28963,8,State - RAJASTHAN,Urban,50-54,Graduate,86652,33091,119743
28964,8,State - RAJASTHAN,Urban,55-59,Graduate,62298,20797,83095
28965,8,State - RAJASTHAN,Urban,60-64,Graduate,41815,11932,53747
28966,8,State - RAJASTHAN,Urban,65-69,Graduate,24333,5561,29894
28967,8,State - RAJASTHAN,Urban,70-74,Graduate,16637,3137,19774
28968,8,State - RAJASTHAN,Urban,75-79,Graduate,8986,1392,10378
28969,8,State - RAJASTHAN,Urban,80+,Graduate,6820,1767,8587
28970,8,State - RAJASTHAN,Urban,Age not stated,Graduate,3457,2292,5749
28971,9,State - UTTAR PRADESH,Total,All ages,Graduate,6378138,3541700,9919838
28972,9,State - UTTAR PRADESH,Total,0-6,Graduate,0,0,0
28973,9,State - UTTAR PRADESH,Total,7,Graduate,0,0,0
28974,9,State - UTTAR PRADESH,Total,8,Graduate,0,0,0
28975,9,State - UTTAR PRADESH,Total,9,Graduate,0,0,0
28976,9,State - UTTAR PRADESH,Total,10,Graduate,0,0,0
28977,9,State - UTTAR PRADESH,Total,11,Graduate,0,0,0
28978,9,State - UTTAR PRADESH,Total,12,Graduate,0,0,0
28979,9,State - UTTAR PRADESH,Total,13,Graduate,0,0,0
28980,9,State - UTTAR PRADESH,Total,14,Graduate,0,0,0
28981,9,State - UTTAR PRADESH,Total,15,Graduate,0,0,0
28982,9,State - UTTAR PRADESH,Total,16,Graduate,0,0,0
28983,9,State - UTTAR PRADESH,Total,17,Graduate,0,0,0
28984,9,State - UTTAR PRADESH,Total,18,Graduate,0,0,0
28985,9,State - UTTAR PRADESH,Total,19,Graduate,0,0,0
28986,9,State - UTTAR PRADESH,Total,20-24,Graduate,1236619,997959,2234578
28987,9,State - UTTAR PRADESH,Total,25-29,Graduate,1215292,859424,2074716
28988,9,State - UTTAR PRADESH,Total,30-34,Graduate,894926,537265,1432191
28989,9,State - UTTAR PRADESH,Total,35-39,Graduate,721489,359193,1080682
28990,9,State - UTTAR PRADESH,Total,40-44,Graduate,565086,240105,805191
28991,9,State - UTTAR PRADESH,Total,45-49,Graduate,488244,178702,666946
28992,9,State - UTTAR PRADESH,Total,50-54,Graduate,404492,128019,532511
28993,9,State - UTTAR PRADESH,Total,55-59,Graduate,307116,85278,392394
28994,9,State - UTTAR PRADESH,Total,60-64,Graduate,212939,50882,263821
28995,9,State - UTTAR PRADESH,Total,65-69,Graduate,120731,24994,145725
28996,9,State - UTTAR PRADESH,Total,70-74,Graduate,74125,14484,88609
28997,9,State - UTTAR PRADESH,Total,75-79,Graduate,33844,6699,40543
28998,9,State - UTTAR PRADESH,Total,80+,Graduate,45520,20242,65762
28999,9,State - UTTAR PRADESH,Total,Age not stated,Graduate,57715,38454,96169
29000,9,State - UTTAR PRADESH,Rural,All ages,Graduate,3344339,1310603,4654942
29001,9,State - UTTAR PRADESH,Rural,0-6,Graduate,0,0,0
29002,9,State - UTTAR PRADESH,Rural,7,Graduate,0,0,0
29003,9,State - UTTAR PRADESH,Rural,8,Graduate,0,0,0
29004,9,State - UTTAR PRADESH,Rural,9,Graduate,0,0,0
29005,9,State - UTTAR PRADESH,Rural,10,Graduate,0,0,0
29006,9,State - UTTAR PRADESH,Rural,11,Graduate,0,0,0
29007,9,State - UTTAR PRADESH,Rural,12,Graduate,0,0,0
29008,9,State - UTTAR PRADESH,Rural,13,Graduate,0,0,0
29009,9,State - UTTAR PRADESH,Rural,14,Graduate,0,0,0
29010,9,State - UTTAR PRADESH,Rural,15,Graduate,0,0,0
29011,9,State - UTTAR PRADESH,Rural,16,Graduate,0,0,0
29012,9,State - UTTAR PRADESH,Rural,17,Graduate,0,0,0
29013,9,State - UTTAR PRADESH,Rural,18,Graduate,0,0,0
29014,9,State - UTTAR PRADESH,Rural,19,Graduate,0,0,0
29015,9,State - UTTAR PRADESH,Rural,20-24,Graduate,753222,501649,1254871
29016,9,State - UTTAR PRADESH,Rural,25-29,Graduate,697405,365423,1062828
29017,9,State - UTTAR PRADESH,Rural,30-34,Graduate,483400,191453,674853
29018,9,State - UTTAR PRADESH,Rural,35-39,Graduate,368792,102308,471100
29019,9,State - UTTAR PRADESH,Rural,40-44,Graduate,269764,54333,324097
29020,9,State - UTTAR PRADESH,Rural,45-49,Graduate,223657,32162,255819
29021,9,State - UTTAR PRADESH,Rural,50-54,Graduate,182977,19677,202654
29022,9,State - UTTAR PRADESH,Rural,55-59,Graduate,137856,11418,149274
29023,9,State - UTTAR PRADESH,Rural,60-64,Graduate,92231,6087,98318
29024,9,State - UTTAR PRADESH,Rural,65-69,Graduate,49981,3476,53457
29025,9,State - UTTAR PRADESH,Rural,70-74,Graduate,28470,2377,30847
29026,9,State - UTTAR PRADESH,Rural,75-79,Graduate,11214,1177,12391
29027,9,State - UTTAR PRADESH,Rural,80+,Graduate,18747,6329,25076
29028,9,State - UTTAR PRADESH,Rural,Age not stated,Graduate,26623,12734,39357
29029,9,State - UTTAR PRADESH,Urban,All ages,Graduate,3033799,2231097,5264896
29030,9,State - UTTAR PRADESH,Urban,0-6,Graduate,0,0,0
29031,9,State - UTTAR PRADESH,Urban,7,Graduate,0,0,0
29032,9,State - UTTAR PRADESH,Urban,8,Graduate,0,0,0
29033,9,State - UTTAR PRADESH,Urban,9,Graduate,0,0,0
29034,9,State - UTTAR PRADESH,Urban,10,Graduate,0,0,0
29035,9,State - UTTAR PRADESH,Urban,11,Graduate,0,0,0
29036,9,State - UTTAR PRADESH,Urban,12,Graduate,0,0,0
29037,9,State - UTTAR PRADESH,Urban,13,Graduate,0,0,0
29038,9,State - UTTAR PRADESH,Urban,14,Graduate,0,0,0
29039,9,State - UTTAR PRADESH,Urban,15,Graduate,0,0,0
29040,9,State - UTTAR PRADESH,Urban,16,Graduate,0,0,0
29041,9,State - UTTAR PRADESH,Urban,17,Graduate,0,0,0
29042,9,State - UTTAR PRADESH,Urban,18,Graduate,0,0,0
29043,9,State - UTTAR PRADESH,Urban,19,Graduate,0,0,0
29044,9,State - UTTAR PRADESH,Urban,20-24,Graduate,483397,496310,979707
29045,9,State - UTTAR PRADESH,Urban,25-29,Graduate,517887,494001,1011888
29046,9,State - UTTAR PRADESH,Urban,30-34,Graduate,411526,345812,757338
29047,9,State - UTTAR PRADESH,Urban,35-39,Graduate,352697,256885,609582
29048,9,State - UTTAR PRADESH,Urban,40-44,Graduate,295322,185772,481094
29049,9,State - UTTAR PRADESH,Urban,45-49,Graduate,264587,146540,411127
29050,9,State - UTTAR PRADESH,Urban,50-54,Graduate,221515,108342,329857
29051,9,State - UTTAR PRADESH,Urban,55-59,Graduate,169260,73860,243120
29052,9,State - UTTAR PRADESH,Urban,60-64,Graduate,120708,44795,165503
29053,9,State - UTTAR PRADESH,Urban,65-69,Graduate,70750,21518,92268
29054,9,State - UTTAR PRADESH,Urban,70-74,Graduate,45655,12107,57762
29055,9,State - UTTAR PRADESH,Urban,75-79,Graduate,22630,5522,28152
29056,9,State - UTTAR PRADESH,Urban,80+,Graduate,26773,13913,40686
29057,9,State - UTTAR PRADESH,Urban,Age not stated,Graduate,31092,25720,56812
29058,10,State - BIHAR,Total,All ages,Graduate,2326092,735584,3061676
29059,10,State - BIHAR,Total,0-6,Graduate,0,0,0
29060,10,State - BIHAR,Total,7,Graduate,0,0,0
29061,10,State - BIHAR,Total,8,Graduate,0,0,0
29062,10,State - BIHAR,Total,9,Graduate,0,0,0
29063,10,State - BIHAR,Total,10,Graduate,0,0,0
29064,10,State - BIHAR,Total,11,Graduate,0,0,0
29065,10,State - BIHAR,Total,12,Graduate,0,0,0
29066,10,State - BIHAR,Total,13,Graduate,0,0,0
29067,10,State - BIHAR,Total,14,Graduate,0,0,0
29068,10,State - BIHAR,Total,15,Graduate,0,0,0
29069,10,State - BIHAR,Total,16,Graduate,0,0,0
29070,10,State - BIHAR,Total,17,Graduate,0,0,0
29071,10,State - BIHAR,Total,18,Graduate,0,0,0
29072,10,State - BIHAR,Total,19,Graduate,0,0,0
29073,10,State - BIHAR,Total,20-24,Graduate,345778,183250,529028
29074,10,State - BIHAR,Total,25-29,Graduate,390768,169799,560567
29075,10,State - BIHAR,Total,30-34,Graduate,307952,116606,424558
29076,10,State - BIHAR,Total,35-39,Graduate,316473,94972,411445
29077,10,State - BIHAR,Total,40-44,Graduate,283750,66725,350475
29078,10,State - BIHAR,Total,45-49,Graduate,213482,42025,255507
29079,10,State - BIHAR,Total,50-54,Graduate,138078,23093,161171
29080,10,State - BIHAR,Total,55-59,Graduate,110409,15637,126046
29081,10,State - BIHAR,Total,60-64,Graduate,88112,9209,97321
29082,10,State - BIHAR,Total,65-69,Graduate,56809,4838,61647
29083,10,State - BIHAR,Total,70-74,Graduate,35401,2406,37807
29084,10,State - BIHAR,Total,75-79,Graduate,14922,1049,15971
29085,10,State - BIHAR,Total,80+,Graduate,14029,2230,16259
29086,10,State - BIHAR,Total,Age not stated,Graduate,10129,3745,13874
29087,10,State - BIHAR,Rural,All ages,Graduate,1488731,362404,1851135
29088,10,State - BIHAR,Rural,0-6,Graduate,0,0,0
29089,10,State - BIHAR,Rural,7,Graduate,0,0,0
29090,10,State - BIHAR,Rural,8,Graduate,0,0,0
29091,10,State - BIHAR,Rural,9,Graduate,0,0,0
29092,10,State - BIHAR,Rural,10,Graduate,0,0,0
29093,10,State - BIHAR,Rural,11,Graduate,0,0,0
29094,10,State - BIHAR,Rural,12,Graduate,0,0,0
29095,10,State - BIHAR,Rural,13,Graduate,0,0,0
29096,10,State - BIHAR,Rural,14,Graduate,0,0,0
29097,10,State - BIHAR,Rural,15,Graduate,0,0,0
29098,10,State - BIHAR,Rural,16,Graduate,0,0,0
29099,10,State - BIHAR,Rural,17,Graduate,0,0,0
29100,10,State - BIHAR,Rural,18,Graduate,0,0,0
29101,10,State - BIHAR,Rural,19,Graduate,0,0,0
29102,10,State - BIHAR,Rural,20-24,Graduate,233723,100849,334572
29103,10,State - BIHAR,Rural,25-29,Graduate,255548,88312,343860
29104,10,State - BIHAR,Rural,30-34,Graduate,195910,57944,253854
29105,10,State - BIHAR,Rural,35-39,Graduate,208016,45895,253911
29106,10,State - BIHAR,Rural,40-44,Graduate,186615,30161,216776
29107,10,State - BIHAR,Rural,45-49,Graduate,135172,16854,152026
29108,10,State - BIHAR,Rural,50-54,Graduate,81531,8138,89669
29109,10,State - BIHAR,Rural,55-59,Graduate,63320,5496,68816
29110,10,State - BIHAR,Rural,60-64,Graduate,51827,3118,54945
29111,10,State - BIHAR,Rural,65-69,Graduate,34128,1747,35875
29112,10,State - BIHAR,Rural,70-74,Graduate,20685,910,21595
29113,10,State - BIHAR,Rural,75-79,Graduate,8236,343,8579
29114,10,State - BIHAR,Rural,80+,Graduate,8221,1035,9256
29115,10,State - BIHAR,Rural,Age not stated,Graduate,5799,1602,7401
29116,10,State - BIHAR,Urban,All ages,Graduate,837361,373180,1210541
29117,10,State - BIHAR,Urban,0-6,Graduate,0,0,0
29118,10,State - BIHAR,Urban,7,Graduate,0,0,0
29119,10,State - BIHAR,Urban,8,Graduate,0,0,0
29120,10,State - BIHAR,Urban,9,Graduate,0,0,0
29121,10,State - BIHAR,Urban,10,Graduate,0,0,0
29122,10,State - BIHAR,Urban,11,Graduate,0,0,0
29123,10,State - BIHAR,Urban,12,Graduate,0,0,0
29124,10,State - BIHAR,Urban,13,Graduate,0,0,0
29125,10,State - BIHAR,Urban,14,Graduate,0,0,0
29126,10,State - BIHAR,Urban,15,Graduate,0,0,0
29127,10,State - BIHAR,Urban,16,Graduate,0,0,0
29128,10,State - BIHAR,Urban,17,Graduate,0,0,0
29129,10,State - BIHAR,Urban,18,Graduate,0,0,0
29130,10,State - BIHAR,Urban,19,Graduate,0,0,0
29131,10,State - BIHAR,Urban,20-24,Graduate,112055,82401,194456
29132,10,State - BIHAR,Urban,25-29,Graduate,135220,81487,216707
29133,10,State - BIHAR,Urban,30-34,Graduate,112042,58662,170704
29134,10,State - BIHAR,Urban,35-39,Graduate,108457,49077,157534
29135,10,State - BIHAR,Urban,40-44,Graduate,97135,36564,133699
29136,10,State - BIHAR,Urban,45-49,Graduate,78310,25171,103481
29137,10,State - BIHAR,Urban,50-54,Graduate,56547,14955,71502
29138,10,State - BIHAR,Urban,55-59,Graduate,47089,10141,57230
29139,10,State - BIHAR,Urban,60-64,Graduate,36285,6091,42376
29140,10,State - BIHAR,Urban,65-69,Graduate,22681,3091,25772
29141,10,State - BIHAR,Urban,70-74,Graduate,14716,1496,16212
29142,10,State - BIHAR,Urban,75-79,Graduate,6686,706,7392
29143,10,State - BIHAR,Urban,80+,Graduate,5808,1195,7003
29144,10,State - BIHAR,Urban,Age not stated,Graduate,4330,2143,6473
29145,11,State - SIKKIM,Total,All ages,Graduate,19290,13379,32669
29146,11,State - SIKKIM,Total,0-6,Graduate,0,0,0
29147,11,State - SIKKIM,Total,7,Graduate,0,0,0
29148,11,State - SIKKIM,Total,8,Graduate,0,0,0
29149,11,State - SIKKIM,Total,9,Graduate,0,0,0
29150,11,State - SIKKIM,Total,10,Graduate,0,0,0
29151,11,State - SIKKIM,Total,11,Graduate,0,0,0
29152,11,State - SIKKIM,Total,12,Graduate,0,0,0
29153,11,State - SIKKIM,Total,13,Graduate,0,0,0
29154,11,State - SIKKIM,Total,14,Graduate,0,0,0
29155,11,State - SIKKIM,Total,15,Graduate,0,0,0
29156,11,State - SIKKIM,Total,16,Graduate,0,0,0
29157,11,State - SIKKIM,Total,17,Graduate,0,0,0
29158,11,State - SIKKIM,Total,18,Graduate,0,0,0
29159,11,State - SIKKIM,Total,19,Graduate,0,0,0
29160,11,State - SIKKIM,Total,20-24,Graduate,2842,3026,5868
29161,11,State - SIKKIM,Total,25-29,Graduate,4992,4553,9545
29162,11,State - SIKKIM,Total,30-34,Graduate,3304,2439,5743
29163,11,State - SIKKIM,Total,35-39,Graduate,2412,1270,3682
29164,11,State - SIKKIM,Total,40-44,Graduate,1988,786,2774
29165,11,State - SIKKIM,Total,45-49,Graduate,1356,550,1906
29166,11,State - SIKKIM,Total,50-54,Graduate,1027,341,1368
29167,11,State - SIKKIM,Total,55-59,Graduate,692,198,890
29168,11,State - SIKKIM,Total,60-64,Graduate,298,93,391
29169,11,State - SIKKIM,Total,65-69,Graduate,160,38,198
29170,11,State - SIKKIM,Total,70-74,Graduate,75,23,98
29171,11,State - SIKKIM,Total,75-79,Graduate,40,15,55
29172,11,State - SIKKIM,Total,80+,Graduate,79,30,109
29173,11,State - SIKKIM,Total,Age not stated,Graduate,25,17,42
29174,11,State - SIKKIM,Rural,All ages,Graduate,8888,5657,14545
29175,11,State - SIKKIM,Rural,0-6,Graduate,0,0,0
29176,11,State - SIKKIM,Rural,7,Graduate,0,0,0
29177,11,State - SIKKIM,Rural,8,Graduate,0,0,0
29178,11,State - SIKKIM,Rural,9,Graduate,0,0,0
29179,11,State - SIKKIM,Rural,10,Graduate,0,0,0
29180,11,State - SIKKIM,Rural,11,Graduate,0,0,0
29181,11,State - SIKKIM,Rural,12,Graduate,0,0,0
29182,11,State - SIKKIM,Rural,13,Graduate,0,0,0
29183,11,State - SIKKIM,Rural,14,Graduate,0,0,0
29184,11,State - SIKKIM,Rural,15,Graduate,0,0,0
29185,11,State - SIKKIM,Rural,16,Graduate,0,0,0
29186,11,State - SIKKIM,Rural,17,Graduate,0,0,0
29187,11,State - SIKKIM,Rural,18,Graduate,0,0,0
29188,11,State - SIKKIM,Rural,19,Graduate,0,0,0
29189,11,State - SIKKIM,Rural,20-24,Graduate,1530,1555,3085
29190,11,State - SIKKIM,Rural,25-29,Graduate,2695,2192,4887
29191,11,State - SIKKIM,Rural,30-34,Graduate,1617,1000,2617
29192,11,State - SIKKIM,Rural,35-39,Graduate,1043,427,1470
29193,11,State - SIKKIM,Rural,40-44,Graduate,816,204,1020
29194,11,State - SIKKIM,Rural,45-49,Graduate,485,133,618
29195,11,State - SIKKIM,Rural,50-54,Graduate,313,51,364
29196,11,State - SIKKIM,Rural,55-59,Graduate,192,41,233
29197,11,State - SIKKIM,Rural,60-64,Graduate,76,12,88
29198,11,State - SIKKIM,Rural,65-69,Graduate,35,10,45
29199,11,State - SIKKIM,Rural,70-74,Graduate,25,9,34
29200,11,State - SIKKIM,Rural,75-79,Graduate,7,5,12
29201,11,State - SIKKIM,Rural,80+,Graduate,38,10,48
29202,11,State - SIKKIM,Rural,Age not stated,Graduate,16,8,24
29203,11,State - SIKKIM,Urban,All ages,Graduate,10402,7722,18124
29204,11,State - SIKKIM,Urban,0-6,Graduate,0,0,0
29205,11,State - SIKKIM,Urban,7,Graduate,0,0,0
29206,11,State - SIKKIM,Urban,8,Graduate,0,0,0
29207,11,State - SIKKIM,Urban,9,Graduate,0,0,0
29208,11,State - SIKKIM,Urban,10,Graduate,0,0,0
29209,11,State - SIKKIM,Urban,11,Graduate,0,0,0
29210,11,State - SIKKIM,Urban,12,Graduate,0,0,0
29211,11,State - SIKKIM,Urban,13,Graduate,0,0,0
29212,11,State - SIKKIM,Urban,14,Graduate,0,0,0
29213,11,State - SIKKIM,Urban,15,Graduate,0,0,0
29214,11,State - SIKKIM,Urban,16,Graduate,0,0,0
29215,11,State - SIKKIM,Urban,17,Graduate,0,0,0
29216,11,State - SIKKIM,Urban,18,Graduate,0,0,0
29217,11,State - SIKKIM,Urban,19,Graduate,0,0,0
29218,11,State - SIKKIM,Urban,20-24,Graduate,1312,1471,2783
29219,11,State - SIKKIM,Urban,25-29,Graduate,2297,2361,4658
29220,11,State - SIKKIM,Urban,30-34,Graduate,1687,1439,3126
29221,11,State - SIKKIM,Urban,35-39,Graduate,1369,843,2212
29222,11,State - SIKKIM,Urban,40-44,Graduate,1172,582,1754
29223,11,State - SIKKIM,Urban,45-49,Graduate,871,417,1288
29224,11,State - SIKKIM,Urban,50-54,Graduate,714,290,1004
29225,11,State - SIKKIM,Urban,55-59,Graduate,500,157,657
29226,11,State - SIKKIM,Urban,60-64,Graduate,222,81,303
29227,11,State - SIKKIM,Urban,65-69,Graduate,125,28,153
29228,11,State - SIKKIM,Urban,70-74,Graduate,50,14,64
29229,11,State - SIKKIM,Urban,75-79,Graduate,33,10,43
29230,11,State - SIKKIM,Urban,80+,Graduate,41,20,61
29231,11,State - SIKKIM,Urban,Age not stated,Graduate,9,9,18
29232,12,State - ARUNACHAL PRADESH,Total,All ages,Graduate,36430,17176,53606
29233,12,State - ARUNACHAL PRADESH,Total,0-6,Graduate,0,0,0
29234,12,State - ARUNACHAL PRADESH,Total,7,Graduate,0,0,0
29235,12,State - ARUNACHAL PRADESH,Total,8,Graduate,0,0,0
29236,12,State - ARUNACHAL PRADESH,Total,9,Graduate,0,0,0
29237,12,State - ARUNACHAL PRADESH,Total,10,Graduate,0,0,0
29238,12,State - ARUNACHAL PRADESH,Total,11,Graduate,0,0,0
29239,12,State - ARUNACHAL PRADESH,Total,12,Graduate,0,0,0
29240,12,State - ARUNACHAL PRADESH,Total,13,Graduate,0,0,0
29241,12,State - ARUNACHAL PRADESH,Total,14,Graduate,0,0,0
29242,12,State - ARUNACHAL PRADESH,Total,15,Graduate,0,0,0
29243,12,State - ARUNACHAL PRADESH,Total,16,Graduate,0,0,0
29244,12,State - ARUNACHAL PRADESH,Total,17,Graduate,0,0,0
29245,12,State - ARUNACHAL PRADESH,Total,18,Graduate,0,0,0
29246,12,State - ARUNACHAL PRADESH,Total,19,Graduate,0,0,0
29247,12,State - ARUNACHAL PRADESH,Total,20-24,Graduate,5076,4550,9626
29248,12,State - ARUNACHAL PRADESH,Total,25-29,Graduate,8204,5319,13523
29249,12,State - ARUNACHAL PRADESH,Total,30-34,Graduate,6375,2831,9206
29250,12,State - ARUNACHAL PRADESH,Total,35-39,Graduate,5015,1752,6767
29251,12,State - ARUNACHAL PRADESH,Total,40-44,Graduate,4019,1207,5226
29252,12,State - ARUNACHAL PRADESH,Total,45-49,Graduate,3450,800,4250
29253,12,State - ARUNACHAL PRADESH,Total,50-54,Graduate,2298,435,2733
29254,12,State - ARUNACHAL PRADESH,Total,55-59,Graduate,1283,163,1446
29255,12,State - ARUNACHAL PRADESH,Total,60-64,Graduate,335,39,374
29256,12,State - ARUNACHAL PRADESH,Total,65-69,Graduate,134,15,149
29257,12,State - ARUNACHAL PRADESH,Total,70-74,Graduate,66,8,74
29258,12,State - ARUNACHAL PRADESH,Total,75-79,Graduate,24,5,29
29259,12,State - ARUNACHAL PRADESH,Total,80+,Graduate,90,29,119
29260,12,State - ARUNACHAL PRADESH,Total,Age not stated,Graduate,61,23,84
29261,12,State - ARUNACHAL PRADESH,Rural,All ages,Graduate,19476,8192,27668
29262,12,State - ARUNACHAL PRADESH,Rural,0-6,Graduate,0,0,0
29263,12,State - ARUNACHAL PRADESH,Rural,7,Graduate,0,0,0
29264,12,State - ARUNACHAL PRADESH,Rural,8,Graduate,0,0,0
29265,12,State - ARUNACHAL PRADESH,Rural,9,Graduate,0,0,0
29266,12,State - ARUNACHAL PRADESH,Rural,10,Graduate,0,0,0
29267,12,State - ARUNACHAL PRADESH,Rural,11,Graduate,0,0,0
29268,12,State - ARUNACHAL PRADESH,Rural,12,Graduate,0,0,0
29269,12,State - ARUNACHAL PRADESH,Rural,13,Graduate,0,0,0
29270,12,State - ARUNACHAL PRADESH,Rural,14,Graduate,0,0,0
29271,12,State - ARUNACHAL PRADESH,Rural,15,Graduate,0,0,0
29272,12,State - ARUNACHAL PRADESH,Rural,16,Graduate,0,0,0
29273,12,State - ARUNACHAL PRADESH,Rural,17,Graduate,0,0,0
29274,12,State - ARUNACHAL PRADESH,Rural,18,Graduate,0,0,0
29275,12,State - ARUNACHAL PRADESH,Rural,19,Graduate,0,0,0
29276,12,State - ARUNACHAL PRADESH,Rural,20-24,Graduate,2937,2373,5310
29277,12,State - ARUNACHAL PRADESH,Rural,25-29,Graduate,4835,2754,7589
29278,12,State - ARUNACHAL PRADESH,Rural,30-34,Graduate,3549,1356,4905
29279,12,State - ARUNACHAL PRADESH,Rural,35-39,Graduate,2610,720,3330
29280,12,State - ARUNACHAL PRADESH,Rural,40-44,Graduate,1969,441,2410
29281,12,State - ARUNACHAL PRADESH,Rural,45-49,Graduate,1575,278,1853
29282,12,State - ARUNACHAL PRADESH,Rural,50-54,Graduate,1071,155,1226
29283,12,State - ARUNACHAL PRADESH,Rural,55-59,Graduate,584,60,644
29284,12,State - ARUNACHAL PRADESH,Rural,60-64,Graduate,155,20,175
29285,12,State - ARUNACHAL PRADESH,Rural,65-69,Graduate,63,7,70
29286,12,State - ARUNACHAL PRADESH,Rural,70-74,Graduate,35,3,38
29287,12,State - ARUNACHAL PRADESH,Rural,75-79,Graduate,12,0,12
29288,12,State - ARUNACHAL PRADESH,Rural,80+,Graduate,45,11,56
29289,12,State - ARUNACHAL PRADESH,Rural,Age not stated,Graduate,36,14,50
29290,12,State - ARUNACHAL PRADESH,Urban,All ages,Graduate,16954,8984,25938
29291,12,State - ARUNACHAL PRADESH,Urban,0-6,Graduate,0,0,0
29292,12,State - ARUNACHAL PRADESH,Urban,7,Graduate,0,0,0
29293,12,State - ARUNACHAL PRADESH,Urban,8,Graduate,0,0,0
29294,12,State - ARUNACHAL PRADESH,Urban,9,Graduate,0,0,0
29295,12,State - ARUNACHAL PRADESH,Urban,10,Graduate,0,0,0
29296,12,State - ARUNACHAL PRADESH,Urban,11,Graduate,0,0,0
29297,12,State - ARUNACHAL PRADESH,Urban,12,Graduate,0,0,0
29298,12,State - ARUNACHAL PRADESH,Urban,13,Graduate,0,0,0
29299,12,State - ARUNACHAL PRADESH,Urban,14,Graduate,0,0,0
29300,12,State - ARUNACHAL PRADESH,Urban,15,Graduate,0,0,0
29301,12,State - ARUNACHAL PRADESH,Urban,16,Graduate,0,0,0
29302,12,State - ARUNACHAL PRADESH,Urban,17,Graduate,0,0,0
29303,12,State - ARUNACHAL PRADESH,Urban,18,Graduate,0,0,0
29304,12,State - ARUNACHAL PRADESH,Urban,19,Graduate,0,0,0
29305,12,State - ARUNACHAL PRADESH,Urban,20-24,Graduate,2139,2177,4316
29306,12,State - ARUNACHAL PRADESH,Urban,25-29,Graduate,3369,2565,5934
29307,12,State - ARUNACHAL PRADESH,Urban,30-34,Graduate,2826,1475,4301
29308,12,State - ARUNACHAL PRADESH,Urban,35-39,Graduate,2405,1032,3437
29309,12,State - ARUNACHAL PRADESH,Urban,40-44,Graduate,2050,766,2816
29310,12,State - ARUNACHAL PRADESH,Urban,45-49,Graduate,1875,522,2397
29311,12,State - ARUNACHAL PRADESH,Urban,50-54,Graduate,1227,280,1507
29312,12,State - ARUNACHAL PRADESH,Urban,55-59,Graduate,699,103,802
29313,12,State - ARUNACHAL PRADESH,Urban,60-64,Graduate,180,19,199
29314,12,State - ARUNACHAL PRADESH,Urban,65-69,Graduate,71,8,79
29315,12,State - ARUNACHAL PRADESH,Urban,70-74,Graduate,31,5,36
29316,12,State - ARUNACHAL PRADESH,Urban,75-79,Graduate,12,5,17
29317,12,State - ARUNACHAL PRADESH,Urban,80+,Graduate,45,18,63
29318,12,State - ARUNACHAL PRADESH,Urban,Age not stated,Graduate,25,9,34
29319,13,State - NAGALAND,Total,All ages,Graduate,53023,36695,89718
29320,13,State - NAGALAND,Total,0-6,Graduate,0,0,0
29321,13,State - NAGALAND,Total,7,Graduate,0,0,0
29322,13,State - NAGALAND,Total,8,Graduate,0,0,0
29323,13,State - NAGALAND,Total,9,Graduate,0,0,0
29324,13,State - NAGALAND,Total,10,Graduate,0,0,0
29325,13,State - NAGALAND,Total,11,Graduate,0,0,0
29326,13,State - NAGALAND,Total,12,Graduate,0,0,0
29327,13,State - NAGALAND,Total,13,Graduate,0,0,0
29328,13,State - NAGALAND,Total,14,Graduate,0,0,0
29329,13,State - NAGALAND,Total,15,Graduate,0,0,0
29330,13,State - NAGALAND,Total,16,Graduate,0,0,0
29331,13,State - NAGALAND,Total,17,Graduate,0,0,0
29332,13,State - NAGALAND,Total,18,Graduate,0,0,0
29333,13,State - NAGALAND,Total,19,Graduate,0,0,0
29334,13,State - NAGALAND,Total,20-24,Graduate,8251,8722,16973
29335,13,State - NAGALAND,Total,25-29,Graduate,12928,11483,24411
29336,13,State - NAGALAND,Total,30-34,Graduate,10041,7393,17434
29337,13,State - NAGALAND,Total,35-39,Graduate,7000,4340,11340
29338,13,State - NAGALAND,Total,40-44,Graduate,4916,2156,7072
29339,13,State - NAGALAND,Total,45-49,Graduate,3716,1237,4953
29340,13,State - NAGALAND,Total,50-54,Graduate,2542,644,3186
29341,13,State - NAGALAND,Total,55-59,Graduate,1552,358,1910
29342,13,State - NAGALAND,Total,60-64,Graduate,894,142,1036
29343,13,State - NAGALAND,Total,65-69,Graduate,501,71,572
29344,13,State - NAGALAND,Total,70-74,Graduate,287,44,331
29345,13,State - NAGALAND,Total,75-79,Graduate,178,32,210
29346,13,State - NAGALAND,Total,80+,Graduate,182,64,246
29347,13,State - NAGALAND,Total,Age not stated,Graduate,35,9,44
29348,13,State - NAGALAND,Rural,All ages,Graduate,24521,15462,39983
29349,13,State - NAGALAND,Rural,0-6,Graduate,0,0,0
29350,13,State - NAGALAND,Rural,7,Graduate,0,0,0
29351,13,State - NAGALAND,Rural,8,Graduate,0,0,0
29352,13,State - NAGALAND,Rural,9,Graduate,0,0,0
29353,13,State - NAGALAND,Rural,10,Graduate,0,0,0
29354,13,State - NAGALAND,Rural,11,Graduate,0,0,0
29355,13,State - NAGALAND,Rural,12,Graduate,0,0,0
29356,13,State - NAGALAND,Rural,13,Graduate,0,0,0
29357,13,State - NAGALAND,Rural,14,Graduate,0,0,0
29358,13,State - NAGALAND,Rural,15,Graduate,0,0,0
29359,13,State - NAGALAND,Rural,16,Graduate,0,0,0
29360,13,State - NAGALAND,Rural,17,Graduate,0,0,0
29361,13,State - NAGALAND,Rural,18,Graduate,0,0,0
29362,13,State - NAGALAND,Rural,19,Graduate,0,0,0
29363,13,State - NAGALAND,Rural,20-24,Graduate,4158,3995,8153
29364,13,State - NAGALAND,Rural,25-29,Graduate,6298,4981,11279
29365,13,State - NAGALAND,Rural,30-34,Graduate,4702,3105,7807
29366,13,State - NAGALAND,Rural,35-39,Graduate,3134,1688,4822
29367,13,State - NAGALAND,Rural,40-44,Graduate,2118,821,2939
29368,13,State - NAGALAND,Rural,45-49,Graduate,1594,423,2017
29369,13,State - NAGALAND,Rural,50-54,Graduate,1024,195,1219
29370,13,State - NAGALAND,Rural,55-59,Graduate,630,117,747
29371,13,State - NAGALAND,Rural,60-64,Graduate,352,51,403
29372,13,State - NAGALAND,Rural,65-69,Graduate,208,25,233
29373,13,State - NAGALAND,Rural,70-74,Graduate,124,18,142
29374,13,State - NAGALAND,Rural,75-79,Graduate,70,14,84
29375,13,State - NAGALAND,Rural,80+,Graduate,77,23,100
29376,13,State - NAGALAND,Rural,Age not stated,Graduate,32,6,38
29377,13,State - NAGALAND,Urban,All ages,Graduate,28502,21233,49735
29378,13,State - NAGALAND,Urban,0-6,Graduate,0,0,0
29379,13,State - NAGALAND,Urban,7,Graduate,0,0,0
29380,13,State - NAGALAND,Urban,8,Graduate,0,0,0
29381,13,State - NAGALAND,Urban,9,Graduate,0,0,0
29382,13,State - NAGALAND,Urban,10,Graduate,0,0,0
29383,13,State - NAGALAND,Urban,11,Graduate,0,0,0
29384,13,State - NAGALAND,Urban,12,Graduate,0,0,0
29385,13,State - NAGALAND,Urban,13,Graduate,0,0,0
29386,13,State - NAGALAND,Urban,14,Graduate,0,0,0
29387,13,State - NAGALAND,Urban,15,Graduate,0,0,0
29388,13,State - NAGALAND,Urban,16,Graduate,0,0,0
29389,13,State - NAGALAND,Urban,17,Graduate,0,0,0
29390,13,State - NAGALAND,Urban,18,Graduate,0,0,0
29391,13,State - NAGALAND,Urban,19,Graduate,0,0,0
29392,13,State - NAGALAND,Urban,20-24,Graduate,4093,4727,8820
29393,13,State - NAGALAND,Urban,25-29,Graduate,6630,6502,13132
29394,13,State - NAGALAND,Urban,30-34,Graduate,5339,4288,9627
29395,13,State - NAGALAND,Urban,35-39,Graduate,3866,2652,6518
29396,13,State - NAGALAND,Urban,40-44,Graduate,2798,1335,4133
29397,13,State - NAGALAND,Urban,45-49,Graduate,2122,814,2936
29398,13,State - NAGALAND,Urban,50-54,Graduate,1518,449,1967
29399,13,State - NAGALAND,Urban,55-59,Graduate,922,241,1163
29400,13,State - NAGALAND,Urban,60-64,Graduate,542,91,633
29401,13,State - NAGALAND,Urban,65-69,Graduate,293,46,339
29402,13,State - NAGALAND,Urban,70-74,Graduate,163,26,189
29403,13,State - NAGALAND,Urban,75-79,Graduate,108,18,126
29404,13,State - NAGALAND,Urban,80+,Graduate,105,41,146
29405,13,State - NAGALAND,Urban,Age not stated,Graduate,3,3,6
29406,14,State - MANIPUR,Total,All ages,Graduate,135082,90538,225620
29407,14,State - MANIPUR,Total,0-6,Graduate,0,0,0
29408,14,State - MANIPUR,Total,7,Graduate,0,0,0
29409,14,State - MANIPUR,Total,8,Graduate,0,0,0
29410,14,State - MANIPUR,Total,9,Graduate,0,0,0
29411,14,State - MANIPUR,Total,10,Graduate,0,0,0
29412,14,State - MANIPUR,Total,11,Graduate,0,0,0
29413,14,State - MANIPUR,Total,12,Graduate,0,0,0
29414,14,State - MANIPUR,Total,13,Graduate,0,0,0
29415,14,State - MANIPUR,Total,14,Graduate,0,0,0
29416,14,State - MANIPUR,Total,15,Graduate,0,0,0
29417,14,State - MANIPUR,Total,16,Graduate,0,0,0
29418,14,State - MANIPUR,Total,17,Graduate,0,0,0
29419,14,State - MANIPUR,Total,18,Graduate,0,0,0
29420,14,State - MANIPUR,Total,19,Graduate,0,0,0
29421,14,State - MANIPUR,Total,20-24,Graduate,14744,12346,27090
29422,14,State - MANIPUR,Total,25-29,Graduate,21851,17809,39660
29423,14,State - MANIPUR,Total,30-34,Graduate,20949,16446,37395
29424,14,State - MANIPUR,Total,35-39,Graduate,19462,14367,33829
29425,14,State - MANIPUR,Total,40-44,Graduate,16433,10944,27377
29426,14,State - MANIPUR,Total,45-49,Graduate,13844,7899,21743
29427,14,State - MANIPUR,Total,50-54,Graduate,10393,5366,15759
29428,14,State - MANIPUR,Total,55-59,Graduate,7016,2884,9900
29429,14,State - MANIPUR,Total,60-64,Graduate,4821,1385,6206
29430,14,State - MANIPUR,Total,65-69,Graduate,2499,457,2956
29431,14,State - MANIPUR,Total,70-74,Graduate,1434,183,1617
29432,14,State - MANIPUR,Total,75-79,Graduate,693,88,781
29433,14,State - MANIPUR,Total,80+,Graduate,604,171,775
29434,14,State - MANIPUR,Total,Age not stated,Graduate,339,193,532
29435,14,State - MANIPUR,Rural,All ages,Graduate,66363,37239,103602
29436,14,State - MANIPUR,Rural,0-6,Graduate,0,0,0
29437,14,State - MANIPUR,Rural,7,Graduate,0,0,0
29438,14,State - MANIPUR,Rural,8,Graduate,0,0,0
29439,14,State - MANIPUR,Rural,9,Graduate,0,0,0
29440,14,State - MANIPUR,Rural,10,Graduate,0,0,0
29441,14,State - MANIPUR,Rural,11,Graduate,0,0,0
29442,14,State - MANIPUR,Rural,12,Graduate,0,0,0
29443,14,State - MANIPUR,Rural,13,Graduate,0,0,0
29444,14,State - MANIPUR,Rural,14,Graduate,0,0,0
29445,14,State - MANIPUR,Rural,15,Graduate,0,0,0
29446,14,State - MANIPUR,Rural,16,Graduate,0,0,0
29447,14,State - MANIPUR,Rural,17,Graduate,0,0,0
29448,14,State - MANIPUR,Rural,18,Graduate,0,0,0
29449,14,State - MANIPUR,Rural,19,Graduate,0,0,0
29450,14,State - MANIPUR,Rural,20-24,Graduate,8844,6417,15261
29451,14,State - MANIPUR,Rural,25-29,Graduate,12053,8388,20441
29452,14,State - MANIPUR,Rural,30-34,Graduate,10760,7196,17956
29453,14,State - MANIPUR,Rural,35-39,Graduate,9495,5781,15276
29454,14,State - MANIPUR,Rural,40-44,Graduate,7846,4037,11883
29455,14,State - MANIPUR,Rural,45-49,Graduate,6302,2539,8841
29456,14,State - MANIPUR,Rural,50-54,Graduate,4374,1479,5853
29457,14,State - MANIPUR,Rural,55-59,Graduate,2851,737,3588
29458,14,State - MANIPUR,Rural,60-64,Graduate,1775,345,2120
29459,14,State - MANIPUR,Rural,65-69,Graduate,964,104,1068
29460,14,State - MANIPUR,Rural,70-74,Graduate,501,46,547
29461,14,State - MANIPUR,Rural,75-79,Graduate,229,24,253
29462,14,State - MANIPUR,Rural,80+,Graduate,197,65,262
29463,14,State - MANIPUR,Rural,Age not stated,Graduate,172,81,253
29464,14,State - MANIPUR,Urban,All ages,Graduate,68719,53299,122018
29465,14,State - MANIPUR,Urban,0-6,Graduate,0,0,0
29466,14,State - MANIPUR,Urban,7,Graduate,0,0,0
29467,14,State - MANIPUR,Urban,8,Graduate,0,0,0
29468,14,State - MANIPUR,Urban,9,Graduate,0,0,0
29469,14,State - MANIPUR,Urban,10,Graduate,0,0,0
29470,14,State - MANIPUR,Urban,11,Graduate,0,0,0
29471,14,State - MANIPUR,Urban,12,Graduate,0,0,0
29472,14,State - MANIPUR,Urban,13,Graduate,0,0,0
29473,14,State - MANIPUR,Urban,14,Graduate,0,0,0
29474,14,State - MANIPUR,Urban,15,Graduate,0,0,0
29475,14,State - MANIPUR,Urban,16,Graduate,0,0,0
29476,14,State - MANIPUR,Urban,17,Graduate,0,0,0
29477,14,State - MANIPUR,Urban,18,Graduate,0,0,0
29478,14,State - MANIPUR,Urban,19,Graduate,0,0,0
29479,14,State - MANIPUR,Urban,20-24,Graduate,5900,5929,11829
29480,14,State - MANIPUR,Urban,25-29,Graduate,9798,9421,19219
29481,14,State - MANIPUR,Urban,30-34,Graduate,10189,9250,19439
29482,14,State - MANIPUR,Urban,35-39,Graduate,9967,8586,18553
29483,14,State - MANIPUR,Urban,40-44,Graduate,8587,6907,15494
29484,14,State - MANIPUR,Urban,45-49,Graduate,7542,5360,12902
29485,14,State - MANIPUR,Urban,50-54,Graduate,6019,3887,9906
29486,14,State - MANIPUR,Urban,55-59,Graduate,4165,2147,6312
29487,14,State - MANIPUR,Urban,60-64,Graduate,3046,1040,4086
29488,14,State - MANIPUR,Urban,65-69,Graduate,1535,353,1888
29489,14,State - MANIPUR,Urban,70-74,Graduate,933,137,1070
29490,14,State - MANIPUR,Urban,75-79,Graduate,464,64,528
29491,14,State - MANIPUR,Urban,80+,Graduate,407,106,513
29492,14,State - MANIPUR,Urban,Age not stated,Graduate,167,112,279
29493,15,State - MIZORAM,Total,All ages,Graduate,29527,20094,49621
29494,15,State - MIZORAM,Total,0-6,Graduate,0,0,0
29495,15,State - MIZORAM,Total,7,Graduate,0,0,0
29496,15,State - MIZORAM,Total,8,Graduate,0,0,0
29497,15,State - MIZORAM,Total,9,Graduate,0,0,0
29498,15,State - MIZORAM,Total,10,Graduate,0,0,0
29499,15,State - MIZORAM,Total,11,Graduate,0,0,0
29500,15,State - MIZORAM,Total,12,Graduate,0,0,0
29501,15,State - MIZORAM,Total,13,Graduate,0,0,0
29502,15,State - MIZORAM,Total,14,Graduate,0,0,0
29503,15,State - MIZORAM,Total,15,Graduate,0,0,0
29504,15,State - MIZORAM,Total,16,Graduate,0,0,0
29505,15,State - MIZORAM,Total,17,Graduate,0,0,0
29506,15,State - MIZORAM,Total,18,Graduate,0,0,0
29507,15,State - MIZORAM,Total,19,Graduate,0,0,0
29508,15,State - MIZORAM,Total,20-24,Graduate,3226,3444,6670
29509,15,State - MIZORAM,Total,25-29,Graduate,5455,5212,10667
29510,15,State - MIZORAM,Total,30-34,Graduate,5574,4547,10121
29511,15,State - MIZORAM,Total,35-39,Graduate,4655,3082,7737
29512,15,State - MIZORAM,Total,40-44,Graduate,3341,1650,4991
29513,15,State - MIZORAM,Total,45-49,Graduate,2626,1064,3690
29514,15,State - MIZORAM,Total,50-54,Graduate,1742,574,2316
29515,15,State - MIZORAM,Total,55-59,Graduate,1090,246,1336
29516,15,State - MIZORAM,Total,60-64,Graduate,734,126,860
29517,15,State - MIZORAM,Total,65-69,Graduate,471,74,545
29518,15,State - MIZORAM,Total,70-74,Graduate,346,33,379
29519,15,State - MIZORAM,Total,75-79,Graduate,154,15,169
29520,15,State - MIZORAM,Total,80+,Graduate,92,18,110
29521,15,State - MIZORAM,Total,Age not stated,Graduate,21,9,30
29522,15,State - MIZORAM,Rural,All ages,Graduate,6149,2740,8889
29523,15,State - MIZORAM,Rural,0-6,Graduate,0,0,0
29524,15,State - MIZORAM,Rural,7,Graduate,0,0,0
29525,15,State - MIZORAM,Rural,8,Graduate,0,0,0
29526,15,State - MIZORAM,Rural,9,Graduate,0,0,0
29527,15,State - MIZORAM,Rural,10,Graduate,0,0,0
29528,15,State - MIZORAM,Rural,11,Graduate,0,0,0
29529,15,State - MIZORAM,Rural,12,Graduate,0,0,0
29530,15,State - MIZORAM,Rural,13,Graduate,0,0,0
29531,15,State - MIZORAM,Rural,14,Graduate,0,0,0
29532,15,State - MIZORAM,Rural,15,Graduate,0,0,0
29533,15,State - MIZORAM,Rural,16,Graduate,0,0,0
29534,15,State - MIZORAM,Rural,17,Graduate,0,0,0
29535,15,State - MIZORAM,Rural,18,Graduate,0,0,0
29536,15,State - MIZORAM,Rural,19,Graduate,0,0,0
29537,15,State - MIZORAM,Rural,20-24,Graduate,710,563,1273
29538,15,State - MIZORAM,Rural,25-29,Graduate,1224,846,2070
29539,15,State - MIZORAM,Rural,30-34,Graduate,1290,637,1927
29540,15,State - MIZORAM,Rural,35-39,Graduate,1055,390,1445
29541,15,State - MIZORAM,Rural,40-44,Graduate,721,167,888
29542,15,State - MIZORAM,Rural,45-49,Graduate,487,73,560
29543,15,State - MIZORAM,Rural,50-54,Graduate,306,39,345
29544,15,State - MIZORAM,Rural,55-59,Graduate,152,14,166
29545,15,State - MIZORAM,Rural,60-64,Graduate,94,5,99
29546,15,State - MIZORAM,Rural,65-69,Graduate,53,1,54
29547,15,State - MIZORAM,Rural,70-74,Graduate,34,1,35
29548,15,State - MIZORAM,Rural,75-79,Graduate,11,2,13
29549,15,State - MIZORAM,Rural,80+,Graduate,7,1,8
29550,15,State - MIZORAM,Rural,Age not stated,Graduate,5,1,6
29551,15,State - MIZORAM,Urban,All ages,Graduate,23378,17354,40732
29552,15,State - MIZORAM,Urban,0-6,Graduate,0,0,0
29553,15,State - MIZORAM,Urban,7,Graduate,0,0,0
29554,15,State - MIZORAM,Urban,8,Graduate,0,0,0
29555,15,State - MIZORAM,Urban,9,Graduate,0,0,0
29556,15,State - MIZORAM,Urban,10,Graduate,0,0,0
29557,15,State - MIZORAM,Urban,11,Graduate,0,0,0
29558,15,State - MIZORAM,Urban,12,Graduate,0,0,0
29559,15,State - MIZORAM,Urban,13,Graduate,0,0,0
29560,15,State - MIZORAM,Urban,14,Graduate,0,0,0
29561,15,State - MIZORAM,Urban,15,Graduate,0,0,0
29562,15,State - MIZORAM,Urban,16,Graduate,0,0,0
29563,15,State - MIZORAM,Urban,17,Graduate,0,0,0
29564,15,State - MIZORAM,Urban,18,Graduate,0,0,0
29565,15,State - MIZORAM,Urban,19,Graduate,0,0,0
29566,15,State - MIZORAM,Urban,20-24,Graduate,2516,2881,5397
29567,15,State - MIZORAM,Urban,25-29,Graduate,4231,4366,8597
29568,15,State - MIZORAM,Urban,30-34,Graduate,4284,3910,8194
29569,15,State - MIZORAM,Urban,35-39,Graduate,3600,2692,6292
29570,15,State - MIZORAM,Urban,40-44,Graduate,2620,1483,4103
29571,15,State - MIZORAM,Urban,45-49,Graduate,2139,991,3130
29572,15,State - MIZORAM,Urban,50-54,Graduate,1436,535,1971
29573,15,State - MIZORAM,Urban,55-59,Graduate,938,232,1170
29574,15,State - MIZORAM,Urban,60-64,Graduate,640,121,761
29575,15,State - MIZORAM,Urban,65-69,Graduate,418,73,491
29576,15,State - MIZORAM,Urban,70-74,Graduate,312,32,344
29577,15,State - MIZORAM,Urban,75-79,Graduate,143,13,156
29578,15,State - MIZORAM,Urban,80+,Graduate,85,17,102
29579,15,State - MIZORAM,Urban,Age not stated,Graduate,16,8,24
29580,16,State - TRIPURA,Total,All ages,Graduate,88621,49191,137812
29581,16,State - TRIPURA,Total,0-6,Graduate,0,0,0
29582,16,State - TRIPURA,Total,7,Graduate,0,0,0
29583,16,State - TRIPURA,Total,8,Graduate,0,0,0
29584,16,State - TRIPURA,Total,9,Graduate,0,0,0
29585,16,State - TRIPURA,Total,10,Graduate,0,0,0
29586,16,State - TRIPURA,Total,11,Graduate,0,0,0
29587,16,State - TRIPURA,Total,12,Graduate,0,0,0
29588,16,State - TRIPURA,Total,13,Graduate,0,0,0
29589,16,State - TRIPURA,Total,14,Graduate,0,0,0
29590,16,State - TRIPURA,Total,15,Graduate,0,0,0
29591,16,State - TRIPURA,Total,16,Graduate,0,0,0
29592,16,State - TRIPURA,Total,17,Graduate,0,0,0
29593,16,State - TRIPURA,Total,18,Graduate,0,0,0
29594,16,State - TRIPURA,Total,19,Graduate,0,0,0
29595,16,State - TRIPURA,Total,20-24,Graduate,9507,7971,17478
29596,16,State - TRIPURA,Total,25-29,Graduate,13555,9889,23444
29597,16,State - TRIPURA,Total,30-34,Graduate,11744,7492,19236
29598,16,State - TRIPURA,Total,35-39,Graduate,12310,6829,19139
29599,16,State - TRIPURA,Total,40-44,Graduate,11494,5660,17154
29600,16,State - TRIPURA,Total,45-49,Graduate,10118,4424,14542
29601,16,State - TRIPURA,Total,50-54,Graduate,6921,3003,9924
29602,16,State - TRIPURA,Total,55-59,Graduate,5336,1982,7318
29603,16,State - TRIPURA,Total,60-64,Graduate,3904,1148,5052
29604,16,State - TRIPURA,Total,65-69,Graduate,1850,459,2309
29605,16,State - TRIPURA,Total,70-74,Graduate,1022,172,1194
29606,16,State - TRIPURA,Total,75-79,Graduate,493,65,558
29607,16,State - TRIPURA,Total,80+,Graduate,327,80,407
29608,16,State - TRIPURA,Total,Age not stated,Graduate,40,17,57
29609,16,State - TRIPURA,Rural,All ages,Graduate,34869,13184,48053
29610,16,State - TRIPURA,Rural,0-6,Graduate,0,0,0
29611,16,State - TRIPURA,Rural,7,Graduate,0,0,0
29612,16,State - TRIPURA,Rural,8,Graduate,0,0,0
29613,16,State - TRIPURA,Rural,9,Graduate,0,0,0
29614,16,State - TRIPURA,Rural,10,Graduate,0,0,0
29615,16,State - TRIPURA,Rural,11,Graduate,0,0,0
29616,16,State - TRIPURA,Rural,12,Graduate,0,0,0
29617,16,State - TRIPURA,Rural,13,Graduate,0,0,0
29618,16,State - TRIPURA,Rural,14,Graduate,0,0,0
29619,16,State - TRIPURA,Rural,15,Graduate,0,0,0
29620,16,State - TRIPURA,Rural,16,Graduate,0,0,0
29621,16,State - TRIPURA,Rural,17,Graduate,0,0,0
29622,16,State - TRIPURA,Rural,18,Graduate,0,0,0
29623,16,State - TRIPURA,Rural,19,Graduate,0,0,0
29624,16,State - TRIPURA,Rural,20-24,Graduate,4809,3146,7955
29625,16,State - TRIPURA,Rural,25-29,Graduate,6619,3508,10127
29626,16,State - TRIPURA,Rural,30-34,Graduate,5566,2259,7825
29627,16,State - TRIPURA,Rural,35-39,Graduate,5483,1787,7270
29628,16,State - TRIPURA,Rural,40-44,Graduate,4638,1192,5830
29629,16,State - TRIPURA,Rural,45-49,Graduate,3541,662,4203
29630,16,State - TRIPURA,Rural,50-54,Graduate,1850,324,2174
29631,16,State - TRIPURA,Rural,55-59,Graduate,1078,170,1248
29632,16,State - TRIPURA,Rural,60-64,Graduate,691,75,766
29633,16,State - TRIPURA,Rural,65-69,Graduate,294,23,317
29634,16,State - TRIPURA,Rural,70-74,Graduate,136,12,148
29635,16,State - TRIPURA,Rural,75-79,Graduate,58,5,63
29636,16,State - TRIPURA,Rural,80+,Graduate,90,13,103
29637,16,State - TRIPURA,Rural,Age not stated,Graduate,16,8,24
29638,16,State - TRIPURA,Urban,All ages,Graduate,53752,36007,89759
29639,16,State - TRIPURA,Urban,0-6,Graduate,0,0,0
29640,16,State - TRIPURA,Urban,7,Graduate,0,0,0
29641,16,State - TRIPURA,Urban,8,Graduate,0,0,0
29642,16,State - TRIPURA,Urban,9,Graduate,0,0,0
29643,16,State - TRIPURA,Urban,10,Graduate,0,0,0
29644,16,State - TRIPURA,Urban,11,Graduate,0,0,0
29645,16,State - TRIPURA,Urban,12,Graduate,0,0,0
29646,16,State - TRIPURA,Urban,13,Graduate,0,0,0
29647,16,State - TRIPURA,Urban,14,Graduate,0,0,0
29648,16,State - TRIPURA,Urban,15,Graduate,0,0,0
29649,16,State - TRIPURA,Urban,16,Graduate,0,0,0
29650,16,State - TRIPURA,Urban,17,Graduate,0,0,0
29651,16,State - TRIPURA,Urban,18,Graduate,0,0,0
29652,16,State - TRIPURA,Urban,19,Graduate,0,0,0
29653,16,State - TRIPURA,Urban,20-24,Graduate,4698,4825,9523
29654,16,State - TRIPURA,Urban,25-29,Graduate,6936,6381,13317
29655,16,State - TRIPURA,Urban,30-34,Graduate,6178,5233,11411
29656,16,State - TRIPURA,Urban,35-39,Graduate,6827,5042,11869
29657,16,State - TRIPURA,Urban,40-44,Graduate,6856,4468,11324
29658,16,State - TRIPURA,Urban,45-49,Graduate,6577,3762,10339
29659,16,State - TRIPURA,Urban,50-54,Graduate,5071,2679,7750
29660,16,State - TRIPURA,Urban,55-59,Graduate,4258,1812,6070
29661,16,State - TRIPURA,Urban,60-64,Graduate,3213,1073,4286
29662,16,State - TRIPURA,Urban,65-69,Graduate,1556,436,1992
29663,16,State - TRIPURA,Urban,70-74,Graduate,886,160,1046
29664,16,State - TRIPURA,Urban,75-79,Graduate,435,60,495
29665,16,State - TRIPURA,Urban,80+,Graduate,237,67,304
29666,16,State - TRIPURA,Urban,Age not stated,Graduate,24,9,33
29667,17,State - MEGHALAYA,Total,All ages,Graduate,46311,44208,90519
29668,17,State - MEGHALAYA,Total,0-6,Graduate,0,0,0
29669,17,State - MEGHALAYA,Total,7,Graduate,0,0,0
29670,17,State - MEGHALAYA,Total,8,Graduate,0,0,0
29671,17,State - MEGHALAYA,Total,9,Graduate,0,0,0
29672,17,State - MEGHALAYA,Total,10,Graduate,0,0,0
29673,17,State - MEGHALAYA,Total,11,Graduate,0,0,0
29674,17,State - MEGHALAYA,Total,12,Graduate,0,0,0
29675,17,State - MEGHALAYA,Total,13,Graduate,0,0,0
29676,17,State - MEGHALAYA,Total,14,Graduate,0,0,0
29677,17,State - MEGHALAYA,Total,15,Graduate,0,0,0
29678,17,State - MEGHALAYA,Total,16,Graduate,0,0,0
29679,17,State - MEGHALAYA,Total,17,Graduate,0,0,0
29680,17,State - MEGHALAYA,Total,18,Graduate,0,0,0
29681,17,State - MEGHALAYA,Total,19,Graduate,0,0,0
29682,17,State - MEGHALAYA,Total,20-24,Graduate,6658,8647,15305
29683,17,State - MEGHALAYA,Total,25-29,Graduate,9966,11424,21390
29684,17,State - MEGHALAYA,Total,30-34,Graduate,8068,7910,15978
29685,17,State - MEGHALAYA,Total,35-39,Graduate,6089,5548,11637
29686,17,State - MEGHALAYA,Total,40-44,Graduate,4504,3509,8013
29687,17,State - MEGHALAYA,Total,45-49,Graduate,3331,2403,5734
29688,17,State - MEGHALAYA,Total,50-54,Graduate,2597,1693,4290
29689,17,State - MEGHALAYA,Total,55-59,Graduate,1851,1272,3123
29690,17,State - MEGHALAYA,Total,60-64,Graduate,1356,826,2182
29691,17,State - MEGHALAYA,Total,65-69,Graduate,737,422,1159
29692,17,State - MEGHALAYA,Total,70-74,Graduate,499,240,739
29693,17,State - MEGHALAYA,Total,75-79,Graduate,288,117,405
29694,17,State - MEGHALAYA,Total,80+,Graduate,287,152,439
29695,17,State - MEGHALAYA,Total,Age not stated,Graduate,80,45,125
29696,17,State - MEGHALAYA,Rural,All ages,Graduate,14884,12603,27487
29697,17,State - MEGHALAYA,Rural,0-6,Graduate,0,0,0
29698,17,State - MEGHALAYA,Rural,7,Graduate,0,0,0
29699,17,State - MEGHALAYA,Rural,8,Graduate,0,0,0
29700,17,State - MEGHALAYA,Rural,9,Graduate,0,0,0
29701,17,State - MEGHALAYA,Rural,10,Graduate,0,0,0
29702,17,State - MEGHALAYA,Rural,11,Graduate,0,0,0
29703,17,State - MEGHALAYA,Rural,12,Graduate,0,0,0
29704,17,State - MEGHALAYA,Rural,13,Graduate,0,0,0
29705,17,State - MEGHALAYA,Rural,14,Graduate,0,0,0
29706,17,State - MEGHALAYA,Rural,15,Graduate,0,0,0
29707,17,State - MEGHALAYA,Rural,16,Graduate,0,0,0
29708,17,State - MEGHALAYA,Rural,17,Graduate,0,0,0
29709,17,State - MEGHALAYA,Rural,18,Graduate,0,0,0
29710,17,State - MEGHALAYA,Rural,19,Graduate,0,0,0
29711,17,State - MEGHALAYA,Rural,20-24,Graduate,2551,3182,5733
29712,17,State - MEGHALAYA,Rural,25-29,Graduate,3646,3778,7424
29713,17,State - MEGHALAYA,Rural,30-34,Graduate,2821,2351,5172
29714,17,State - MEGHALAYA,Rural,35-39,Graduate,1990,1493,3483
29715,17,State - MEGHALAYA,Rural,40-44,Graduate,1420,771,2191
29716,17,State - MEGHALAYA,Rural,45-49,Graduate,914,442,1356
29717,17,State - MEGHALAYA,Rural,50-54,Graduate,577,227,804
29718,17,State - MEGHALAYA,Rural,55-59,Graduate,339,147,486
29719,17,State - MEGHALAYA,Rural,60-64,Graduate,264,88,352
29720,17,State - MEGHALAYA,Rural,65-69,Graduate,133,31,164
29721,17,State - MEGHALAYA,Rural,70-74,Graduate,85,22,107
29722,17,State - MEGHALAYA,Rural,75-79,Graduate,44,15,59
29723,17,State - MEGHALAYA,Rural,80+,Graduate,51,25,76
29724,17,State - MEGHALAYA,Rural,Age not stated,Graduate,49,31,80
29725,17,State - MEGHALAYA,Urban,All ages,Graduate,31427,31605,63032
29726,17,State - MEGHALAYA,Urban,0-6,Graduate,0,0,0
29727,17,State - MEGHALAYA,Urban,7,Graduate,0,0,0
29728,17,State - MEGHALAYA,Urban,8,Graduate,0,0,0
29729,17,State - MEGHALAYA,Urban,9,Graduate,0,0,0
29730,17,State - MEGHALAYA,Urban,10,Graduate,0,0,0
29731,17,State - MEGHALAYA,Urban,11,Graduate,0,0,0
29732,17,State - MEGHALAYA,Urban,12,Graduate,0,0,0
29733,17,State - MEGHALAYA,Urban,13,Graduate,0,0,0
29734,17,State - MEGHALAYA,Urban,14,Graduate,0,0,0
29735,17,State - MEGHALAYA,Urban,15,Graduate,0,0,0
29736,17,State - MEGHALAYA,Urban,16,Graduate,0,0,0
29737,17,State - MEGHALAYA,Urban,17,Graduate,0,0,0
29738,17,State - MEGHALAYA,Urban,18,Graduate,0,0,0
29739,17,State - MEGHALAYA,Urban,19,Graduate,0,0,0
29740,17,State - MEGHALAYA,Urban,20-24,Graduate,4107,5465,9572
29741,17,State - MEGHALAYA,Urban,25-29,Graduate,6320,7646,13966
29742,17,State - MEGHALAYA,Urban,30-34,Graduate,5247,5559,10806
29743,17,State - MEGHALAYA,Urban,35-39,Graduate,4099,4055,8154
29744,17,State - MEGHALAYA,Urban,40-44,Graduate,3084,2738,5822
29745,17,State - MEGHALAYA,Urban,45-49,Graduate,2417,1961,4378
29746,17,State - MEGHALAYA,Urban,50-54,Graduate,2020,1466,3486
29747,17,State - MEGHALAYA,Urban,55-59,Graduate,1512,1125,2637
29748,17,State - MEGHALAYA,Urban,60-64,Graduate,1092,738,1830
29749,17,State - MEGHALAYA,Urban,65-69,Graduate,604,391,995
29750,17,State - MEGHALAYA,Urban,70-74,Graduate,414,218,632
29751,17,State - MEGHALAYA,Urban,75-79,Graduate,244,102,346
29752,17,State - MEGHALAYA,Urban,80+,Graduate,236,127,363
29753,17,State - MEGHALAYA,Urban,Age not stated,Graduate,31,14,45
29754,18,State - ASSAM,Total,All ages,Graduate,639241,372104,1011345
29755,18,State - ASSAM,Total,0-6,Graduate,0,0,0
29756,18,State - ASSAM,Total,7,Graduate,0,0,0
29757,18,State - ASSAM,Total,8,Graduate,0,0,0
29758,18,State - ASSAM,Total,9,Graduate,0,0,0
29759,18,State - ASSAM,Total,10,Graduate,0,0,0
29760,18,State - ASSAM,Total,11,Graduate,0,0,0
29761,18,State - ASSAM,Total,12,Graduate,0,0,0
29762,18,State - ASSAM,Total,13,Graduate,0,0,0
29763,18,State - ASSAM,Total,14,Graduate,0,0,0
29764,18,State - ASSAM,Total,15,Graduate,0,0,0
29765,18,State - ASSAM,Total,16,Graduate,0,0,0
29766,18,State - ASSAM,Total,17,Graduate,0,0,0
29767,18,State - ASSAM,Total,18,Graduate,0,0,0
29768,18,State - ASSAM,Total,19,Graduate,0,0,0
29769,18,State - ASSAM,Total,20-24,Graduate,66007,68978,134985
29770,18,State - ASSAM,Total,25-29,Graduate,101431,88005,189436
29771,18,State - ASSAM,Total,30-34,Graduate,96274,66501,162775
29772,18,State - ASSAM,Total,35-39,Graduate,92987,52033,145020
29773,18,State - ASSAM,Total,40-44,Graduate,79987,35650,115637
29774,18,State - ASSAM,Total,45-49,Graduate,63719,24201,87920
29775,18,State - ASSAM,Total,50-54,Graduate,49470,15762,65232
29776,18,State - ASSAM,Total,55-59,Graduate,34325,9430,43755
29777,18,State - ASSAM,Total,60-64,Graduate,24573,6035,30608
29778,18,State - ASSAM,Total,65-69,Graduate,13842,2573,16415
29779,18,State - ASSAM,Total,70-74,Graduate,8695,1275,9970
29780,18,State - ASSAM,Total,75-79,Graduate,4097,580,4677
29781,18,State - ASSAM,Total,80+,Graduate,3279,793,4072
29782,18,State - ASSAM,Total,Age not stated,Graduate,555,288,843
29783,18,State - ASSAM,Rural,All ages,Graduate,340774,166466,507240
29784,18,State - ASSAM,Rural,0-6,Graduate,0,0,0
29785,18,State - ASSAM,Rural,7,Graduate,0,0,0
29786,18,State - ASSAM,Rural,8,Graduate,0,0,0
29787,18,State - ASSAM,Rural,9,Graduate,0,0,0
29788,18,State - ASSAM,Rural,10,Graduate,0,0,0
29789,18,State - ASSAM,Rural,11,Graduate,0,0,0
29790,18,State - ASSAM,Rural,12,Graduate,0,0,0
29791,18,State - ASSAM,Rural,13,Graduate,0,0,0
29792,18,State - ASSAM,Rural,14,Graduate,0,0,0
29793,18,State - ASSAM,Rural,15,Graduate,0,0,0
29794,18,State - ASSAM,Rural,16,Graduate,0,0,0
29795,18,State - ASSAM,Rural,17,Graduate,0,0,0
29796,18,State - ASSAM,Rural,18,Graduate,0,0,0
29797,18,State - ASSAM,Rural,19,Graduate,0,0,0
29798,18,State - ASSAM,Rural,20-24,Graduate,38794,37694,76488
29799,18,State - ASSAM,Rural,25-29,Graduate,60711,45314,106025
29800,18,State - ASSAM,Rural,30-34,Graduate,57096,31577,88673
29801,18,State - ASSAM,Rural,35-39,Graduate,54199,22293,76492
29802,18,State - ASSAM,Rural,40-44,Graduate,43537,13161,56698
29803,18,State - ASSAM,Rural,45-49,Graduate,31116,7627,38743
29804,18,State - ASSAM,Rural,50-54,Graduate,21284,4180,25464
29805,18,State - ASSAM,Rural,55-59,Graduate,13856,2201,16057
29806,18,State - ASSAM,Rural,60-64,Graduate,9160,1225,10385
29807,18,State - ASSAM,Rural,65-69,Graduate,5118,475,5593
29808,18,State - ASSAM,Rural,70-74,Graduate,3091,270,3361
29809,18,State - ASSAM,Rural,75-79,Graduate,1379,114,1493
29810,18,State - ASSAM,Rural,80+,Graduate,1208,249,1457
29811,18,State - ASSAM,Rural,Age not stated,Graduate,225,86,311
29812,18,State - ASSAM,Urban,All ages,Graduate,298467,205638,504105
29813,18,State - ASSAM,Urban,0-6,Graduate,0,0,0
29814,18,State - ASSAM,Urban,7,Graduate,0,0,0
29815,18,State - ASSAM,Urban,8,Graduate,0,0,0
29816,18,State - ASSAM,Urban,9,Graduate,0,0,0
29817,18,State - ASSAM,Urban,10,Graduate,0,0,0
29818,18,State - ASSAM,Urban,11,Graduate,0,0,0
29819,18,State - ASSAM,Urban,12,Graduate,0,0,0
29820,18,State - ASSAM,Urban,13,Graduate,0,0,0
29821,18,State - ASSAM,Urban,14,Graduate,0,0,0
29822,18,State - ASSAM,Urban,15,Graduate,0,0,0
29823,18,State - ASSAM,Urban,16,Graduate,0,0,0
29824,18,State - ASSAM,Urban,17,Graduate,0,0,0
29825,18,State - ASSAM,Urban,18,Graduate,0,0,0
29826,18,State - ASSAM,Urban,19,Graduate,0,0,0
29827,18,State - ASSAM,Urban,20-24,Graduate,27213,31284,58497
29828,18,State - ASSAM,Urban,25-29,Graduate,40720,42691,83411
29829,18,State - ASSAM,Urban,30-34,Graduate,39178,34924,74102
29830,18,State - ASSAM,Urban,35-39,Graduate,38788,29740,68528
29831,18,State - ASSAM,Urban,40-44,Graduate,36450,22489,58939
29832,18,State - ASSAM,Urban,45-49,Graduate,32603,16574,49177
29833,18,State - ASSAM,Urban,50-54,Graduate,28186,11582,39768
29834,18,State - ASSAM,Urban,55-59,Graduate,20469,7229,27698
29835,18,State - ASSAM,Urban,60-64,Graduate,15413,4810,20223
29836,18,State - ASSAM,Urban,65-69,Graduate,8724,2098,10822
29837,18,State - ASSAM,Urban,70-74,Graduate,5604,1005,6609
29838,18,State - ASSAM,Urban,75-79,Graduate,2718,466,3184
29839,18,State - ASSAM,Urban,80+,Graduate,2071,544,2615
29840,18,State - ASSAM,Urban,Age not stated,Graduate,330,202,532
29841,19,State - WEST BENGAL,Total,All ages,Graduate,3088673,1739144,4827817
29842,19,State - WEST BENGAL,Total,0-6,Graduate,0,0,0
29843,19,State - WEST BENGAL,Total,7,Graduate,0,0,0
29844,19,State - WEST BENGAL,Total,8,Graduate,0,0,0
29845,19,State - WEST BENGAL,Total,9,Graduate,0,0,0
29846,19,State - WEST BENGAL,Total,10,Graduate,0,0,0
29847,19,State - WEST BENGAL,Total,11,Graduate,0,0,0
29848,19,State - WEST BENGAL,Total,12,Graduate,0,0,0
29849,19,State - WEST BENGAL,Total,13,Graduate,0,0,0
29850,19,State - WEST BENGAL,Total,14,Graduate,0,0,0
29851,19,State - WEST BENGAL,Total,15,Graduate,0,0,0
29852,19,State - WEST BENGAL,Total,16,Graduate,0,0,0
29853,19,State - WEST BENGAL,Total,17,Graduate,0,0,0
29854,19,State - WEST BENGAL,Total,18,Graduate,0,0,0
29855,19,State - WEST BENGAL,Total,19,Graduate,0,0,0
29856,19,State - WEST BENGAL,Total,20-24,Graduate,392346,309635,701981
29857,19,State - WEST BENGAL,Total,25-29,Graduate,469817,345506,815323
29858,19,State - WEST BENGAL,Total,30-34,Graduate,400759,266928,667687
29859,19,State - WEST BENGAL,Total,35-39,Graduate,362939,213513,576452
29860,19,State - WEST BENGAL,Total,40-44,Graduate,328227,163800,492027
29861,19,State - WEST BENGAL,Total,45-49,Graduate,273724,129271,402995
29862,19,State - WEST BENGAL,Total,50-54,Graduate,233016,104815,337831
29863,19,State - WEST BENGAL,Total,55-59,Graduate,216614,81388,298002
29864,19,State - WEST BENGAL,Total,60-64,Graduate,170395,57851,228246
29865,19,State - WEST BENGAL,Total,65-69,Graduate,107048,31192,138240
29866,19,State - WEST BENGAL,Total,70-74,Graduate,66108,16204,82312
29867,19,State - WEST BENGAL,Total,75-79,Graduate,32799,6894,39693
29868,19,State - WEST BENGAL,Total,80+,Graduate,29784,9018,38802
29869,19,State - WEST BENGAL,Total,Age not stated,Graduate,5097,3129,8226
29870,19,State - WEST BENGAL,Rural,All ages,Graduate,1042854,359922,1402776
29871,19,State - WEST BENGAL,Rural,0-6,Graduate,0,0,0
29872,19,State - WEST BENGAL,Rural,7,Graduate,0,0,0
29873,19,State - WEST BENGAL,Rural,8,Graduate,0,0,0
29874,19,State - WEST BENGAL,Rural,9,Graduate,0,0,0
29875,19,State - WEST BENGAL,Rural,10,Graduate,0,0,0
29876,19,State - WEST BENGAL,Rural,11,Graduate,0,0,0
29877,19,State - WEST BENGAL,Rural,12,Graduate,0,0,0
29878,19,State - WEST BENGAL,Rural,13,Graduate,0,0,0
29879,19,State - WEST BENGAL,Rural,14,Graduate,0,0,0
29880,19,State - WEST BENGAL,Rural,15,Graduate,0,0,0
29881,19,State - WEST BENGAL,Rural,16,Graduate,0,0,0
29882,19,State - WEST BENGAL,Rural,17,Graduate,0,0,0
29883,19,State - WEST BENGAL,Rural,18,Graduate,0,0,0
29884,19,State - WEST BENGAL,Rural,19,Graduate,0,0,0
29885,19,State - WEST BENGAL,Rural,20-24,Graduate,177924,103868,281792
29886,19,State - WEST BENGAL,Rural,25-29,Graduate,195727,93914,289641
29887,19,State - WEST BENGAL,Rural,30-34,Graduate,149745,58913,208658
29888,19,State - WEST BENGAL,Rural,35-39,Graduate,126879,38297,165176
29889,19,State - WEST BENGAL,Rural,40-44,Graduate,109362,24408,133770
29890,19,State - WEST BENGAL,Rural,45-49,Graduate,82096,15219,97315
29891,19,State - WEST BENGAL,Rural,50-54,Graduate,57604,9905,67509
29892,19,State - WEST BENGAL,Rural,55-59,Graduate,53312,7268,60580
29893,19,State - WEST BENGAL,Rural,60-64,Graduate,42602,4273,46875
29894,19,State - WEST BENGAL,Rural,65-69,Graduate,24882,1692,26574
29895,19,State - WEST BENGAL,Rural,70-74,Graduate,12247,741,12988
29896,19,State - WEST BENGAL,Rural,75-79,Graduate,4852,311,5163
29897,19,State - WEST BENGAL,Rural,80+,Graduate,4586,764,5350
29898,19,State - WEST BENGAL,Rural,Age not stated,Graduate,1036,349,1385
29899,19,State - WEST BENGAL,Urban,All ages,Graduate,2045819,1379222,3425041
29900,19,State - WEST BENGAL,Urban,0-6,Graduate,0,0,0
29901,19,State - WEST BENGAL,Urban,7,Graduate,0,0,0
29902,19,State - WEST BENGAL,Urban,8,Graduate,0,0,0
29903,19,State - WEST BENGAL,Urban,9,Graduate,0,0,0
29904,19,State - WEST BENGAL,Urban,10,Graduate,0,0,0
29905,19,State - WEST BENGAL,Urban,11,Graduate,0,0,0
29906,19,State - WEST BENGAL,Urban,12,Graduate,0,0,0
29907,19,State - WEST BENGAL,Urban,13,Graduate,0,0,0
29908,19,State - WEST BENGAL,Urban,14,Graduate,0,0,0
29909,19,State - WEST BENGAL,Urban,15,Graduate,0,0,0
29910,19,State - WEST BENGAL,Urban,16,Graduate,0,0,0
29911,19,State - WEST BENGAL,Urban,17,Graduate,0,0,0
29912,19,State - WEST BENGAL,Urban,18,Graduate,0,0,0
29913,19,State - WEST BENGAL,Urban,19,Graduate,0,0,0
29914,19,State - WEST BENGAL,Urban,20-24,Graduate,214422,205767,420189
29915,19,State - WEST BENGAL,Urban,25-29,Graduate,274090,251592,525682
29916,19,State - WEST BENGAL,Urban,30-34,Graduate,251014,208015,459029
29917,19,State - WEST BENGAL,Urban,35-39,Graduate,236060,175216,411276
29918,19,State - WEST BENGAL,Urban,40-44,Graduate,218865,139392,358257
29919,19,State - WEST BENGAL,Urban,45-49,Graduate,191628,114052,305680
29920,19,State - WEST BENGAL,Urban,50-54,Graduate,175412,94910,270322
29921,19,State - WEST BENGAL,Urban,55-59,Graduate,163302,74120,237422
29922,19,State - WEST BENGAL,Urban,60-64,Graduate,127793,53578,181371
29923,19,State - WEST BENGAL,Urban,65-69,Graduate,82166,29500,111666
29924,19,State - WEST BENGAL,Urban,70-74,Graduate,53861,15463,69324
29925,19,State - WEST BENGAL,Urban,75-79,Graduate,27947,6583,34530
29926,19,State - WEST BENGAL,Urban,80+,Graduate,25198,8254,33452
29927,19,State - WEST BENGAL,Urban,Age not stated,Graduate,4061,2780,6841
29928,20,State - JHARKHAND,Total,All ages,Graduate,906174,422303,1328477
29929,20,State - JHARKHAND,Total,0-6,Graduate,0,0,0
29930,20,State - JHARKHAND,Total,7,Graduate,0,0,0
29931,20,State - JHARKHAND,Total,8,Graduate,0,0,0
29932,20,State - JHARKHAND,Total,9,Graduate,0,0,0
29933,20,State - JHARKHAND,Total,10,Graduate,0,0,0
29934,20,State - JHARKHAND,Total,11,Graduate,0,0,0
29935,20,State - JHARKHAND,Total,12,Graduate,0,0,0
29936,20,State - JHARKHAND,Total,13,Graduate,0,0,0
29937,20,State - JHARKHAND,Total,14,Graduate,0,0,0
29938,20,State - JHARKHAND,Total,15,Graduate,0,0,0
29939,20,State - JHARKHAND,Total,16,Graduate,0,0,0
29940,20,State - JHARKHAND,Total,17,Graduate,0,0,0
29941,20,State - JHARKHAND,Total,18,Graduate,0,0,0
29942,20,State - JHARKHAND,Total,19,Graduate,0,0,0
29943,20,State - JHARKHAND,Total,20-24,Graduate,127498,95194,222692
29944,20,State - JHARKHAND,Total,25-29,Graduate,167263,104308,271571
29945,20,State - JHARKHAND,Total,30-34,Graduate,132286,69827,202113
29946,20,State - JHARKHAND,Total,35-39,Graduate,118538,51501,170039
29947,20,State - JHARKHAND,Total,40-44,Graduate,103100,36521,139621
29948,20,State - JHARKHAND,Total,45-49,Graduate,84193,24961,109154
29949,20,State - JHARKHAND,Total,50-54,Graduate,57029,15626,72655
29950,20,State - JHARKHAND,Total,55-59,Graduate,45224,10207,55431
29951,20,State - JHARKHAND,Total,60-64,Graduate,30985,5946,36931
29952,20,State - JHARKHAND,Total,65-69,Graduate,17192,2703,19895
29953,20,State - JHARKHAND,Total,70-74,Graduate,10113,1394,11507
29954,20,State - JHARKHAND,Total,75-79,Graduate,4226,570,4796
29955,20,State - JHARKHAND,Total,80+,Graduate,3511,773,4284
29956,20,State - JHARKHAND,Total,Age not stated,Graduate,5016,2772,7788
29957,20,State - JHARKHAND,Rural,All ages,Graduate,321799,93092,414891
29958,20,State - JHARKHAND,Rural,0-6,Graduate,0,0,0
29959,20,State - JHARKHAND,Rural,7,Graduate,0,0,0
29960,20,State - JHARKHAND,Rural,8,Graduate,0,0,0
29961,20,State - JHARKHAND,Rural,9,Graduate,0,0,0
29962,20,State - JHARKHAND,Rural,10,Graduate,0,0,0
29963,20,State - JHARKHAND,Rural,11,Graduate,0,0,0
29964,20,State - JHARKHAND,Rural,12,Graduate,0,0,0
29965,20,State - JHARKHAND,Rural,13,Graduate,0,0,0
29966,20,State - JHARKHAND,Rural,14,Graduate,0,0,0
29967,20,State - JHARKHAND,Rural,15,Graduate,0,0,0
29968,20,State - JHARKHAND,Rural,16,Graduate,0,0,0
29969,20,State - JHARKHAND,Rural,17,Graduate,0,0,0
29970,20,State - JHARKHAND,Rural,18,Graduate,0,0,0
29971,20,State - JHARKHAND,Rural,19,Graduate,0,0,0
29972,20,State - JHARKHAND,Rural,20-24,Graduate,54723,26477,81200
29973,20,State - JHARKHAND,Rural,25-29,Graduate,66444,26265,92709
29974,20,State - JHARKHAND,Rural,30-34,Graduate,47471,15534,63005
29975,20,State - JHARKHAND,Rural,35-39,Graduate,43223,10280,53503
29976,20,State - JHARKHAND,Rural,40-44,Graduate,37071,6315,43386
29977,20,State - JHARKHAND,Rural,45-49,Graduate,27952,3455,31407
29978,20,State - JHARKHAND,Rural,50-54,Graduate,15766,1905,17671
29979,20,State - JHARKHAND,Rural,55-59,Graduate,11503,1156,12659
29980,20,State - JHARKHAND,Rural,60-64,Graduate,8026,696,8722
29981,20,State - JHARKHAND,Rural,65-69,Graduate,4512,329,4841
29982,20,State - JHARKHAND,Rural,70-74,Graduate,2524,174,2698
29983,20,State - JHARKHAND,Rural,75-79,Graduate,871,69,940
29984,20,State - JHARKHAND,Rural,80+,Graduate,840,147,987
29985,20,State - JHARKHAND,Rural,Age not stated,Graduate,873,290,1163
29986,20,State - JHARKHAND,Urban,All ages,Graduate,584375,329211,913586
29987,20,State - JHARKHAND,Urban,0-6,Graduate,0,0,0
29988,20,State - JHARKHAND,Urban,7,Graduate,0,0,0
29989,20,State - JHARKHAND,Urban,8,Graduate,0,0,0
29990,20,State - JHARKHAND,Urban,9,Graduate,0,0,0
29991,20,State - JHARKHAND,Urban,10,Graduate,0,0,0
29992,20,State - JHARKHAND,Urban,11,Graduate,0,0,0
29993,20,State - JHARKHAND,Urban,12,Graduate,0,0,0
29994,20,State - JHARKHAND,Urban,13,Graduate,0,0,0
29995,20,State - JHARKHAND,Urban,14,Graduate,0,0,0
29996,20,State - JHARKHAND,Urban,15,Graduate,0,0,0
29997,20,State - JHARKHAND,Urban,16,Graduate,0,0,0
29998,20,State - JHARKHAND,Urban,17,Graduate,0,0,0
29999,20,State - JHARKHAND,Urban,18,Graduate,0,0,0
30000,20,State - JHARKHAND,Urban,19,Graduate,0,0,0
30001,20,State - JHARKHAND,Urban,20-24,Graduate,72775,68717,141492
30002,20,State - JHARKHAND,Urban,25-29,Graduate,100819,78043,178862
30003,20,State - JHARKHAND,Urban,30-34,Graduate,84815,54293,139108
30004,20,State - JHARKHAND,Urban,35-39,Graduate,75315,41221,116536
30005,20,State - JHARKHAND,Urban,40-44,Graduate,66029,30206,96235
30006,20,State - JHARKHAND,Urban,45-49,Graduate,56241,21506,77747
30007,20,State - JHARKHAND,Urban,50-54,Graduate,41263,13721,54984
30008,20,State - JHARKHAND,Urban,55-59,Graduate,33721,9051,42772
30009,20,State - JHARKHAND,Urban,60-64,Graduate,22959,5250,28209
30010,20,State - JHARKHAND,Urban,65-69,Graduate,12680,2374,15054
30011,20,State - JHARKHAND,Urban,70-74,Graduate,7589,1220,8809
30012,20,State - JHARKHAND,Urban,75-79,Graduate,3355,501,3856
30013,20,State - JHARKHAND,Urban,80+,Graduate,2671,626,3297
30014,20,State - JHARKHAND,Urban,Age not stated,Graduate,4143,2482,6625
30015,21,State - ODISHA,Total,All ages,Graduate,1174184,609613,1783797
30016,21,State - ODISHA,Total,0-6,Graduate,0,0,0
30017,21,State - ODISHA,Total,7,Graduate,0,0,0
30018,21,State - ODISHA,Total,8,Graduate,0,0,0
30019,21,State - ODISHA,Total,9,Graduate,0,0,0
30020,21,State - ODISHA,Total,10,Graduate,0,0,0
30021,21,State - ODISHA,Total,11,Graduate,0,0,0
30022,21,State - ODISHA,Total,12,Graduate,0,0,0
30023,21,State - ODISHA,Total,13,Graduate,0,0,0
30024,21,State - ODISHA,Total,14,Graduate,0,0,0
30025,21,State - ODISHA,Total,15,Graduate,0,0,0
30026,21,State - ODISHA,Total,16,Graduate,0,0,0
30027,21,State - ODISHA,Total,17,Graduate,0,0,0
30028,21,State - ODISHA,Total,18,Graduate,0,0,0
30029,21,State - ODISHA,Total,19,Graduate,0,0,0
30030,21,State - ODISHA,Total,20-24,Graduate,137148,125013,262161
30031,21,State - ODISHA,Total,25-29,Graduate,184042,145400,329442
30032,21,State - ODISHA,Total,30-34,Graduate,199847,123191,323038
30033,21,State - ODISHA,Total,35-39,Graduate,186169,87850,274019
30034,21,State - ODISHA,Total,40-44,Graduate,142432,51001,193433
30035,21,State - ODISHA,Total,45-49,Graduate,106915,32472,139387
30036,21,State - ODISHA,Total,50-54,Graduate,76888,18815,95703
30037,21,State - ODISHA,Total,55-59,Graduate,57033,11532,68565
30038,21,State - ODISHA,Total,60-64,Graduate,36189,6103,42292
30039,21,State - ODISHA,Total,65-69,Graduate,20960,2808,23768
30040,21,State - ODISHA,Total,70-74,Graduate,11954,1474,13428
30041,21,State - ODISHA,Total,75-79,Graduate,5522,701,6223
30042,21,State - ODISHA,Total,80+,Graduate,5365,1208,6573
30043,21,State - ODISHA,Total,Age not stated,Graduate,3720,2045,5765
30044,21,State - ODISHA,Rural,All ages,Graduate,626900,273069,899969
30045,21,State - ODISHA,Rural,0-6,Graduate,0,0,0
30046,21,State - ODISHA,Rural,7,Graduate,0,0,0
30047,21,State - ODISHA,Rural,8,Graduate,0,0,0
30048,21,State - ODISHA,Rural,9,Graduate,0,0,0
30049,21,State - ODISHA,Rural,10,Graduate,0,0,0
30050,21,State - ODISHA,Rural,11,Graduate,0,0,0
30051,21,State - ODISHA,Rural,12,Graduate,0,0,0
30052,21,State - ODISHA,Rural,13,Graduate,0,0,0
30053,21,State - ODISHA,Rural,14,Graduate,0,0,0
30054,21,State - ODISHA,Rural,15,Graduate,0,0,0
30055,21,State - ODISHA,Rural,16,Graduate,0,0,0
30056,21,State - ODISHA,Rural,17,Graduate,0,0,0
30057,21,State - ODISHA,Rural,18,Graduate,0,0,0
30058,21,State - ODISHA,Rural,19,Graduate,0,0,0
30059,21,State - ODISHA,Rural,20-24,Graduate,74096,61590,135686
30060,21,State - ODISHA,Rural,25-29,Graduate,106073,72240,178313
30061,21,State - ODISHA,Rural,30-34,Graduate,120235,59177,179412
30062,21,State - ODISHA,Rural,35-39,Graduate,110183,38171,148354
30063,21,State - ODISHA,Rural,40-44,Graduate,76151,18317,94468
30064,21,State - ODISHA,Rural,45-49,Graduate,49145,9931,59076
30065,21,State - ODISHA,Rural,50-54,Graduate,31689,5519,37208
30066,21,State - ODISHA,Rural,55-59,Graduate,23271,3492,26763
30067,21,State - ODISHA,Rural,60-64,Graduate,15436,1850,17286
30068,21,State - ODISHA,Rural,65-69,Graduate,9206,862,10068
30069,21,State - ODISHA,Rural,70-74,Graduate,5192,499,5691
30070,21,State - ODISHA,Rural,75-79,Graduate,2243,220,2463
30071,21,State - ODISHA,Rural,80+,Graduate,2262,397,2659
30072,21,State - ODISHA,Rural,Age not stated,Graduate,1718,804,2522
30073,21,State - ODISHA,Urban,All ages,Graduate,547284,336544,883828
30074,21,State - ODISHA,Urban,0-6,Graduate,0,0,0
30075,21,State - ODISHA,Urban,7,Graduate,0,0,0
30076,21,State - ODISHA,Urban,8,Graduate,0,0,0
30077,21,State - ODISHA,Urban,9,Graduate,0,0,0
30078,21,State - ODISHA,Urban,10,Graduate,0,0,0
30079,21,State - ODISHA,Urban,11,Graduate,0,0,0
30080,21,State - ODISHA,Urban,12,Graduate,0,0,0
30081,21,State - ODISHA,Urban,13,Graduate,0,0,0
30082,21,State - ODISHA,Urban,14,Graduate,0,0,0
30083,21,State - ODISHA,Urban,15,Graduate,0,0,0
30084,21,State - ODISHA,Urban,16,Graduate,0,0,0
30085,21,State - ODISHA,Urban,17,Graduate,0,0,0
30086,21,State - ODISHA,Urban,18,Graduate,0,0,0
30087,21,State - ODISHA,Urban,19,Graduate,0,0,0
30088,21,State - ODISHA,Urban,20-24,Graduate,63052,63423,126475
30089,21,State - ODISHA,Urban,25-29,Graduate,77969,73160,151129
30090,21,State - ODISHA,Urban,30-34,Graduate,79612,64014,143626
30091,21,State - ODISHA,Urban,35-39,Graduate,75986,49679,125665
30092,21,State - ODISHA,Urban,40-44,Graduate,66281,32684,98965
30093,21,State - ODISHA,Urban,45-49,Graduate,57770,22541,80311
30094,21,State - ODISHA,Urban,50-54,Graduate,45199,13296,58495
30095,21,State - ODISHA,Urban,55-59,Graduate,33762,8040,41802
30096,21,State - ODISHA,Urban,60-64,Graduate,20753,4253,25006
30097,21,State - ODISHA,Urban,65-69,Graduate,11754,1946,13700
30098,21,State - ODISHA,Urban,70-74,Graduate,6762,975,7737
30099,21,State - ODISHA,Urban,75-79,Graduate,3279,481,3760
30100,21,State - ODISHA,Urban,80+,Graduate,3103,811,3914
30101,21,State - ODISHA,Urban,Age not stated,Graduate,2002,1241,3243
30102,22,State - CHHATTISGARH,Total,All ages,Graduate,659081,359772,1018853
30103,22,State - CHHATTISGARH,Total,0-6,Graduate,0,0,0
30104,22,State - CHHATTISGARH,Total,7,Graduate,0,0,0
30105,22,State - CHHATTISGARH,Total,8,Graduate,0,0,0
30106,22,State - CHHATTISGARH,Total,9,Graduate,0,0,0
30107,22,State - CHHATTISGARH,Total,10,Graduate,0,0,0
30108,22,State - CHHATTISGARH,Total,11,Graduate,0,0,0
30109,22,State - CHHATTISGARH,Total,12,Graduate,0,0,0
30110,22,State - CHHATTISGARH,Total,13,Graduate,0,0,0
30111,22,State - CHHATTISGARH,Total,14,Graduate,0,0,0
30112,22,State - CHHATTISGARH,Total,15,Graduate,0,0,0
30113,22,State - CHHATTISGARH,Total,16,Graduate,0,0,0
30114,22,State - CHHATTISGARH,Total,17,Graduate,0,0,0
30115,22,State - CHHATTISGARH,Total,18,Graduate,0,0,0
30116,22,State - CHHATTISGARH,Total,19,Graduate,0,0,0
30117,22,State - CHHATTISGARH,Total,20-24,Graduate,76079,73995,150074
30118,22,State - CHHATTISGARH,Total,25-29,Graduate,122296,89672,211968
30119,22,State - CHHATTISGARH,Total,30-34,Graduate,112816,65538,178354
30120,22,State - CHHATTISGARH,Total,35-39,Graduate,98236,46833,145069
30121,22,State - CHHATTISGARH,Total,40-44,Graduate,79705,32758,112463
30122,22,State - CHHATTISGARH,Total,45-49,Graduate,61099,22274,83373
30123,22,State - CHHATTISGARH,Total,50-54,Graduate,41045,12607,53652
30124,22,State - CHHATTISGARH,Total,55-59,Graduate,27204,7100,34304
30125,22,State - CHHATTISGARH,Total,60-64,Graduate,18619,4330,22949
30126,22,State - CHHATTISGARH,Total,65-69,Graduate,10291,2048,12339
30127,22,State - CHHATTISGARH,Total,70-74,Graduate,6099,1045,7144
30128,22,State - CHHATTISGARH,Total,75-79,Graduate,2750,439,3189
30129,22,State - CHHATTISGARH,Total,80+,Graduate,2109,709,2818
30130,22,State - CHHATTISGARH,Total,Age not stated,Graduate,733,424,1157
30131,22,State - CHHATTISGARH,Rural,All ages,Graduate,256863,79922,336785
30132,22,State - CHHATTISGARH,Rural,0-6,Graduate,0,0,0
30133,22,State - CHHATTISGARH,Rural,7,Graduate,0,0,0
30134,22,State - CHHATTISGARH,Rural,8,Graduate,0,0,0
30135,22,State - CHHATTISGARH,Rural,9,Graduate,0,0,0
30136,22,State - CHHATTISGARH,Rural,10,Graduate,0,0,0
30137,22,State - CHHATTISGARH,Rural,11,Graduate,0,0,0
30138,22,State - CHHATTISGARH,Rural,12,Graduate,0,0,0
30139,22,State - CHHATTISGARH,Rural,13,Graduate,0,0,0
30140,22,State - CHHATTISGARH,Rural,14,Graduate,0,0,0
30141,22,State - CHHATTISGARH,Rural,15,Graduate,0,0,0
30142,22,State - CHHATTISGARH,Rural,16,Graduate,0,0,0
30143,22,State - CHHATTISGARH,Rural,17,Graduate,0,0,0
30144,22,State - CHHATTISGARH,Rural,18,Graduate,0,0,0
30145,22,State - CHHATTISGARH,Rural,19,Graduate,0,0,0
30146,22,State - CHHATTISGARH,Rural,20-24,Graduate,32076,22174,54250
30147,22,State - CHHATTISGARH,Rural,25-29,Graduate,54990,25215,80205
30148,22,State - CHHATTISGARH,Rural,30-34,Graduate,50975,15586,66561
30149,22,State - CHHATTISGARH,Rural,35-39,Graduate,42899,8627,51526
30150,22,State - CHHATTISGARH,Rural,40-44,Graduate,29725,4149,33874
30151,22,State - CHHATTISGARH,Rural,45-49,Graduate,18733,2066,20799
30152,22,State - CHHATTISGARH,Rural,50-54,Graduate,10372,941,11313
30153,22,State - CHHATTISGARH,Rural,55-59,Graduate,6753,469,7222
30154,22,State - CHHATTISGARH,Rural,60-64,Graduate,5205,274,5479
30155,22,State - CHHATTISGARH,Rural,65-69,Graduate,2730,142,2872
30156,22,State - CHHATTISGARH,Rural,70-74,Graduate,1312,78,1390
30157,22,State - CHHATTISGARH,Rural,75-79,Graduate,483,31,514
30158,22,State - CHHATTISGARH,Rural,80+,Graduate,463,118,581
30159,22,State - CHHATTISGARH,Rural,Age not stated,Graduate,147,52,199
30160,22,State - CHHATTISGARH,Urban,All ages,Graduate,402218,279850,682068
30161,22,State - CHHATTISGARH,Urban,0-6,Graduate,0,0,0
30162,22,State - CHHATTISGARH,Urban,7,Graduate,0,0,0
30163,22,State - CHHATTISGARH,Urban,8,Graduate,0,0,0
30164,22,State - CHHATTISGARH,Urban,9,Graduate,0,0,0
30165,22,State - CHHATTISGARH,Urban,10,Graduate,0,0,0
30166,22,State - CHHATTISGARH,Urban,11,Graduate,0,0,0
30167,22,State - CHHATTISGARH,Urban,12,Graduate,0,0,0
30168,22,State - CHHATTISGARH,Urban,13,Graduate,0,0,0
30169,22,State - CHHATTISGARH,Urban,14,Graduate,0,0,0
30170,22,State - CHHATTISGARH,Urban,15,Graduate,0,0,0
30171,22,State - CHHATTISGARH,Urban,16,Graduate,0,0,0
30172,22,State - CHHATTISGARH,Urban,17,Graduate,0,0,0
30173,22,State - CHHATTISGARH,Urban,18,Graduate,0,0,0
30174,22,State - CHHATTISGARH,Urban,19,Graduate,0,0,0
30175,22,State - CHHATTISGARH,Urban,20-24,Graduate,44003,51821,95824
30176,22,State - CHHATTISGARH,Urban,25-29,Graduate,67306,64457,131763
30177,22,State - CHHATTISGARH,Urban,30-34,Graduate,61841,49952,111793
30178,22,State - CHHATTISGARH,Urban,35-39,Graduate,55337,38206,93543
30179,22,State - CHHATTISGARH,Urban,40-44,Graduate,49980,28609,78589
30180,22,State - CHHATTISGARH,Urban,45-49,Graduate,42366,20208,62574
30181,22,State - CHHATTISGARH,Urban,50-54,Graduate,30673,11666,42339
30182,22,State - CHHATTISGARH,Urban,55-59,Graduate,20451,6631,27082
30183,22,State - CHHATTISGARH,Urban,60-64,Graduate,13414,4056,17470
30184,22,State - CHHATTISGARH,Urban,65-69,Graduate,7561,1906,9467
30185,22,State - CHHATTISGARH,Urban,70-74,Graduate,4787,967,5754
30186,22,State - CHHATTISGARH,Urban,75-79,Graduate,2267,408,2675
30187,22,State - CHHATTISGARH,Urban,80+,Graduate,1646,591,2237
30188,22,State - CHHATTISGARH,Urban,Age not stated,Graduate,586,372,958
30189,23,State - MADHYA PRADESH,Total,All ages,Graduate,2051127,1171675,3222802
30190,23,State - MADHYA PRADESH,Total,0-6,Graduate,0,0,0
30191,23,State - MADHYA PRADESH,Total,7,Graduate,0,0,0
30192,23,State - MADHYA PRADESH,Total,8,Graduate,0,0,0
30193,23,State - MADHYA PRADESH,Total,9,Graduate,0,0,0
30194,23,State - MADHYA PRADESH,Total,10,Graduate,0,0,0
30195,23,State - MADHYA PRADESH,Total,11,Graduate,0,0,0
30196,23,State - MADHYA PRADESH,Total,12,Graduate,0,0,0
30197,23,State - MADHYA PRADESH,Total,13,Graduate,0,0,0
30198,23,State - MADHYA PRADESH,Total,14,Graduate,0,0,0
30199,23,State - MADHYA PRADESH,Total,15,Graduate,0,0,0
30200,23,State - MADHYA PRADESH,Total,16,Graduate,0,0,0
30201,23,State - MADHYA PRADESH,Total,17,Graduate,0,0,0
30202,23,State - MADHYA PRADESH,Total,18,Graduate,0,0,0
30203,23,State - MADHYA PRADESH,Total,19,Graduate,0,0,0
30204,23,State - MADHYA PRADESH,Total,20-24,Graduate,301184,253295,554479
30205,23,State - MADHYA PRADESH,Total,25-29,Graduate,370332,264057,634389
30206,23,State - MADHYA PRADESH,Total,30-34,Graduate,309099,193260,502359
30207,23,State - MADHYA PRADESH,Total,35-39,Graduate,254328,138991,393319
30208,23,State - MADHYA PRADESH,Total,40-44,Graduate,220070,108241,328311
30209,23,State - MADHYA PRADESH,Total,45-49,Graduate,187736,82112,269848
30210,23,State - MADHYA PRADESH,Total,50-54,Graduate,141061,54029,195090
30211,23,State - MADHYA PRADESH,Total,55-59,Graduate,97512,32967,130479
30212,23,State - MADHYA PRADESH,Total,60-64,Graduate,71866,20581,92447
30213,23,State - MADHYA PRADESH,Total,65-69,Graduate,43802,10014,53816
30214,23,State - MADHYA PRADESH,Total,70-74,Graduate,27385,5794,33179
30215,23,State - MADHYA PRADESH,Total,75-79,Graduate,13169,2443,15612
30216,23,State - MADHYA PRADESH,Total,80+,Graduate,10520,3746,14266
30217,23,State - MADHYA PRADESH,Total,Age not stated,Graduate,3063,2145,5208
30218,23,State - MADHYA PRADESH,Rural,All ages,Graduate,640936,194665,835601
30219,23,State - MADHYA PRADESH,Rural,0-6,Graduate,0,0,0
30220,23,State - MADHYA PRADESH,Rural,7,Graduate,0,0,0
30221,23,State - MADHYA PRADESH,Rural,8,Graduate,0,0,0
30222,23,State - MADHYA PRADESH,Rural,9,Graduate,0,0,0
30223,23,State - MADHYA PRADESH,Rural,10,Graduate,0,0,0
30224,23,State - MADHYA PRADESH,Rural,11,Graduate,0,0,0
30225,23,State - MADHYA PRADESH,Rural,12,Graduate,0,0,0
30226,23,State - MADHYA PRADESH,Rural,13,Graduate,0,0,0
30227,23,State - MADHYA PRADESH,Rural,14,Graduate,0,0,0
30228,23,State - MADHYA PRADESH,Rural,15,Graduate,0,0,0
30229,23,State - MADHYA PRADESH,Rural,16,Graduate,0,0,0
30230,23,State - MADHYA PRADESH,Rural,17,Graduate,0,0,0
30231,23,State - MADHYA PRADESH,Rural,18,Graduate,0,0,0
30232,23,State - MADHYA PRADESH,Rural,19,Graduate,0,0,0
30233,23,State - MADHYA PRADESH,Rural,20-24,Graduate,118301,62577,180878
30234,23,State - MADHYA PRADESH,Rural,25-29,Graduate,137797,54652,192449
30235,23,State - MADHYA PRADESH,Rural,30-34,Graduate,106911,33200,140111
30236,23,State - MADHYA PRADESH,Rural,35-39,Graduate,82398,18775,101173
30237,23,State - MADHYA PRADESH,Rural,40-44,Graduate,64796,11334,76130
30238,23,State - MADHYA PRADESH,Rural,45-49,Graduate,46818,6454,53272
30239,23,State - MADHYA PRADESH,Rural,50-54,Graduate,29885,3309,33194
30240,23,State - MADHYA PRADESH,Rural,55-59,Graduate,19609,1805,21414
30241,23,State - MADHYA PRADESH,Rural,60-64,Graduate,15082,1021,16103
30242,23,State - MADHYA PRADESH,Rural,65-69,Graduate,9504,537,10041
30243,23,State - MADHYA PRADESH,Rural,70-74,Graduate,5282,298,5580
30244,23,State - MADHYA PRADESH,Rural,75-79,Graduate,2059,112,2171
30245,23,State - MADHYA PRADESH,Rural,80+,Graduate,1897,372,2269
30246,23,State - MADHYA PRADESH,Rural,Age not stated,Graduate,597,219,816
30247,23,State - MADHYA PRADESH,Urban,All ages,Graduate,1410191,977010,2387201
30248,23,State - MADHYA PRADESH,Urban,0-6,Graduate,0,0,0
30249,23,State - MADHYA PRADESH,Urban,7,Graduate,0,0,0
30250,23,State - MADHYA PRADESH,Urban,8,Graduate,0,0,0
30251,23,State - MADHYA PRADESH,Urban,9,Graduate,0,0,0
30252,23,State - MADHYA PRADESH,Urban,10,Graduate,0,0,0
30253,23,State - MADHYA PRADESH,Urban,11,Graduate,0,0,0
30254,23,State - MADHYA PRADESH,Urban,12,Graduate,0,0,0
30255,23,State - MADHYA PRADESH,Urban,13,Graduate,0,0,0
30256,23,State - MADHYA PRADESH,Urban,14,Graduate,0,0,0
30257,23,State - MADHYA PRADESH,Urban,15,Graduate,0,0,0
30258,23,State - MADHYA PRADESH,Urban,16,Graduate,0,0,0
30259,23,State - MADHYA PRADESH,Urban,17,Graduate,0,0,0
30260,23,State - MADHYA PRADESH,Urban,18,Graduate,0,0,0
30261,23,State - MADHYA PRADESH,Urban,19,Graduate,0,0,0
30262,23,State - MADHYA PRADESH,Urban,20-24,Graduate,182883,190718,373601
30263,23,State - MADHYA PRADESH,Urban,25-29,Graduate,232535,209405,441940
30264,23,State - MADHYA PRADESH,Urban,30-34,Graduate,202188,160060,362248
30265,23,State - MADHYA PRADESH,Urban,35-39,Graduate,171930,120216,292146
30266,23,State - MADHYA PRADESH,Urban,40-44,Graduate,155274,96907,252181
30267,23,State - MADHYA PRADESH,Urban,45-49,Graduate,140918,75658,216576
30268,23,State - MADHYA PRADESH,Urban,50-54,Graduate,111176,50720,161896
30269,23,State - MADHYA PRADESH,Urban,55-59,Graduate,77903,31162,109065
30270,23,State - MADHYA PRADESH,Urban,60-64,Graduate,56784,19560,76344
30271,23,State - MADHYA PRADESH,Urban,65-69,Graduate,34298,9477,43775
30272,23,State - MADHYA PRADESH,Urban,70-74,Graduate,22103,5496,27599
30273,23,State - MADHYA PRADESH,Urban,75-79,Graduate,11110,2331,13441
30274,23,State - MADHYA PRADESH,Urban,80+,Graduate,8623,3374,11997
30275,23,State - MADHYA PRADESH,Urban,Age not stated,Graduate,2466,1926,4392
30276,24,State - GUJARAT,Total,All ages,Graduate,1891932,1282226,3174158
30277,24,State - GUJARAT,Total,0-6,Graduate,0,0,0
30278,24,State - GUJARAT,Total,7,Graduate,0,0,0
30279,24,State - GUJARAT,Total,8,Graduate,0,0,0
30280,24,State - GUJARAT,Total,9,Graduate,0,0,0
30281,24,State - GUJARAT,Total,10,Graduate,0,0,0
30282,24,State - GUJARAT,Total,11,Graduate,0,0,0
30283,24,State - GUJARAT,Total,12,Graduate,0,0,0
30284,24,State - GUJARAT,Total,13,Graduate,0,0,0
30285,24,State - GUJARAT,Total,14,Graduate,0,0,0
30286,24,State - GUJARAT,Total,15,Graduate,0,0,0
30287,24,State - GUJARAT,Total,16,Graduate,0,0,0
30288,24,State - GUJARAT,Total,17,Graduate,0,0,0
30289,24,State - GUJARAT,Total,18,Graduate,0,0,0
30290,24,State - GUJARAT,Total,19,Graduate,0,0,0
30291,24,State - GUJARAT,Total,20-24,Graduate,297384,266961,564345
30292,24,State - GUJARAT,Total,25-29,Graduate,346476,293222,639698
30293,24,State - GUJARAT,Total,30-34,Graduate,264196,210576,474772
30294,24,State - GUJARAT,Total,35-39,Graduate,226129,163687,389816
30295,24,State - GUJARAT,Total,40-44,Graduate,183489,111725,295214
30296,24,State - GUJARAT,Total,45-49,Graduate,158570,81882,240452
30297,24,State - GUJARAT,Total,50-54,Graduate,137181,60207,197388
30298,24,State - GUJARAT,Total,55-59,Graduate,112081,41708,153789
30299,24,State - GUJARAT,Total,60-64,Graduate,71677,22768,94445
30300,24,State - GUJARAT,Total,65-69,Graduate,40873,11338,52211
30301,24,State - GUJARAT,Total,70-74,Graduate,24414,6277,30691
30302,24,State - GUJARAT,Total,75-79,Graduate,11815,2605,14420
30303,24,State - GUJARAT,Total,80+,Graduate,10238,3781,14019
30304,24,State - GUJARAT,Total,Age not stated,Graduate,7409,5489,12898
30305,24,State - GUJARAT,Rural,All ages,Graduate,452150,218280,670430
30306,24,State - GUJARAT,Rural,0-6,Graduate,0,0,0
30307,24,State - GUJARAT,Rural,7,Graduate,0,0,0
30308,24,State - GUJARAT,Rural,8,Graduate,0,0,0
30309,24,State - GUJARAT,Rural,9,Graduate,0,0,0
30310,24,State - GUJARAT,Rural,10,Graduate,0,0,0
30311,24,State - GUJARAT,Rural,11,Graduate,0,0,0
30312,24,State - GUJARAT,Rural,12,Graduate,0,0,0
30313,24,State - GUJARAT,Rural,13,Graduate,0,0,0
30314,24,State - GUJARAT,Rural,14,Graduate,0,0,0
30315,24,State - GUJARAT,Rural,15,Graduate,0,0,0
30316,24,State - GUJARAT,Rural,16,Graduate,0,0,0
30317,24,State - GUJARAT,Rural,17,Graduate,0,0,0
30318,24,State - GUJARAT,Rural,18,Graduate,0,0,0
30319,24,State - GUJARAT,Rural,19,Graduate,0,0,0
30320,24,State - GUJARAT,Rural,20-24,Graduate,88952,67624,156576
30321,24,State - GUJARAT,Rural,25-29,Graduate,100543,61074,161617
30322,24,State - GUJARAT,Rural,30-34,Graduate,67052,34817,101869
30323,24,State - GUJARAT,Rural,35-39,Graduate,56634,24160,80794
30324,24,State - GUJARAT,Rural,40-44,Graduate,43069,13274,56343
30325,24,State - GUJARAT,Rural,45-49,Graduate,32405,7404,39809
30326,24,State - GUJARAT,Rural,50-54,Graduate,23496,4151,27647
30327,24,State - GUJARAT,Rural,55-59,Graduate,17614,2420,20034
30328,24,State - GUJARAT,Rural,60-64,Graduate,10646,1189,11835
30329,24,State - GUJARAT,Rural,65-69,Graduate,5410,553,5963
30330,24,State - GUJARAT,Rural,70-74,Graduate,2624,275,2899
30331,24,State - GUJARAT,Rural,75-79,Graduate,1015,111,1126
30332,24,State - GUJARAT,Rural,80+,Graduate,1106,339,1445
30333,24,State - GUJARAT,Rural,Age not stated,Graduate,1584,889,2473
30334,24,State - GUJARAT,Urban,All ages,Graduate,1439782,1063946,2503728
30335,24,State - GUJARAT,Urban,0-6,Graduate,0,0,0
30336,24,State - GUJARAT,Urban,7,Graduate,0,0,0
30337,24,State - GUJARAT,Urban,8,Graduate,0,0,0
30338,24,State - GUJARAT,Urban,9,Graduate,0,0,0
30339,24,State - GUJARAT,Urban,10,Graduate,0,0,0
30340,24,State - GUJARAT,Urban,11,Graduate,0,0,0
30341,24,State - GUJARAT,Urban,12,Graduate,0,0,0
30342,24,State - GUJARAT,Urban,13,Graduate,0,0,0
30343,24,State - GUJARAT,Urban,14,Graduate,0,0,0
30344,24,State - GUJARAT,Urban,15,Graduate,0,0,0
30345,24,State - GUJARAT,Urban,16,Graduate,0,0,0
30346,24,State - GUJARAT,Urban,17,Graduate,0,0,0
30347,24,State - GUJARAT,Urban,18,Graduate,0,0,0
30348,24,State - GUJARAT,Urban,19,Graduate,0,0,0
30349,24,State - GUJARAT,Urban,20-24,Graduate,208432,199337,407769
30350,24,State - GUJARAT,Urban,25-29,Graduate,245933,232148,478081
30351,24,State - GUJARAT,Urban,30-34,Graduate,197144,175759,372903
30352,24,State - GUJARAT,Urban,35-39,Graduate,169495,139527,309022
30353,24,State - GUJARAT,Urban,40-44,Graduate,140420,98451,238871
30354,24,State - GUJARAT,Urban,45-49,Graduate,126165,74478,200643
30355,24,State - GUJARAT,Urban,50-54,Graduate,113685,56056,169741
30356,24,State - GUJARAT,Urban,55-59,Graduate,94467,39288,133755
30357,24,State - GUJARAT,Urban,60-64,Graduate,61031,21579,82610
30358,24,State - GUJARAT,Urban,65-69,Graduate,35463,10785,46248
30359,24,State - GUJARAT,Urban,70-74,Graduate,21790,6002,27792
30360,24,State - GUJARAT,Urban,75-79,Graduate,10800,2494,13294
30361,24,State - GUJARAT,Urban,80+,Graduate,9132,3442,12574
30362,24,State - GUJARAT,Urban,Age not stated,Graduate,5825,4600,10425
30363,25,State - DAMAN & DIU,Total,All ages,Graduate,8425,4377,12802
30364,25,State - DAMAN & DIU,Total,0-6,Graduate,0,0,0
30365,25,State - DAMAN & DIU,Total,7,Graduate,0,0,0
30366,25,State - DAMAN & DIU,Total,8,Graduate,0,0,0
30367,25,State - DAMAN & DIU,Total,9,Graduate,0,0,0
30368,25,State - DAMAN & DIU,Total,10,Graduate,0,0,0
30369,25,State - DAMAN & DIU,Total,11,Graduate,0,0,0
30370,25,State - DAMAN & DIU,Total,12,Graduate,0,0,0
30371,25,State - DAMAN & DIU,Total,13,Graduate,0,0,0
30372,25,State - DAMAN & DIU,Total,14,Graduate,0,0,0
30373,25,State - DAMAN & DIU,Total,15,Graduate,0,0,0
30374,25,State - DAMAN & DIU,Total,16,Graduate,0,0,0
30375,25,State - DAMAN & DIU,Total,17,Graduate,0,0,0
30376,25,State - DAMAN & DIU,Total,18,Graduate,0,0,0
30377,25,State - DAMAN & DIU,Total,19,Graduate,0,0,0
30378,25,State - DAMAN & DIU,Total,20-24,Graduate,1181,845,2026
30379,25,State - DAMAN & DIU,Total,25-29,Graduate,1872,1148,3020
30380,25,State - DAMAN & DIU,Total,30-34,Graduate,1473,867,2340
30381,25,State - DAMAN & DIU,Total,35-39,Graduate,1360,679,2039
30382,25,State - DAMAN & DIU,Total,40-44,Graduate,1007,382,1389
30383,25,State - DAMAN & DIU,Total,45-49,Graduate,581,189,770
30384,25,State - DAMAN & DIU,Total,50-54,Graduate,339,108,447
30385,25,State - DAMAN & DIU,Total,55-59,Graduate,268,85,353
30386,25,State - DAMAN & DIU,Total,60-64,Graduate,179,35,214
30387,25,State - DAMAN & DIU,Total,65-69,Graduate,70,15,85
30388,25,State - DAMAN & DIU,Total,70-74,Graduate,47,7,54
30389,25,State - DAMAN & DIU,Total,75-79,Graduate,16,6,22
30390,25,State - DAMAN & DIU,Total,80+,Graduate,24,7,31
30391,25,State - DAMAN & DIU,Total,Age not stated,Graduate,8,4,12
30392,25,State - DAMAN & DIU,Rural,All ages,Graduate,1223,446,1669
30393,25,State - DAMAN & DIU,Rural,0-6,Graduate,0,0,0
30394,25,State - DAMAN & DIU,Rural,7,Graduate,0,0,0
30395,25,State - DAMAN & DIU,Rural,8,Graduate,0,0,0
30396,25,State - DAMAN & DIU,Rural,9,Graduate,0,0,0
30397,25,State - DAMAN & DIU,Rural,10,Graduate,0,0,0
30398,25,State - DAMAN & DIU,Rural,11,Graduate,0,0,0
30399,25,State - DAMAN & DIU,Rural,12,Graduate,0,0,0
30400,25,State - DAMAN & DIU,Rural,13,Graduate,0,0,0
30401,25,State - DAMAN & DIU,Rural,14,Graduate,0,0,0
30402,25,State - DAMAN & DIU,Rural,15,Graduate,0,0,0
30403,25,State - DAMAN & DIU,Rural,16,Graduate,0,0,0
30404,25,State - DAMAN & DIU,Rural,17,Graduate,0,0,0
30405,25,State - DAMAN & DIU,Rural,18,Graduate,0,0,0
30406,25,State - DAMAN & DIU,Rural,19,Graduate,0,0,0
30407,25,State - DAMAN & DIU,Rural,20-24,Graduate,263,139,402
30408,25,State - DAMAN & DIU,Rural,25-29,Graduate,309,112,421
30409,25,State - DAMAN & DIU,Rural,30-34,Graduate,193,88,281
30410,25,State - DAMAN & DIU,Rural,35-39,Graduate,180,56,236
30411,25,State - DAMAN & DIU,Rural,40-44,Graduate,121,23,144
30412,25,State - DAMAN & DIU,Rural,45-49,Graduate,74,17,91
30413,25,State - DAMAN & DIU,Rural,50-54,Graduate,36,3,39
30414,25,State - DAMAN & DIU,Rural,55-59,Graduate,21,4,25
30415,25,State - DAMAN & DIU,Rural,60-64,Graduate,17,3,20
30416,25,State - DAMAN & DIU,Rural,65-69,Graduate,4,0,4
30417,25,State - DAMAN & DIU,Rural,70-74,Graduate,2,0,2
30418,25,State - DAMAN & DIU,Rural,75-79,Graduate,0,0,0
30419,25,State - DAMAN & DIU,Rural,80+,Graduate,1,1,2
30420,25,State - DAMAN & DIU,Rural,Age not stated,Graduate,2,0,2
30421,25,State - DAMAN & DIU,Urban,All ages,Graduate,7202,3931,11133
30422,25,State - DAMAN & DIU,Urban,0-6,Graduate,0,0,0
30423,25,State - DAMAN & DIU,Urban,7,Graduate,0,0,0
30424,25,State - DAMAN & DIU,Urban,8,Graduate,0,0,0
30425,25,State - DAMAN & DIU,Urban,9,Graduate,0,0,0
30426,25,State - DAMAN & DIU,Urban,10,Graduate,0,0,0
30427,25,State - DAMAN & DIU,Urban,11,Graduate,0,0,0
30428,25,State - DAMAN & DIU,Urban,12,Graduate,0,0,0
30429,25,State - DAMAN & DIU,Urban,13,Graduate,0,0,0
30430,25,State - DAMAN & DIU,Urban,14,Graduate,0,0,0
30431,25,State - DAMAN & DIU,Urban,15,Graduate,0,0,0
30432,25,State - DAMAN & DIU,Urban,16,Graduate,0,0,0
30433,25,State - DAMAN & DIU,Urban,17,Graduate,0,0,0
30434,25,State - DAMAN & DIU,Urban,18,Graduate,0,0,0
30435,25,State - DAMAN & DIU,Urban,19,Graduate,0,0,0
30436,25,State - DAMAN & DIU,Urban,20-24,Graduate,918,706,1624
30437,25,State - DAMAN & DIU,Urban,25-29,Graduate,1563,1036,2599
30438,25,State - DAMAN & DIU,Urban,30-34,Graduate,1280,779,2059
30439,25,State - DAMAN & DIU,Urban,35-39,Graduate,1180,623,1803
30440,25,State - DAMAN & DIU,Urban,40-44,Graduate,886,359,1245
30441,25,State - DAMAN & DIU,Urban,45-49,Graduate,507,172,679
30442,25,State - DAMAN & DIU,Urban,50-54,Graduate,303,105,408
30443,25,State - DAMAN & DIU,Urban,55-59,Graduate,247,81,328
30444,25,State - DAMAN & DIU,Urban,60-64,Graduate,162,32,194
30445,25,State - DAMAN & DIU,Urban,65-69,Graduate,66,15,81
30446,25,State - DAMAN & DIU,Urban,70-74,Graduate,45,7,52
30447,25,State - DAMAN & DIU,Urban,75-79,Graduate,16,6,22
30448,25,State - DAMAN & DIU,Urban,80+,Graduate,23,6,29
30449,25,State - DAMAN & DIU,Urban,Age not stated,Graduate,6,4,10
30450,26,State - DADRA & NAGAR HAVELI,Total,All ages,Graduate,12227,6947,19174
30451,26,State - DADRA & NAGAR HAVELI,Total,0-6,Graduate,0,0,0
30452,26,State - DADRA & NAGAR HAVELI,Total,7,Graduate,0,0,0
30453,26,State - DADRA & NAGAR HAVELI,Total,8,Graduate,0,0,0
30454,26,State - DADRA & NAGAR HAVELI,Total,9,Graduate,0,0,0
30455,26,State - DADRA & NAGAR HAVELI,Total,10,Graduate,0,0,0
30456,26,State - DADRA & NAGAR HAVELI,Total,11,Graduate,0,0,0
30457,26,State - DADRA & NAGAR HAVELI,Total,12,Graduate,0,0,0
30458,26,State - DADRA & NAGAR HAVELI,Total,13,Graduate,0,0,0
30459,26,State - DADRA & NAGAR HAVELI,Total,14,Graduate,0,0,0
30460,26,State - DADRA & NAGAR HAVELI,Total,15,Graduate,0,0,0
30461,26,State - DADRA & NAGAR HAVELI,Total,16,Graduate,0,0,0
30462,26,State - DADRA & NAGAR HAVELI,Total,17,Graduate,0,0,0
30463,26,State - DADRA & NAGAR HAVELI,Total,18,Graduate,0,0,0
30464,26,State - DADRA & NAGAR HAVELI,Total,19,Graduate,0,0,0
30465,26,State - DADRA & NAGAR HAVELI,Total,20-24,Graduate,1782,1293,3075
30466,26,State - DADRA & NAGAR HAVELI,Total,25-29,Graduate,2565,1845,4410
30467,26,State - DADRA & NAGAR HAVELI,Total,30-34,Graduate,2343,1571,3914
30468,26,State - DADRA & NAGAR HAVELI,Total,35-39,Graduate,2231,1077,3308
30469,26,State - DADRA & NAGAR HAVELI,Total,40-44,Graduate,1464,524,1988
30470,26,State - DADRA & NAGAR HAVELI,Total,45-49,Graduate,810,305,1115
30471,26,State - DADRA & NAGAR HAVELI,Total,50-54,Graduate,456,165,621
30472,26,State - DADRA & NAGAR HAVELI,Total,55-59,Graduate,268,82,350
30473,26,State - DADRA & NAGAR HAVELI,Total,60-64,Graduate,149,41,190
30474,26,State - DADRA & NAGAR HAVELI,Total,65-69,Graduate,71,21,92
30475,26,State - DADRA & NAGAR HAVELI,Total,70-74,Graduate,39,4,43
30476,26,State - DADRA & NAGAR HAVELI,Total,75-79,Graduate,18,2,20
30477,26,State - DADRA & NAGAR HAVELI,Total,80+,Graduate,17,8,25
30478,26,State - DADRA & NAGAR HAVELI,Total,Age not stated,Graduate,14,9,23
30479,26,State - DADRA & NAGAR HAVELI,Rural,All ages,Graduate,2242,937,3179
30480,26,State - DADRA & NAGAR HAVELI,Rural,0-6,Graduate,0,0,0
30481,26,State - DADRA & NAGAR HAVELI,Rural,7,Graduate,0,0,0
30482,26,State - DADRA & NAGAR HAVELI,Rural,8,Graduate,0,0,0
30483,26,State - DADRA & NAGAR HAVELI,Rural,9,Graduate,0,0,0
30484,26,State - DADRA & NAGAR HAVELI,Rural,10,Graduate,0,0,0
30485,26,State - DADRA & NAGAR HAVELI,Rural,11,Graduate,0,0,0
30486,26,State - DADRA & NAGAR HAVELI,Rural,12,Graduate,0,0,0
30487,26,State - DADRA & NAGAR HAVELI,Rural,13,Graduate,0,0,0
30488,26,State - DADRA & NAGAR HAVELI,Rural,14,Graduate,0,0,0
30489,26,State - DADRA & NAGAR HAVELI,Rural,15,Graduate,0,0,0
30490,26,State - DADRA & NAGAR HAVELI,Rural,16,Graduate,0,0,0
30491,26,State - DADRA & NAGAR HAVELI,Rural,17,Graduate,0,0,0
30492,26,State - DADRA & NAGAR HAVELI,Rural,18,Graduate,0,0,0
30493,26,State - DADRA & NAGAR HAVELI,Rural,19,Graduate,0,0,0
30494,26,State - DADRA & NAGAR HAVELI,Rural,20-24,Graduate,513,237,750
30495,26,State - DADRA & NAGAR HAVELI,Rural,25-29,Graduate,564,267,831
30496,26,State - DADRA & NAGAR HAVELI,Rural,30-34,Graduate,387,209,596
30497,26,State - DADRA & NAGAR HAVELI,Rural,35-39,Graduate,338,124,462
30498,26,State - DADRA & NAGAR HAVELI,Rural,40-44,Graduate,217,54,271
30499,26,State - DADRA & NAGAR HAVELI,Rural,45-49,Graduate,104,21,125
30500,26,State - DADRA & NAGAR HAVELI,Rural,50-54,Graduate,61,10,71
30501,26,State - DADRA & NAGAR HAVELI,Rural,55-59,Graduate,27,7,34
30502,26,State - DADRA & NAGAR HAVELI,Rural,60-64,Graduate,13,4,17
30503,26,State - DADRA & NAGAR HAVELI,Rural,65-69,Graduate,6,0,6
30504,26,State - DADRA & NAGAR HAVELI,Rural,70-74,Graduate,3,0,3
30505,26,State - DADRA & NAGAR HAVELI,Rural,75-79,Graduate,1,0,1
30506,26,State - DADRA & NAGAR HAVELI,Rural,80+,Graduate,3,0,3
30507,26,State - DADRA & NAGAR HAVELI,Rural,Age not stated,Graduate,5,4,9
30508,26,State - DADRA & NAGAR HAVELI,Urban,All ages,Graduate,9985,6010,15995
30509,26,State - DADRA & NAGAR HAVELI,Urban,0-6,Graduate,0,0,0
30510,26,State - DADRA & NAGAR HAVELI,Urban,7,Graduate,0,0,0
30511,26,State - DADRA & NAGAR HAVELI,Urban,8,Graduate,0,0,0
30512,26,State - DADRA & NAGAR HAVELI,Urban,9,Graduate,0,0,0
30513,26,State - DADRA & NAGAR HAVELI,Urban,10,Graduate,0,0,0
30514,26,State - DADRA & NAGAR HAVELI,Urban,11,Graduate,0,0,0
30515,26,State - DADRA & NAGAR HAVELI,Urban,12,Graduate,0,0,0
30516,26,State - DADRA & NAGAR HAVELI,Urban,13,Graduate,0,0,0
30517,26,State - DADRA & NAGAR HAVELI,Urban,14,Graduate,0,0,0
30518,26,State - DADRA & NAGAR HAVELI,Urban,15,Graduate,0,0,0
30519,26,State - DADRA & NAGAR HAVELI,Urban,16,Graduate,0,0,0
30520,26,State - DADRA & NAGAR HAVELI,Urban,17,Graduate,0,0,0
30521,26,State - DADRA & NAGAR HAVELI,Urban,18,Graduate,0,0,0
30522,26,State - DADRA & NAGAR HAVELI,Urban,19,Graduate,0,0,0
30523,26,State - DADRA & NAGAR HAVELI,Urban,20-24,Graduate,1269,1056,2325
30524,26,State - DADRA & NAGAR HAVELI,Urban,25-29,Graduate,2001,1578,3579
30525,26,State - DADRA & NAGAR HAVELI,Urban,30-34,Graduate,1956,1362,3318
30526,26,State - DADRA & NAGAR HAVELI,Urban,35-39,Graduate,1893,953,2846
30527,26,State - DADRA & NAGAR HAVELI,Urban,40-44,Graduate,1247,470,1717
30528,26,State - DADRA & NAGAR HAVELI,Urban,45-49,Graduate,706,284,990
30529,26,State - DADRA & NAGAR HAVELI,Urban,50-54,Graduate,395,155,550
30530,26,State - DADRA & NAGAR HAVELI,Urban,55-59,Graduate,241,75,316
30531,26,State - DADRA & NAGAR HAVELI,Urban,60-64,Graduate,136,37,173
30532,26,State - DADRA & NAGAR HAVELI,Urban,65-69,Graduate,65,21,86
30533,26,State - DADRA & NAGAR HAVELI,Urban,70-74,Graduate,36,4,40
30534,26,State - DADRA & NAGAR HAVELI,Urban,75-79,Graduate,17,2,19
30535,26,State - DADRA & NAGAR HAVELI,Urban,80+,Graduate,14,8,22
30536,26,State - DADRA & NAGAR HAVELI,Urban,Age not stated,Graduate,9,5,14
30537,27,State - MAHARASHTRA,Total,All ages,Graduate,5167671,3471410,8639081
30538,27,State - MAHARASHTRA,Total,0-6,Graduate,0,0,0
30539,27,State - MAHARASHTRA,Total,7,Graduate,0,0,0
30540,27,State - MAHARASHTRA,Total,8,Graduate,0,0,0
30541,27,State - MAHARASHTRA,Total,9,Graduate,0,0,0
30542,27,State - MAHARASHTRA,Total,10,Graduate,0,0,0
30543,27,State - MAHARASHTRA,Total,11,Graduate,0,0,0
30544,27,State - MAHARASHTRA,Total,12,Graduate,0,0,0
30545,27,State - MAHARASHTRA,Total,13,Graduate,0,0,0
30546,27,State - MAHARASHTRA,Total,14,Graduate,0,0,0
30547,27,State - MAHARASHTRA,Total,15,Graduate,0,0,0
30548,27,State - MAHARASHTRA,Total,16,Graduate,0,0,0
30549,27,State - MAHARASHTRA,Total,17,Graduate,0,0,0
30550,27,State - MAHARASHTRA,Total,18,Graduate,0,0,0
30551,27,State - MAHARASHTRA,Total,19,Graduate,0,0,0
30552,27,State - MAHARASHTRA,Total,20-24,Graduate,778084,709301,1487385
30553,27,State - MAHARASHTRA,Total,25-29,Graduate,1002480,801626,1804106
30554,27,State - MAHARASHTRA,Total,30-34,Graduate,786496,579364,1365860
30555,27,State - MAHARASHTRA,Total,35-39,Graduate,669444,429008,1098452
30556,27,State - MAHARASHTRA,Total,40-44,Graduate,548326,304772,853098
30557,27,State - MAHARASHTRA,Total,45-49,Graduate,392447,209290,601737
30558,27,State - MAHARASHTRA,Total,50-54,Graduate,301425,152297,453722
30559,27,State - MAHARASHTRA,Total,55-59,Graduate,261961,114575,376536
30560,27,State - MAHARASHTRA,Total,60-64,Graduate,178662,71023,249685
30561,27,State - MAHARASHTRA,Total,65-69,Graduate,102972,37579,140551
30562,27,State - MAHARASHTRA,Total,70-74,Graduate,60808,22959,83767
30563,27,State - MAHARASHTRA,Total,75-79,Graduate,34462,12359,46821
30564,27,State - MAHARASHTRA,Total,80+,Graduate,31326,14465,45791
30565,27,State - MAHARASHTRA,Total,Age not stated,Graduate,18778,12792,31570
30566,27,State - MAHARASHTRA,Rural,All ages,Graduate,1440447,567411,2007858
30567,27,State - MAHARASHTRA,Rural,0-6,Graduate,0,0,0
30568,27,State - MAHARASHTRA,Rural,7,Graduate,0,0,0
30569,27,State - MAHARASHTRA,Rural,8,Graduate,0,0,0
30570,27,State - MAHARASHTRA,Rural,9,Graduate,0,0,0
30571,27,State - MAHARASHTRA,Rural,10,Graduate,0,0,0
30572,27,State - MAHARASHTRA,Rural,11,Graduate,0,0,0
30573,27,State - MAHARASHTRA,Rural,12,Graduate,0,0,0
30574,27,State - MAHARASHTRA,Rural,13,Graduate,0,0,0
30575,27,State - MAHARASHTRA,Rural,14,Graduate,0,0,0
30576,27,State - MAHARASHTRA,Rural,15,Graduate,0,0,0
30577,27,State - MAHARASHTRA,Rural,16,Graduate,0,0,0
30578,27,State - MAHARASHTRA,Rural,17,Graduate,0,0,0
30579,27,State - MAHARASHTRA,Rural,18,Graduate,0,0,0
30580,27,State - MAHARASHTRA,Rural,19,Graduate,0,0,0
30581,27,State - MAHARASHTRA,Rural,20-24,Graduate,278017,182858,460875
30582,27,State - MAHARASHTRA,Rural,25-29,Graduate,312064,153230,465294
30583,27,State - MAHARASHTRA,Rural,30-34,Graduate,224555,91836,316391
30584,27,State - MAHARASHTRA,Rural,35-39,Graduate,195480,57222,252702
30585,27,State - MAHARASHTRA,Rural,40-44,Graduate,151492,33175,184667
30586,27,State - MAHARASHTRA,Rural,45-49,Graduate,87298,16945,104243
30587,27,State - MAHARASHTRA,Rural,50-54,Graduate,56185,10491,66676
30588,27,State - MAHARASHTRA,Rural,55-59,Graduate,53365,8575,61940
30589,27,State - MAHARASHTRA,Rural,60-64,Graduate,37887,5168,43055
30590,27,State - MAHARASHTRA,Rural,65-69,Graduate,20691,2542,23233
30591,27,State - MAHARASHTRA,Rural,70-74,Graduate,9597,1363,10960
30592,27,State - MAHARASHTRA,Rural,75-79,Graduate,4331,630,4961
30593,27,State - MAHARASHTRA,Rural,80+,Graduate,4630,1349,5979
30594,27,State - MAHARASHTRA,Rural,Age not stated,Graduate,4855,2027,6882
30595,27,State - MAHARASHTRA,Urban,All ages,Graduate,3727224,2903999,6631223
30596,27,State - MAHARASHTRA,Urban,0-6,Graduate,0,0,0
30597,27,State - MAHARASHTRA,Urban,7,Graduate,0,0,0
30598,27,State - MAHARASHTRA,Urban,8,Graduate,0,0,0
30599,27,State - MAHARASHTRA,Urban,9,Graduate,0,0,0
30600,27,State - MAHARASHTRA,Urban,10,Graduate,0,0,0
30601,27,State - MAHARASHTRA,Urban,11,Graduate,0,0,0
30602,27,State - MAHARASHTRA,Urban,12,Graduate,0,0,0
30603,27,State - MAHARASHTRA,Urban,13,Graduate,0,0,0
30604,27,State - MAHARASHTRA,Urban,14,Graduate,0,0,0
30605,27,State - MAHARASHTRA,Urban,15,Graduate,0,0,0
30606,27,State - MAHARASHTRA,Urban,16,Graduate,0,0,0
30607,27,State - MAHARASHTRA,Urban,17,Graduate,0,0,0
30608,27,State - MAHARASHTRA,Urban,18,Graduate,0,0,0
30609,27,State - MAHARASHTRA,Urban,19,Graduate,0,0,0
30610,27,State - MAHARASHTRA,Urban,20-24,Graduate,500067,526443,1026510
30611,27,State - MAHARASHTRA,Urban,25-29,Graduate,690416,648396,1338812
30612,27,State - MAHARASHTRA,Urban,30-34,Graduate,561941,487528,1049469
30613,27,State - MAHARASHTRA,Urban,35-39,Graduate,473964,371786,845750
30614,27,State - MAHARASHTRA,Urban,40-44,Graduate,396834,271597,668431
30615,27,State - MAHARASHTRA,Urban,45-49,Graduate,305149,192345,497494
30616,27,State - MAHARASHTRA,Urban,50-54,Graduate,245240,141806,387046
30617,27,State - MAHARASHTRA,Urban,55-59,Graduate,208596,106000,314596
30618,27,State - MAHARASHTRA,Urban,60-64,Graduate,140775,65855,206630
30619,27,State - MAHARASHTRA,Urban,65-69,Graduate,82281,35037,117318
30620,27,State - MAHARASHTRA,Urban,70-74,Graduate,51211,21596,72807
30621,27,State - MAHARASHTRA,Urban,75-79,Graduate,30131,11729,41860
30622,27,State - MAHARASHTRA,Urban,80+,Graduate,26696,13116,39812
30623,27,State - MAHARASHTRA,Urban,Age not stated,Graduate,13923,10765,24688
30624,28,State - ANDHRA PRADESH,Total,All ages,Graduate,3632622,1944765,5577387
30625,28,State - ANDHRA PRADESH,Total,0-6,Graduate,0,0,0
30626,28,State - ANDHRA PRADESH,Total,7,Graduate,0,0,0
30627,28,State - ANDHRA PRADESH,Total,8,Graduate,0,0,0
30628,28,State - ANDHRA PRADESH,Total,9,Graduate,0,0,0
30629,28,State - ANDHRA PRADESH,Total,10,Graduate,0,0,0
30630,28,State - ANDHRA PRADESH,Total,11,Graduate,0,0,0
30631,28,State - ANDHRA PRADESH,Total,12,Graduate,0,0,0
30632,28,State - ANDHRA PRADESH,Total,13,Graduate,0,0,0
30633,28,State - ANDHRA PRADESH,Total,14,Graduate,0,0,0
30634,28,State - ANDHRA PRADESH,Total,15,Graduate,0,0,0
30635,28,State - ANDHRA PRADESH,Total,16,Graduate,0,0,0
30636,28,State - ANDHRA PRADESH,Total,17,Graduate,0,0,0
30637,28,State - ANDHRA PRADESH,Total,18,Graduate,0,0,0
30638,28,State - ANDHRA PRADESH,Total,19,Graduate,0,0,0
30639,28,State - ANDHRA PRADESH,Total,20-24,Graduate,780087,566948,1347035
30640,28,State - ANDHRA PRADESH,Total,25-29,Graduate,777520,494141,1271661
30641,28,State - ANDHRA PRADESH,Total,30-34,Graduate,529020,293460,822480
30642,28,State - ANDHRA PRADESH,Total,35-39,Graduate,405323,202391,607714
30643,28,State - ANDHRA PRADESH,Total,40-44,Graduate,328201,136821,465022
30644,28,State - ANDHRA PRADESH,Total,45-49,Graduate,257187,90796,347983
30645,28,State - ANDHRA PRADESH,Total,50-54,Graduate,170283,53516,223799
30646,28,State - ANDHRA PRADESH,Total,55-59,Graduate,132412,34652,167064
30647,28,State - ANDHRA PRADESH,Total,60-64,Graduate,96364,20633,116997
30648,28,State - ANDHRA PRADESH,Total,65-69,Graduate,50850,9772,60622
30649,28,State - ANDHRA PRADESH,Total,70-74,Graduate,32741,5623,38364
30650,28,State - ANDHRA PRADESH,Total,75-79,Graduate,16528,2775,19303
30651,28,State - ANDHRA PRADESH,Total,80+,Graduate,16303,6449,22752
30652,28,State - ANDHRA PRADESH,Total,Age not stated,Graduate,39803,26788,66591
30653,28,State - ANDHRA PRADESH,Rural,All ages,Graduate,1382454,539271,1921725
30654,28,State - ANDHRA PRADESH,Rural,0-6,Graduate,0,0,0
30655,28,State - ANDHRA PRADESH,Rural,7,Graduate,0,0,0
30656,28,State - ANDHRA PRADESH,Rural,8,Graduate,0,0,0
30657,28,State - ANDHRA PRADESH,Rural,9,Graduate,0,0,0
30658,28,State - ANDHRA PRADESH,Rural,10,Graduate,0,0,0
30659,28,State - ANDHRA PRADESH,Rural,11,Graduate,0,0,0
30660,28,State - ANDHRA PRADESH,Rural,12,Graduate,0,0,0
30661,28,State - ANDHRA PRADESH,Rural,13,Graduate,0,0,0
30662,28,State - ANDHRA PRADESH,Rural,14,Graduate,0,0,0
30663,28,State - ANDHRA PRADESH,Rural,15,Graduate,0,0,0
30664,28,State - ANDHRA PRADESH,Rural,16,Graduate,0,0,0
30665,28,State - ANDHRA PRADESH,Rural,17,Graduate,0,0,0
30666,28,State - ANDHRA PRADESH,Rural,18,Graduate,0,0,0
30667,28,State - ANDHRA PRADESH,Rural,19,Graduate,0,0,0
30668,28,State - ANDHRA PRADESH,Rural,20-24,Graduate,410998,219714,630712
30669,28,State - ANDHRA PRADESH,Rural,25-29,Graduate,353707,151106,504813
30670,28,State - ANDHRA PRADESH,Rural,30-34,Graduate,195583,70316,265899
30671,28,State - ANDHRA PRADESH,Rural,35-39,Graduate,135762,41352,177114
30672,28,State - ANDHRA PRADESH,Rural,40-44,Graduate,99604,23451,123055
30673,28,State - ANDHRA PRADESH,Rural,45-49,Graduate,67893,12774,80667
30674,28,State - ANDHRA PRADESH,Rural,50-54,Graduate,37827,6460,44287
30675,28,State - ANDHRA PRADESH,Rural,55-59,Graduate,27156,3805,30961
30676,28,State - ANDHRA PRADESH,Rural,60-64,Graduate,19762,2053,21815
30677,28,State - ANDHRA PRADESH,Rural,65-69,Graduate,10476,1042,11518
30678,28,State - ANDHRA PRADESH,Rural,70-74,Graduate,6719,717,7436
30679,28,State - ANDHRA PRADESH,Rural,75-79,Graduate,3029,336,3365
30680,28,State - ANDHRA PRADESH,Rural,80+,Graduate,3234,994,4228
30681,28,State - ANDHRA PRADESH,Rural,Age not stated,Graduate,10704,5151,15855
30682,28,State - ANDHRA PRADESH,Urban,All ages,Graduate,2250168,1405494,3655662
30683,28,State - ANDHRA PRADESH,Urban,0-6,Graduate,0,0,0
30684,28,State - ANDHRA PRADESH,Urban,7,Graduate,0,0,0
30685,28,State - ANDHRA PRADESH,Urban,8,Graduate,0,0,0
30686,28,State - ANDHRA PRADESH,Urban,9,Graduate,0,0,0
30687,28,State - ANDHRA PRADESH,Urban,10,Graduate,0,0,0
30688,28,State - ANDHRA PRADESH,Urban,11,Graduate,0,0,0
30689,28,State - ANDHRA PRADESH,Urban,12,Graduate,0,0,0
30690,28,State - ANDHRA PRADESH,Urban,13,Graduate,0,0,0
30691,28,State - ANDHRA PRADESH,Urban,14,Graduate,0,0,0
30692,28,State - ANDHRA PRADESH,Urban,15,Graduate,0,0,0
30693,28,State - ANDHRA PRADESH,Urban,16,Graduate,0,0,0
30694,28,State - ANDHRA PRADESH,Urban,17,Graduate,0,0,0
30695,28,State - ANDHRA PRADESH,Urban,18,Graduate,0,0,0
30696,28,State - ANDHRA PRADESH,Urban,19,Graduate,0,0,0
30697,28,State - ANDHRA PRADESH,Urban,20-24,Graduate,369089,347234,716323
30698,28,State - ANDHRA PRADESH,Urban,25-29,Graduate,423813,343035,766848
30699,28,State - ANDHRA PRADESH,Urban,30-34,Graduate,333437,223144,556581
30700,28,State - ANDHRA PRADESH,Urban,35-39,Graduate,269561,161039,430600
30701,28,State - ANDHRA PRADESH,Urban,40-44,Graduate,228597,113370,341967
30702,28,State - ANDHRA PRADESH,Urban,45-49,Graduate,189294,78022,267316
30703,28,State - ANDHRA PRADESH,Urban,50-54,Graduate,132456,47056,179512
30704,28,State - ANDHRA PRADESH,Urban,55-59,Graduate,105256,30847,136103
30705,28,State - ANDHRA PRADESH,Urban,60-64,Graduate,76602,18580,95182
30706,28,State - ANDHRA PRADESH,Urban,65-69,Graduate,40374,8730,49104
30707,28,State - ANDHRA PRADESH,Urban,70-74,Graduate,26022,4906,30928
30708,28,State - ANDHRA PRADESH,Urban,75-79,Graduate,13499,2439,15938
30709,28,State - ANDHRA PRADESH,Urban,80+,Graduate,13069,5455,18524
30710,28,State - ANDHRA PRADESH,Urban,Age not stated,Graduate,29099,21637,50736
30711,29,State - KARNATAKA,Total,All ages,Graduate,2489209,1554438,4043647
30712,29,State - KARNATAKA,Total,0-6,Graduate,0,0,0
30713,29,State - KARNATAKA,Total,7,Graduate,0,0,0
30714,29,State - KARNATAKA,Total,8,Graduate,0,0,0
30715,29,State - KARNATAKA,Total,9,Graduate,0,0,0
30716,29,State - KARNATAKA,Total,10,Graduate,0,0,0
30717,29,State - KARNATAKA,Total,11,Graduate,0,0,0
30718,29,State - KARNATAKA,Total,12,Graduate,0,0,0
30719,29,State - KARNATAKA,Total,13,Graduate,0,0,0
30720,29,State - KARNATAKA,Total,14,Graduate,0,0,0
30721,29,State - KARNATAKA,Total,15,Graduate,0,0,0
30722,29,State - KARNATAKA,Total,16,Graduate,0,0,0
30723,29,State - KARNATAKA,Total,17,Graduate,0,0,0
30724,29,State - KARNATAKA,Total,18,Graduate,0,0,0
30725,29,State - KARNATAKA,Total,19,Graduate,0,0,0
30726,29,State - KARNATAKA,Total,20-24,Graduate,400949,373000,773949
30727,29,State - KARNATAKA,Total,25-29,Graduate,478600,391821,870421
30728,29,State - KARNATAKA,Total,30-34,Graduate,375445,256597,632042
30729,29,State - KARNATAKA,Total,35-39,Graduate,313342,179873,493215
30730,29,State - KARNATAKA,Total,40-44,Graduate,240324,116242,356566
30731,29,State - KARNATAKA,Total,45-49,Graduate,201086,84471,285557
30732,29,State - KARNATAKA,Total,50-54,Graduate,152825,58530,211355
30733,29,State - KARNATAKA,Total,55-59,Graduate,125682,41505,167187
30734,29,State - KARNATAKA,Total,60-64,Graduate,89621,24704,114325
30735,29,State - KARNATAKA,Total,65-69,Graduate,47360,11618,58978
30736,29,State - KARNATAKA,Total,70-74,Graduate,29992,6476,36468
30737,29,State - KARNATAKA,Total,75-79,Graduate,16166,3263,19429
30738,29,State - KARNATAKA,Total,80+,Graduate,15626,5209,20835
30739,29,State - KARNATAKA,Total,Age not stated,Graduate,2191,1129,3320
30740,29,State - KARNATAKA,Rural,All ages,Graduate,694998,287321,982319
30741,29,State - KARNATAKA,Rural,0-6,Graduate,0,0,0
30742,29,State - KARNATAKA,Rural,7,Graduate,0,0,0
30743,29,State - KARNATAKA,Rural,8,Graduate,0,0,0
30744,29,State - KARNATAKA,Rural,9,Graduate,0,0,0
30745,29,State - KARNATAKA,Rural,10,Graduate,0,0,0
30746,29,State - KARNATAKA,Rural,11,Graduate,0,0,0
30747,29,State - KARNATAKA,Rural,12,Graduate,0,0,0
30748,29,State - KARNATAKA,Rural,13,Graduate,0,0,0
30749,29,State - KARNATAKA,Rural,14,Graduate,0,0,0
30750,29,State - KARNATAKA,Rural,15,Graduate,0,0,0
30751,29,State - KARNATAKA,Rural,16,Graduate,0,0,0
30752,29,State - KARNATAKA,Rural,17,Graduate,0,0,0
30753,29,State - KARNATAKA,Rural,18,Graduate,0,0,0
30754,29,State - KARNATAKA,Rural,19,Graduate,0,0,0
30755,29,State - KARNATAKA,Rural,20-24,Graduate,147991,110060,258051
30756,29,State - KARNATAKA,Rural,25-29,Graduate,148840,78411,227251
30757,29,State - KARNATAKA,Rural,30-34,Graduate,101378,39742,141120
30758,29,State - KARNATAKA,Rural,35-39,Graduate,90451,25634,116085
30759,29,State - KARNATAKA,Rural,40-44,Graduate,67324,14025,81349
30760,29,State - KARNATAKA,Rural,45-49,Graduate,50481,8307,58788
30761,29,State - KARNATAKA,Rural,50-54,Graduate,31706,4767,36473
30762,29,State - KARNATAKA,Rural,55-59,Graduate,24447,3019,27466
30763,29,State - KARNATAKA,Rural,60-64,Graduate,16324,1495,17819
30764,29,State - KARNATAKA,Rural,65-69,Graduate,7644,643,8287
30765,29,State - KARNATAKA,Rural,70-74,Graduate,4126,360,4486
30766,29,State - KARNATAKA,Rural,75-79,Graduate,1877,194,2071
30767,29,State - KARNATAKA,Rural,80+,Graduate,1978,447,2425
30768,29,State - KARNATAKA,Rural,Age not stated,Graduate,431,217,648
30769,29,State - KARNATAKA,Urban,All ages,Graduate,1794211,1267117,3061328
30770,29,State - KARNATAKA,Urban,0-6,Graduate,0,0,0
30771,29,State - KARNATAKA,Urban,7,Graduate,0,0,0
30772,29,State - KARNATAKA,Urban,8,Graduate,0,0,0
30773,29,State - KARNATAKA,Urban,9,Graduate,0,0,0
30774,29,State - KARNATAKA,Urban,10,Graduate,0,0,0
30775,29,State - KARNATAKA,Urban,11,Graduate,0,0,0
30776,29,State - KARNATAKA,Urban,12,Graduate,0,0,0
30777,29,State - KARNATAKA,Urban,13,Graduate,0,0,0
30778,29,State - KARNATAKA,Urban,14,Graduate,0,0,0
30779,29,State - KARNATAKA,Urban,15,Graduate,0,0,0
30780,29,State - KARNATAKA,Urban,16,Graduate,0,0,0
30781,29,State - KARNATAKA,Urban,17,Graduate,0,0,0
30782,29,State - KARNATAKA,Urban,18,Graduate,0,0,0
30783,29,State - KARNATAKA,Urban,19,Graduate,0,0,0
30784,29,State - KARNATAKA,Urban,20-24,Graduate,252958,262940,515898
30785,29,State - KARNATAKA,Urban,25-29,Graduate,329760,313410,643170
30786,29,State - KARNATAKA,Urban,30-34,Graduate,274067,216855,490922
30787,29,State - KARNATAKA,Urban,35-39,Graduate,222891,154239,377130
30788,29,State - KARNATAKA,Urban,40-44,Graduate,173000,102217,275217
30789,29,State - KARNATAKA,Urban,45-49,Graduate,150605,76164,226769
30790,29,State - KARNATAKA,Urban,50-54,Graduate,121119,53763,174882
30791,29,State - KARNATAKA,Urban,55-59,Graduate,101235,38486,139721
30792,29,State - KARNATAKA,Urban,60-64,Graduate,73297,23209,96506
30793,29,State - KARNATAKA,Urban,65-69,Graduate,39716,10975,50691
30794,29,State - KARNATAKA,Urban,70-74,Graduate,25866,6116,31982
30795,29,State - KARNATAKA,Urban,75-79,Graduate,14289,3069,17358
30796,29,State - KARNATAKA,Urban,80+,Graduate,13648,4762,18410
30797,29,State - KARNATAKA,Urban,Age not stated,Graduate,1760,912,2672
30798,30,State - GOA,Total,All ages,Graduate,74077,72751,146828
30799,30,State - GOA,Total,0-6,Graduate,0,0,0
30800,30,State - GOA,Total,7,Graduate,0,0,0
30801,30,State - GOA,Total,8,Graduate,0,0,0
30802,30,State - GOA,Total,9,Graduate,0,0,0
30803,30,State - GOA,Total,10,Graduate,0,0,0
30804,30,State - GOA,Total,11,Graduate,0,0,0
30805,30,State - GOA,Total,12,Graduate,0,0,0
30806,30,State - GOA,Total,13,Graduate,0,0,0
30807,30,State - GOA,Total,14,Graduate,0,0,0
30808,30,State - GOA,Total,15,Graduate,0,0,0
30809,30,State - GOA,Total,16,Graduate,0,0,0
30810,30,State - GOA,Total,17,Graduate,0,0,0
30811,30,State - GOA,Total,18,Graduate,0,0,0
30812,30,State - GOA,Total,19,Graduate,0,0,0
30813,30,State - GOA,Total,20-24,Graduate,9286,12964,22250
30814,30,State - GOA,Total,25-29,Graduate,11816,14983,26799
30815,30,State - GOA,Total,30-34,Graduate,9962,11865,21827
30816,30,State - GOA,Total,35-39,Graduate,9695,9717,19412
30817,30,State - GOA,Total,40-44,Graduate,8151,7258,15409
30818,30,State - GOA,Total,45-49,Graduate,6195,5297,11492
30819,30,State - GOA,Total,50-54,Graduate,5503,3947,9450
30820,30,State - GOA,Total,55-59,Graduate,5196,2974,8170
30821,30,State - GOA,Total,60-64,Graduate,3898,1884,5782
30822,30,State - GOA,Total,65-69,Graduate,2098,837,2935
30823,30,State - GOA,Total,70-74,Graduate,1099,459,1558
30824,30,State - GOA,Total,75-79,Graduate,620,232,852
30825,30,State - GOA,Total,80+,Graduate,480,278,758
30826,30,State - GOA,Total,Age not stated,Graduate,78,56,134
30827,30,State - GOA,Rural,All ages,Graduate,17361,17272,34633
30828,30,State - GOA,Rural,0-6,Graduate,0,0,0
30829,30,State - GOA,Rural,7,Graduate,0,0,0
30830,30,State - GOA,Rural,8,Graduate,0,0,0
30831,30,State - GOA,Rural,9,Graduate,0,0,0
30832,30,State - GOA,Rural,10,Graduate,0,0,0
30833,30,State - GOA,Rural,11,Graduate,0,0,0
30834,30,State - GOA,Rural,12,Graduate,0,0,0
30835,30,State - GOA,Rural,13,Graduate,0,0,0
30836,30,State - GOA,Rural,14,Graduate,0,0,0
30837,30,State - GOA,Rural,15,Graduate,0,0,0
30838,30,State - GOA,Rural,16,Graduate,0,0,0
30839,30,State - GOA,Rural,17,Graduate,0,0,0
30840,30,State - GOA,Rural,18,Graduate,0,0,0
30841,30,State - GOA,Rural,19,Graduate,0,0,0
30842,30,State - GOA,Rural,20-24,Graduate,2590,3834,6424
30843,30,State - GOA,Rural,25-29,Graduate,3290,4158,7448
30844,30,State - GOA,Rural,30-34,Graduate,2636,3019,5655
30845,30,State - GOA,Rural,35-39,Graduate,2426,2190,4616
30846,30,State - GOA,Rural,40-44,Graduate,1839,1405,3244
30847,30,State - GOA,Rural,45-49,Graduate,1150,920,2070
30848,30,State - GOA,Rural,50-54,Graduate,1001,609,1610
30849,30,State - GOA,Rural,55-59,Graduate,978,490,1468
30850,30,State - GOA,Rural,60-64,Graduate,742,312,1054
30851,30,State - GOA,Rural,65-69,Graduate,353,142,495
30852,30,State - GOA,Rural,70-74,Graduate,171,80,251
30853,30,State - GOA,Rural,75-79,Graduate,94,40,134
30854,30,State - GOA,Rural,80+,Graduate,66,53,119
30855,30,State - GOA,Rural,Age not stated,Graduate,25,20,45
30856,30,State - GOA,Urban,All ages,Graduate,56716,55479,112195
30857,30,State - GOA,Urban,0-6,Graduate,0,0,0
30858,30,State - GOA,Urban,7,Graduate,0,0,0
30859,30,State - GOA,Urban,8,Graduate,0,0,0
30860,30,State - GOA,Urban,9,Graduate,0,0,0
30861,30,State - GOA,Urban,10,Graduate,0,0,0
30862,30,State - GOA,Urban,11,Graduate,0,0,0
30863,30,State - GOA,Urban,12,Graduate,0,0,0
30864,30,State - GOA,Urban,13,Graduate,0,0,0
30865,30,State - GOA,Urban,14,Graduate,0,0,0
30866,30,State - GOA,Urban,15,Graduate,0,0,0
30867,30,State - GOA,Urban,16,Graduate,0,0,0
30868,30,State - GOA,Urban,17,Graduate,0,0,0
30869,30,State - GOA,Urban,18,Graduate,0,0,0
30870,30,State - GOA,Urban,19,Graduate,0,0,0
30871,30,State - GOA,Urban,20-24,Graduate,6696,9130,15826
30872,30,State - GOA,Urban,25-29,Graduate,8526,10825,19351
30873,30,State - GOA,Urban,30-34,Graduate,7326,8846,16172
30874,30,State - GOA,Urban,35-39,Graduate,7269,7527,14796
30875,30,State - GOA,Urban,40-44,Graduate,6312,5853,12165
30876,30,State - GOA,Urban,45-49,Graduate,5045,4377,9422
30877,30,State - GOA,Urban,50-54,Graduate,4502,3338,7840
30878,30,State - GOA,Urban,55-59,Graduate,4218,2484,6702
30879,30,State - GOA,Urban,60-64,Graduate,3156,1572,4728
30880,30,State - GOA,Urban,65-69,Graduate,1745,695,2440
30881,30,State - GOA,Urban,70-74,Graduate,928,379,1307
30882,30,State - GOA,Urban,75-79,Graduate,526,192,718
30883,30,State - GOA,Urban,80+,Graduate,414,225,639
30884,30,State - GOA,Urban,Age not stated,Graduate,53,36,89
30885,31,State - LAKSHADWEEP,Total,All ages,Graduate,1458,844,2302
30886,31,State - LAKSHADWEEP,Total,0-6,Graduate,0,0,0
30887,31,State - LAKSHADWEEP,Total,7,Graduate,0,0,0
30888,31,State - LAKSHADWEEP,Total,8,Graduate,0,0,0
30889,31,State - LAKSHADWEEP,Total,9,Graduate,0,0,0
30890,31,State - LAKSHADWEEP,Total,10,Graduate,0,0,0
30891,31,State - LAKSHADWEEP,Total,11,Graduate,0,0,0
30892,31,State - LAKSHADWEEP,Total,12,Graduate,0,0,0
30893,31,State - LAKSHADWEEP,Total,13,Graduate,0,0,0
30894,31,State - LAKSHADWEEP,Total,14,Graduate,0,0,0
30895,31,State - LAKSHADWEEP,Total,15,Graduate,0,0,0
30896,31,State - LAKSHADWEEP,Total,16,Graduate,0,0,0
30897,31,State - LAKSHADWEEP,Total,17,Graduate,0,0,0
30898,31,State - LAKSHADWEEP,Total,18,Graduate,0,0,0
30899,31,State - LAKSHADWEEP,Total,19,Graduate,0,0,0
30900,31,State - LAKSHADWEEP,Total,20-24,Graduate,176,272,448
30901,31,State - LAKSHADWEEP,Total,25-29,Graduate,342,303,645
30902,31,State - LAKSHADWEEP,Total,30-34,Graduate,250,139,389
30903,31,State - LAKSHADWEEP,Total,35-39,Graduate,174,58,232
30904,31,State - LAKSHADWEEP,Total,40-44,Graduate,131,32,163
30905,31,State - LAKSHADWEEP,Total,45-49,Graduate,106,11,117
30906,31,State - LAKSHADWEEP,Total,50-54,Graduate,103,15,118
30907,31,State - LAKSHADWEEP,Total,55-59,Graduate,93,9,102
30908,31,State - LAKSHADWEEP,Total,60-64,Graduate,57,0,57
30909,31,State - LAKSHADWEEP,Total,65-69,Graduate,19,0,19
30910,31,State - LAKSHADWEEP,Total,70-74,Graduate,4,1,5
30911,31,State - LAKSHADWEEP,Total,75-79,Graduate,0,0,0
30912,31,State - LAKSHADWEEP,Total,80+,Graduate,2,1,3
30913,31,State - LAKSHADWEEP,Total,Age not stated,Graduate,1,3,4
30914,31,State - LAKSHADWEEP,Rural,All ages,Graduate,256,99,355
30915,31,State - LAKSHADWEEP,Rural,0-6,Graduate,0,0,0
30916,31,State - LAKSHADWEEP,Rural,7,Graduate,0,0,0
30917,31,State - LAKSHADWEEP,Rural,8,Graduate,0,0,0
30918,31,State - LAKSHADWEEP,Rural,9,Graduate,0,0,0
30919,31,State - LAKSHADWEEP,Rural,10,Graduate,0,0,0
30920,31,State - LAKSHADWEEP,Rural,11,Graduate,0,0,0
30921,31,State - LAKSHADWEEP,Rural,12,Graduate,0,0,0
30922,31,State - LAKSHADWEEP,Rural,13,Graduate,0,0,0
30923,31,State - LAKSHADWEEP,Rural,14,Graduate,0,0,0
30924,31,State - LAKSHADWEEP,Rural,15,Graduate,0,0,0
30925,31,State - LAKSHADWEEP,Rural,16,Graduate,0,0,0
30926,31,State - LAKSHADWEEP,Rural,17,Graduate,0,0,0
30927,31,State - LAKSHADWEEP,Rural,18,Graduate,0,0,0
30928,31,State - LAKSHADWEEP,Rural,19,Graduate,0,0,0
30929,31,State - LAKSHADWEEP,Rural,20-24,Graduate,27,29,56
30930,31,State - LAKSHADWEEP,Rural,25-29,Graduate,48,37,85
30931,31,State - LAKSHADWEEP,Rural,30-34,Graduate,52,20,72
30932,31,State - LAKSHADWEEP,Rural,35-39,Graduate,33,5,38
30933,31,State - LAKSHADWEEP,Rural,40-44,Graduate,23,3,26
30934,31,State - LAKSHADWEEP,Rural,45-49,Graduate,22,4,26
30935,31,State - LAKSHADWEEP,Rural,50-54,Graduate,20,1,21
30936,31,State - LAKSHADWEEP,Rural,55-59,Graduate,11,0,11
30937,31,State - LAKSHADWEEP,Rural,60-64,Graduate,12,0,12
30938,31,State - LAKSHADWEEP,Rural,65-69,Graduate,6,0,6
30939,31,State - LAKSHADWEEP,Rural,70-74,Graduate,1,0,1
30940,31,State - LAKSHADWEEP,Rural,75-79,Graduate,0,0,0
30941,31,State - LAKSHADWEEP,Rural,80+,Graduate,1,0,1
30942,31,State - LAKSHADWEEP,Rural,Age not stated,Graduate,0,0,0
30943,31,State - LAKSHADWEEP,Urban,All ages,Graduate,1202,745,1947
30944,31,State - LAKSHADWEEP,Urban,0-6,Graduate,0,0,0
30945,31,State - LAKSHADWEEP,Urban,7,Graduate,0,0,0
30946,31,State - LAKSHADWEEP,Urban,8,Graduate,0,0,0
30947,31,State - LAKSHADWEEP,Urban,9,Graduate,0,0,0
30948,31,State - LAKSHADWEEP,Urban,10,Graduate,0,0,0
30949,31,State - LAKSHADWEEP,Urban,11,Graduate,0,0,0
30950,31,State - LAKSHADWEEP,Urban,12,Graduate,0,0,0
30951,31,State - LAKSHADWEEP,Urban,13,Graduate,0,0,0
30952,31,State - LAKSHADWEEP,Urban,14,Graduate,0,0,0
30953,31,State - LAKSHADWEEP,Urban,15,Graduate,0,0,0
30954,31,State - LAKSHADWEEP,Urban,16,Graduate,0,0,0
30955,31,State - LAKSHADWEEP,Urban,17,Graduate,0,0,0
30956,31,State - LAKSHADWEEP,Urban,18,Graduate,0,0,0
30957,31,State - LAKSHADWEEP,Urban,19,Graduate,0,0,0
30958,31,State - LAKSHADWEEP,Urban,20-24,Graduate,149,243,392
30959,31,State - LAKSHADWEEP,Urban,25-29,Graduate,294,266,560
30960,31,State - LAKSHADWEEP,Urban,30-34,Graduate,198,119,317
30961,31,State - LAKSHADWEEP,Urban,35-39,Graduate,141,53,194
30962,31,State - LAKSHADWEEP,Urban,40-44,Graduate,108,29,137
30963,31,State - LAKSHADWEEP,Urban,45-49,Graduate,84,7,91
30964,31,State - LAKSHADWEEP,Urban,50-54,Graduate,83,14,97
30965,31,State - LAKSHADWEEP,Urban,55-59,Graduate,82,9,91
30966,31,State - LAKSHADWEEP,Urban,60-64,Graduate,45,0,45
30967,31,State - LAKSHADWEEP,Urban,65-69,Graduate,13,0,13
30968,31,State - LAKSHADWEEP,Urban,70-74,Graduate,3,1,4
30969,31,State - LAKSHADWEEP,Urban,75-79,Graduate,0,0,0
30970,31,State - LAKSHADWEEP,Urban,80+,Graduate,1,1,2
30971,31,State - LAKSHADWEEP,Urban,Age not stated,Graduate,1,3,4
30972,32,State - KERALA,Total,All ages,Graduate,1131336,1399985,2531321
30973,32,State - KERALA,Total,0-6,Graduate,0,0,0
30974,32,State - KERALA,Total,7,Graduate,0,0,0
30975,32,State - KERALA,Total,8,Graduate,0,0,0
30976,32,State - KERALA,Total,9,Graduate,0,0,0
30977,32,State - KERALA,Total,10,Graduate,0,0,0
30978,32,State - KERALA,Total,11,Graduate,0,0,0
30979,32,State - KERALA,Total,12,Graduate,0,0,0
30980,32,State - KERALA,Total,13,Graduate,0,0,0
30981,32,State - KERALA,Total,14,Graduate,0,0,0
30982,32,State - KERALA,Total,15,Graduate,0,0,0
30983,32,State - KERALA,Total,16,Graduate,0,0,0
30984,32,State - KERALA,Total,17,Graduate,0,0,0
30985,32,State - KERALA,Total,18,Graduate,0,0,0
30986,32,State - KERALA,Total,19,Graduate,0,0,0
30987,32,State - KERALA,Total,20-24,Graduate,215728,319551,535279
30988,32,State - KERALA,Total,25-29,Graduate,199715,322153,521868
30989,32,State - KERALA,Total,30-34,Graduate,134960,215519,350479
30990,32,State - KERALA,Total,35-39,Graduate,125333,178626,303959
30991,32,State - KERALA,Total,40-44,Graduate,106316,120495,226811
30992,32,State - KERALA,Total,45-49,Graduate,92284,87835,180119
30993,32,State - KERALA,Total,50-54,Graduate,71983,57156,129139
30994,32,State - KERALA,Total,55-59,Graduate,65431,42895,108326
30995,32,State - KERALA,Total,60-64,Graduate,51508,27949,79457
30996,32,State - KERALA,Total,65-69,Graduate,29722,13294,43016
30997,32,State - KERALA,Total,70-74,Graduate,18366,6778,25144
30998,32,State - KERALA,Total,75-79,Graduate,11305,3591,14896
30999,32,State - KERALA,Total,80+,Graduate,7809,2901,10710
31000,32,State - KERALA,Total,Age not stated,Graduate,876,1242,2118
31001,32,State - KERALA,Rural,All ages,Graduate,462498,567993,1030491
31002,32,State - KERALA,Rural,0-6,Graduate,0,0,0
31003,32,State - KERALA,Rural,7,Graduate,0,0,0
31004,32,State - KERALA,Rural,8,Graduate,0,0,0
31005,32,State - KERALA,Rural,9,Graduate,0,0,0
31006,32,State - KERALA,Rural,10,Graduate,0,0,0
31007,32,State - KERALA,Rural,11,Graduate,0,0,0
31008,32,State - KERALA,Rural,12,Graduate,0,0,0
31009,32,State - KERALA,Rural,13,Graduate,0,0,0
31010,32,State - KERALA,Rural,14,Graduate,0,0,0
31011,32,State - KERALA,Rural,15,Graduate,0,0,0
31012,32,State - KERALA,Rural,16,Graduate,0,0,0
31013,32,State - KERALA,Rural,17,Graduate,0,0,0
31014,32,State - KERALA,Rural,18,Graduate,0,0,0
31015,32,State - KERALA,Rural,19,Graduate,0,0,0
31016,32,State - KERALA,Rural,20-24,Graduate,99046,141682,240728
31017,32,State - KERALA,Rural,25-29,Graduate,89652,140912,230564
31018,32,State - KERALA,Rural,30-34,Graduate,59092,89888,148980
31019,32,State - KERALA,Rural,35-39,Graduate,52114,71029,123143
31020,32,State - KERALA,Rural,40-44,Graduate,42459,45243,87702
31021,32,State - KERALA,Rural,45-49,Graduate,35385,31375,66760
31022,32,State - KERALA,Rural,50-54,Graduate,25386,18822,44208
31023,32,State - KERALA,Rural,55-59,Graduate,21658,13287,34945
31024,32,State - KERALA,Rural,60-64,Graduate,16722,8199,24921
31025,32,State - KERALA,Rural,65-69,Graduate,9185,3690,12875
31026,32,State - KERALA,Rural,70-74,Graduate,5443,1713,7156
31027,32,State - KERALA,Rural,75-79,Graduate,3566,903,4469
31028,32,State - KERALA,Rural,80+,Graduate,2431,780,3211
31029,32,State - KERALA,Rural,Age not stated,Graduate,359,470,829
31030,32,State - KERALA,Urban,All ages,Graduate,668838,831992,1500830
31031,32,State - KERALA,Urban,0-6,Graduate,0,0,0
31032,32,State - KERALA,Urban,7,Graduate,0,0,0
31033,32,State - KERALA,Urban,8,Graduate,0,0,0
31034,32,State - KERALA,Urban,9,Graduate,0,0,0
31035,32,State - KERALA,Urban,10,Graduate,0,0,0
31036,32,State - KERALA,Urban,11,Graduate,0,0,0
31037,32,State - KERALA,Urban,12,Graduate,0,0,0
31038,32,State - KERALA,Urban,13,Graduate,0,0,0
31039,32,State - KERALA,Urban,14,Graduate,0,0,0
31040,32,State - KERALA,Urban,15,Graduate,0,0,0
31041,32,State - KERALA,Urban,16,Graduate,0,0,0
31042,32,State - KERALA,Urban,17,Graduate,0,0,0
31043,32,State - KERALA,Urban,18,Graduate,0,0,0
31044,32,State - KERALA,Urban,19,Graduate,0,0,0
31045,32,State - KERALA,Urban,20-24,Graduate,116682,177869,294551
31046,32,State - KERALA,Urban,25-29,Graduate,110063,181241,291304
31047,32,State - KERALA,Urban,30-34,Graduate,75868,125631,201499
31048,32,State - KERALA,Urban,35-39,Graduate,73219,107597,180816
31049,32,State - KERALA,Urban,40-44,Graduate,63857,75252,139109
31050,32,State - KERALA,Urban,45-49,Graduate,56899,56460,113359
31051,32,State - KERALA,Urban,50-54,Graduate,46597,38334,84931
31052,32,State - KERALA,Urban,55-59,Graduate,43773,29608,73381
31053,32,State - KERALA,Urban,60-64,Graduate,34786,19750,54536
31054,32,State - KERALA,Urban,65-69,Graduate,20537,9604,30141
31055,32,State - KERALA,Urban,70-74,Graduate,12923,5065,17988
31056,32,State - KERALA,Urban,75-79,Graduate,7739,2688,10427
31057,32,State - KERALA,Urban,80+,Graduate,5378,2121,7499
31058,32,State - KERALA,Urban,Age not stated,Graduate,517,772,1289
31059,33,State - TAMIL NADU,Total,All ages,Graduate,3119342,2338400,5457742
31060,33,State - TAMIL NADU,Total,0-6,Graduate,0,0,0
31061,33,State - TAMIL NADU,Total,7,Graduate,0,0,0
31062,33,State - TAMIL NADU,Total,8,Graduate,0,0,0
31063,33,State - TAMIL NADU,Total,9,Graduate,0,0,0
31064,33,State - TAMIL NADU,Total,10,Graduate,0,0,0
31065,33,State - TAMIL NADU,Total,11,Graduate,0,0,0
31066,33,State - TAMIL NADU,Total,12,Graduate,0,0,0
31067,33,State - TAMIL NADU,Total,13,Graduate,0,0,0
31068,33,State - TAMIL NADU,Total,14,Graduate,0,0,0
31069,33,State - TAMIL NADU,Total,15,Graduate,0,0,0
31070,33,State - TAMIL NADU,Total,16,Graduate,0,0,0
31071,33,State - TAMIL NADU,Total,17,Graduate,0,0,0
31072,33,State - TAMIL NADU,Total,18,Graduate,0,0,0
31073,33,State - TAMIL NADU,Total,19,Graduate,0,0,0
31074,33,State - TAMIL NADU,Total,20-24,Graduate,580891,595955,1176846
31075,33,State - TAMIL NADU,Total,25-29,Graduate,637944,602160,1240104
31076,33,State - TAMIL NADU,Total,30-34,Graduate,471494,397125,868619
31077,33,State - TAMIL NADU,Total,35-39,Graduate,365897,267119,633016
31078,33,State - TAMIL NADU,Total,40-44,Graduate,286543,181158,467701
31079,33,State - TAMIL NADU,Total,45-49,Graduate,227757,114126,341883
31080,33,State - TAMIL NADU,Total,50-54,Graduate,173971,70158,244129
31081,33,State - TAMIL NADU,Total,55-59,Graduate,146631,51336,197967
31082,33,State - TAMIL NADU,Total,60-64,Graduate,108740,31473,140213
31083,33,State - TAMIL NADU,Total,65-69,Graduate,52110,12903,65013
31084,33,State - TAMIL NADU,Total,70-74,Graduate,34103,6699,40802
31085,33,State - TAMIL NADU,Total,75-79,Graduate,17958,3190,21148
31086,33,State - TAMIL NADU,Total,80+,Graduate,12592,3347,15939
31087,33,State - TAMIL NADU,Total,Age not stated,Graduate,2711,1651,4362
31088,33,State - TAMIL NADU,Rural,All ages,Graduate,828750,509018,1337768
31089,33,State - TAMIL NADU,Rural,0-6,Graduate,0,0,0
31090,33,State - TAMIL NADU,Rural,7,Graduate,0,0,0
31091,33,State - TAMIL NADU,Rural,8,Graduate,0,0,0
31092,33,State - TAMIL NADU,Rural,9,Graduate,0,0,0
31093,33,State - TAMIL NADU,Rural,10,Graduate,0,0,0
31094,33,State - TAMIL NADU,Rural,11,Graduate,0,0,0
31095,33,State - TAMIL NADU,Rural,12,Graduate,0,0,0
31096,33,State - TAMIL NADU,Rural,13,Graduate,0,0,0
31097,33,State - TAMIL NADU,Rural,14,Graduate,0,0,0
31098,33,State - TAMIL NADU,Rural,15,Graduate,0,0,0
31099,33,State - TAMIL NADU,Rural,16,Graduate,0,0,0
31100,33,State - TAMIL NADU,Rural,17,Graduate,0,0,0
31101,33,State - TAMIL NADU,Rural,18,Graduate,0,0,0
31102,33,State - TAMIL NADU,Rural,19,Graduate,0,0,0
31103,33,State - TAMIL NADU,Rural,20-24,Graduate,208320,180508,388828
31104,33,State - TAMIL NADU,Rural,25-29,Graduate,203574,150204,353778
31105,33,State - TAMIL NADU,Rural,30-34,Graduate,126264,78195,204459
31106,33,State - TAMIL NADU,Rural,35-39,Graduate,89801,44314,134115
31107,33,State - TAMIL NADU,Rural,40-44,Graduate,64584,26001,90585
31108,33,State - TAMIL NADU,Rural,45-49,Graduate,45381,12593,57974
31109,33,State - TAMIL NADU,Rural,50-54,Graduate,29438,6529,35967
31110,33,State - TAMIL NADU,Rural,55-59,Graduate,25191,5018,30209
31111,33,State - TAMIL NADU,Rural,60-64,Graduate,18904,2939,21843
31112,33,State - TAMIL NADU,Rural,65-69,Graduate,8158,1051,9209
31113,33,State - TAMIL NADU,Rural,70-74,Graduate,4608,501,5109
31114,33,State - TAMIL NADU,Rural,75-79,Graduate,1991,221,2212
31115,33,State - TAMIL NADU,Rural,80+,Graduate,1402,446,1848
31116,33,State - TAMIL NADU,Rural,Age not stated,Graduate,1134,498,1632
31117,33,State - TAMIL NADU,Urban,All ages,Graduate,2290592,1829382,4119974
31118,33,State - TAMIL NADU,Urban,0-6,Graduate,0,0,0
31119,33,State - TAMIL NADU,Urban,7,Graduate,0,0,0
31120,33,State - TAMIL NADU,Urban,8,Graduate,0,0,0
31121,33,State - TAMIL NADU,Urban,9,Graduate,0,0,0
31122,33,State - TAMIL NADU,Urban,10,Graduate,0,0,0
31123,33,State - TAMIL NADU,Urban,11,Graduate,0,0,0
31124,33,State - TAMIL NADU,Urban,12,Graduate,0,0,0
31125,33,State - TAMIL NADU,Urban,13,Graduate,0,0,0
31126,33,State - TAMIL NADU,Urban,14,Graduate,0,0,0
31127,33,State - TAMIL NADU,Urban,15,Graduate,0,0,0
31128,33,State - TAMIL NADU,Urban,16,Graduate,0,0,0
31129,33,State - TAMIL NADU,Urban,17,Graduate,0,0,0
31130,33,State - TAMIL NADU,Urban,18,Graduate,0,0,0
31131,33,State - TAMIL NADU,Urban,19,Graduate,0,0,0
31132,33,State - TAMIL NADU,Urban,20-24,Graduate,372571,415447,788018
31133,33,State - TAMIL NADU,Urban,25-29,Graduate,434370,451956,886326
31134,33,State - TAMIL NADU,Urban,30-34,Graduate,345230,318930,664160
31135,33,State - TAMIL NADU,Urban,35-39,Graduate,276096,222805,498901
31136,33,State - TAMIL NADU,Urban,40-44,Graduate,221959,155157,377116
31137,33,State - TAMIL NADU,Urban,45-49,Graduate,182376,101533,283909
31138,33,State - TAMIL NADU,Urban,50-54,Graduate,144533,63629,208162
31139,33,State - TAMIL NADU,Urban,55-59,Graduate,121440,46318,167758
31140,33,State - TAMIL NADU,Urban,60-64,Graduate,89836,28534,118370
31141,33,State - TAMIL NADU,Urban,65-69,Graduate,43952,11852,55804
31142,33,State - TAMIL NADU,Urban,70-74,Graduate,29495,6198,35693
31143,33,State - TAMIL NADU,Urban,75-79,Graduate,15967,2969,18936
31144,33,State - TAMIL NADU,Urban,80+,Graduate,11190,2901,14091
31145,33,State - TAMIL NADU,Urban,Age not stated,Graduate,1577,1153,2730
31146,34,State - PUDUCHERRY,Total,All ages,Graduate,79482,62547,142029
31147,34,State - PUDUCHERRY,Total,0-6,Graduate,0,0,0
31148,34,State - PUDUCHERRY,Total,7,Graduate,0,0,0
31149,34,State - PUDUCHERRY,Total,8,Graduate,0,0,0
31150,34,State - PUDUCHERRY,Total,9,Graduate,0,0,0
31151,34,State - PUDUCHERRY,Total,10,Graduate,0,0,0
31152,34,State - PUDUCHERRY,Total,11,Graduate,0,0,0
31153,34,State - PUDUCHERRY,Total,12,Graduate,0,0,0
31154,34,State - PUDUCHERRY,Total,13,Graduate,0,0,0
31155,34,State - PUDUCHERRY,Total,14,Graduate,0,0,0
31156,34,State - PUDUCHERRY,Total,15,Graduate,0,0,0
31157,34,State - PUDUCHERRY,Total,16,Graduate,0,0,0
31158,34,State - PUDUCHERRY,Total,17,Graduate,0,0,0
31159,34,State - PUDUCHERRY,Total,18,Graduate,0,0,0
31160,34,State - PUDUCHERRY,Total,19,Graduate,0,0,0
31161,34,State - PUDUCHERRY,Total,20-24,Graduate,11903,13721,25624
31162,34,State - PUDUCHERRY,Total,25-29,Graduate,14750,16693,31443
31163,34,State - PUDUCHERRY,Total,30-34,Graduate,12533,11825,24358
31164,34,State - PUDUCHERRY,Total,35-39,Graduate,10769,7908,18677
31165,34,State - PUDUCHERRY,Total,40-44,Graduate,8410,4752,13162
31166,34,State - PUDUCHERRY,Total,45-49,Graduate,6669,3072,9741
31167,34,State - PUDUCHERRY,Total,50-54,Graduate,5126,1855,6981
31168,34,State - PUDUCHERRY,Total,55-59,Graduate,3947,1276,5223
31169,34,State - PUDUCHERRY,Total,60-64,Graduate,2630,678,3308
31170,34,State - PUDUCHERRY,Total,65-69,Graduate,1203,322,1525
31171,34,State - PUDUCHERRY,Total,70-74,Graduate,761,203,964
31172,34,State - PUDUCHERRY,Total,75-79,Graduate,406,110,516
31173,34,State - PUDUCHERRY,Total,80+,Graduate,331,102,433
31174,34,State - PUDUCHERRY,Total,Age not stated,Graduate,44,30,74
31175,34,State - PUDUCHERRY,Rural,All ages,Graduate,13620,9824,23444
31176,34,State - PUDUCHERRY,Rural,0-6,Graduate,0,0,0
31177,34,State - PUDUCHERRY,Rural,7,Graduate,0,0,0
31178,34,State - PUDUCHERRY,Rural,8,Graduate,0,0,0
31179,34,State - PUDUCHERRY,Rural,9,Graduate,0,0,0
31180,34,State - PUDUCHERRY,Rural,10,Graduate,0,0,0
31181,34,State - PUDUCHERRY,Rural,11,Graduate,0,0,0
31182,34,State - PUDUCHERRY,Rural,12,Graduate,0,0,0
31183,34,State - PUDUCHERRY,Rural,13,Graduate,0,0,0
31184,34,State - PUDUCHERRY,Rural,14,Graduate,0,0,0
31185,34,State - PUDUCHERRY,Rural,15,Graduate,0,0,0
31186,34,State - PUDUCHERRY,Rural,16,Graduate,0,0,0
31187,34,State - PUDUCHERRY,Rural,17,Graduate,0,0,0
31188,34,State - PUDUCHERRY,Rural,18,Graduate,0,0,0
31189,34,State - PUDUCHERRY,Rural,19,Graduate,0,0,0
31190,34,State - PUDUCHERRY,Rural,20-24,Graduate,2778,2877,5655
31191,34,State - PUDUCHERRY,Rural,25-29,Graduate,3189,3197,6386
31192,34,State - PUDUCHERRY,Rural,30-34,Graduate,2405,1815,4220
31193,34,State - PUDUCHERRY,Rural,35-39,Graduate,1864,987,2851
31194,34,State - PUDUCHERRY,Rural,40-44,Graduate,1208,438,1646
31195,34,State - PUDUCHERRY,Rural,45-49,Graduate,812,224,1036
31196,34,State - PUDUCHERRY,Rural,50-54,Graduate,518,109,627
31197,34,State - PUDUCHERRY,Rural,55-59,Graduate,404,81,485
31198,34,State - PUDUCHERRY,Rural,60-64,Graduate,232,42,274
31199,34,State - PUDUCHERRY,Rural,65-69,Graduate,98,17,115
31200,34,State - PUDUCHERRY,Rural,70-74,Graduate,48,12,60
31201,34,State - PUDUCHERRY,Rural,75-79,Graduate,19,3,22
31202,34,State - PUDUCHERRY,Rural,80+,Graduate,27,7,34
31203,34,State - PUDUCHERRY,Rural,Age not stated,Graduate,18,15,33
31204,34,State - PUDUCHERRY,Urban,All ages,Graduate,65862,52723,118585
31205,34,State - PUDUCHERRY,Urban,0-6,Graduate,0,0,0
31206,34,State - PUDUCHERRY,Urban,7,Graduate,0,0,0
31207,34,State - PUDUCHERRY,Urban,8,Graduate,0,0,0
31208,34,State - PUDUCHERRY,Urban,9,Graduate,0,0,0
31209,34,State - PUDUCHERRY,Urban,10,Graduate,0,0,0
31210,34,State - PUDUCHERRY,Urban,11,Graduate,0,0,0
31211,34,State - PUDUCHERRY,Urban,12,Graduate,0,0,0
31212,34,State - PUDUCHERRY,Urban,13,Graduate,0,0,0
31213,34,State - PUDUCHERRY,Urban,14,Graduate,0,0,0
31214,34,State - PUDUCHERRY,Urban,15,Graduate,0,0,0
31215,34,State - PUDUCHERRY,Urban,16,Graduate,0,0,0
31216,34,State - PUDUCHERRY,Urban,17,Graduate,0,0,0
31217,34,State - PUDUCHERRY,Urban,18,Graduate,0,0,0
31218,34,State - PUDUCHERRY,Urban,19,Graduate,0,0,0
31219,34,State - PUDUCHERRY,Urban,20-24,Graduate,9125,10844,19969
31220,34,State - PUDUCHERRY,Urban,25-29,Graduate,11561,13496,25057
31221,34,State - PUDUCHERRY,Urban,30-34,Graduate,10128,10010,20138
31222,34,State - PUDUCHERRY,Urban,35-39,Graduate,8905,6921,15826
31223,34,State - PUDUCHERRY,Urban,40-44,Graduate,7202,4314,11516
31224,34,State - PUDUCHERRY,Urban,45-49,Graduate,5857,2848,8705
31225,34,State - PUDUCHERRY,Urban,50-54,Graduate,4608,1746,6354
31226,34,State - PUDUCHERRY,Urban,55-59,Graduate,3543,1195,4738
31227,34,State - PUDUCHERRY,Urban,60-64,Graduate,2398,636,3034
31228,34,State - PUDUCHERRY,Urban,65-69,Graduate,1105,305,1410
31229,34,State - PUDUCHERRY,Urban,70-74,Graduate,713,191,904
31230,34,State - PUDUCHERRY,Urban,75-79,Graduate,387,107,494
31231,34,State - PUDUCHERRY,Urban,80+,Graduate,304,95,399
31232,34,State - PUDUCHERRY,Urban,Age not stated,Graduate,26,15,41
31233,35,State - ANDAMAN & NICOBAR ISLANDS,Total,All ages,Graduate,13622,10537,24159
31234,35,State - ANDAMAN & NICOBAR ISLANDS,Total,0-6,Graduate,0,0,0
31235,35,State - ANDAMAN & NICOBAR ISLANDS,Total,7,Graduate,0,0,0
31236,35,State - ANDAMAN & NICOBAR ISLANDS,Total,8,Graduate,0,0,0
31237,35,State - ANDAMAN & NICOBAR ISLANDS,Total,9,Graduate,0,0,0
31238,35,State - ANDAMAN & NICOBAR ISLANDS,Total,10,Graduate,0,0,0
31239,35,State - ANDAMAN & NICOBAR ISLANDS,Total,11,Graduate,0,0,0
31240,35,State - ANDAMAN & NICOBAR ISLANDS,Total,12,Graduate,0,0,0
31241,35,State - ANDAMAN & NICOBAR ISLANDS,Total,13,Graduate,0,0,0
31242,35,State - ANDAMAN & NICOBAR ISLANDS,Total,14,Graduate,0,0,0
31243,35,State - ANDAMAN & NICOBAR ISLANDS,Total,15,Graduate,0,0,0
31244,35,State - ANDAMAN & NICOBAR ISLANDS,Total,16,Graduate,0,0,0
31245,35,State - ANDAMAN & NICOBAR ISLANDS,Total,17,Graduate,0,0,0
31246,35,State - ANDAMAN & NICOBAR ISLANDS,Total,18,Graduate,0,0,0
31247,35,State - ANDAMAN & NICOBAR ISLANDS,Total,19,Graduate,0,0,0
31248,35,State - ANDAMAN & NICOBAR ISLANDS,Total,20-24,Graduate,1488,1849,3337
31249,35,State - ANDAMAN & NICOBAR ISLANDS,Total,25-29,Graduate,2710,2689,5399
31250,35,State - ANDAMAN & NICOBAR ISLANDS,Total,30-34,Graduate,2379,1956,4335
31251,35,State - ANDAMAN & NICOBAR ISLANDS,Total,35-39,Graduate,2020,1521,3541
31252,35,State - ANDAMAN & NICOBAR ISLANDS,Total,40-44,Graduate,1818,1189,3007
31253,35,State - ANDAMAN & NICOBAR ISLANDS,Total,45-49,Graduate,1319,682,2001
31254,35,State - ANDAMAN & NICOBAR ISLANDS,Total,50-54,Graduate,867,359,1226
31255,35,State - ANDAMAN & NICOBAR ISLANDS,Total,55-59,Graduate,573,176,749
31256,35,State - ANDAMAN & NICOBAR ISLANDS,Total,60-64,Graduate,238,56,294
31257,35,State - ANDAMAN & NICOBAR ISLANDS,Total,65-69,Graduate,106,14,120
31258,35,State - ANDAMAN & NICOBAR ISLANDS,Total,70-74,Graduate,48,15,63
31259,35,State - ANDAMAN & NICOBAR ISLANDS,Total,75-79,Graduate,23,10,33
31260,35,State - ANDAMAN & NICOBAR ISLANDS,Total,80+,Graduate,21,13,34
31261,35,State - ANDAMAN & NICOBAR ISLANDS,Total,Age not stated,Graduate,12,8,20
31262,35,State - ANDAMAN & NICOBAR ISLANDS,Rural,All ages,Graduate,5335,3623,8958
31263,35,State - ANDAMAN & NICOBAR ISLANDS,Rural,0-6,Graduate,0,0,0
31264,35,State - ANDAMAN & NICOBAR ISLANDS,Rural,7,Graduate,0,0,0
31265,35,State - ANDAMAN & NICOBAR ISLANDS,Rural,8,Graduate,0,0,0
31266,35,State - ANDAMAN & NICOBAR ISLANDS,Rural,9,Graduate,0,0,0
31267,35,State - ANDAMAN & NICOBAR ISLANDS,Rural,10,Graduate,0,0,0
31268,35,State - ANDAMAN & NICOBAR ISLANDS,Rural,11,Graduate,0,0,0
31269,35,State - ANDAMAN & NICOBAR ISLANDS,Rural,12,Graduate,0,0,0
31270,35,State - ANDAMAN & NICOBAR ISLANDS,Rural,13,Graduate,0,0,0
31271,35,State - ANDAMAN & NICOBAR ISLANDS,Rural,14,Graduate,0,0,0
31272,35,State - ANDAMAN & NICOBAR ISLANDS,Rural,15,Graduate,0,0,0
31273,35,State - ANDAMAN & NICOBAR ISLANDS,Rural,16,Graduate,0,0,0
31274,35,State - ANDAMAN & NICOBAR ISLANDS,Rural,17,Graduate,0,0,0
31275,35,State - ANDAMAN & NICOBAR ISLANDS,Rural,18,Graduate,0,0,0
31276,35,State - ANDAMAN & NICOBAR ISLANDS,Rural,19,Graduate,0,0,0
31277,35,State - ANDAMAN & NICOBAR ISLANDS,Rural,20-24,Graduate,522,642,1164
31278,35,State - ANDAMAN & NICOBAR ISLANDS,Rural,25-29,Graduate,1084,1063,2147
31279,35,State - ANDAMAN & NICOBAR ISLANDS,Rural,30-34,Graduate,1061,729,1790
31280,35,State - ANDAMAN & NICOBAR ISLANDS,Rural,35-39,Graduate,910,533,1443
31281,35,State - ANDAMAN & NICOBAR ISLANDS,Rural,40-44,Graduate,735,362,1097
31282,35,State - ANDAMAN & NICOBAR ISLANDS,Rural,45-49,Graduate,483,166,649
31283,35,State - ANDAMAN & NICOBAR ISLANDS,Rural,50-54,Graduate,264,70,334
31284,35,State - ANDAMAN & NICOBAR ISLANDS,Rural,55-59,Graduate,156,37,193
31285,35,State - ANDAMAN & NICOBAR ISLANDS,Rural,60-64,Graduate,60,8,68
31286,35,State - ANDAMAN & NICOBAR ISLANDS,Rural,65-69,Graduate,34,4,38
31287,35,State - ANDAMAN & NICOBAR ISLANDS,Rural,70-74,Graduate,7,0,7
31288,35,State - ANDAMAN & NICOBAR ISLANDS,Rural,75-79,Graduate,7,4,11
31289,35,State - ANDAMAN & NICOBAR ISLANDS,Rural,80+,Graduate,7,4,11
31290,35,State - ANDAMAN & NICOBAR ISLANDS,Rural,Age not stated,Graduate,5,1,6
31291,35,State - ANDAMAN & NICOBAR ISLANDS,Urban,All ages,Graduate,8287,6914,15201
31292,35,State - ANDAMAN & NICOBAR ISLANDS,Urban,0-6,Graduate,0,0,0
31293,35,State - ANDAMAN & NICOBAR ISLANDS,Urban,7,Graduate,0,0,0
31294,35,State - ANDAMAN & NICOBAR ISLANDS,Urban,8,Graduate,0,0,0
31295,35,State - ANDAMAN & NICOBAR ISLANDS,Urban,9,Graduate,0,0,0
31296,35,State - ANDAMAN & NICOBAR ISLANDS,Urban,10,Graduate,0,0,0
31297,35,State - ANDAMAN & NICOBAR ISLANDS,Urban,11,Graduate,0,0,0
31298,35,State - ANDAMAN & NICOBAR ISLANDS,Urban,12,Graduate,0,0,0
31299,35,State - ANDAMAN & NICOBAR ISLANDS,Urban,13,Graduate,0,0,0
31300,35,State - ANDAMAN & NICOBAR ISLANDS,Urban,14,Graduate,0,0,0
31301,35,State - ANDAMAN & NICOBAR ISLANDS,Urban,15,Graduate,0,0,0
31302,35,State - ANDAMAN & NICOBAR ISLANDS,Urban,16,Graduate,0,0,0
31303,35,State - ANDAMAN & NICOBAR ISLANDS,Urban,17,Graduate,0,0,0
31304,35,State - ANDAMAN & NICOBAR ISLANDS,Urban,18,Graduate,0,0,0
31305,35,State - ANDAMAN & NICOBAR ISLANDS,Urban,19,Graduate,0,0,0
31306,35,State - ANDAMAN & NICOBAR ISLANDS,Urban,20-24,Graduate,966,1207,2173
31307,35,State - ANDAMAN & NICOBAR ISLANDS,Urban,25-29,Graduate,1626,1626,3252
31308,35,State - ANDAMAN & NICOBAR ISLANDS,Urban,30-34,Graduate,1318,1227,2545
31309,35,State - ANDAMAN & NICOBAR ISLANDS,Urban,35-39,Graduate,1110,988,2098
31310,35,State - ANDAMAN & NICOBAR ISLANDS,Urban,40-44,Graduate,1083,827,1910
31311,35,State - ANDAMAN & NICOBAR ISLANDS,Urban,45-49,Graduate,836,516,1352
31312,35,State - ANDAMAN & NICOBAR ISLANDS,Urban,50-54,Graduate,603,289,892
31313,35,State - ANDAMAN & NICOBAR ISLANDS,Urban,55-59,Graduate,417,139,556
31314,35,State - ANDAMAN & NICOBAR ISLANDS,Urban,60-64,Graduate,178,48,226
31315,35,State - ANDAMAN & NICOBAR ISLANDS,Urban,65-69,Graduate,72,10,82
31316,35,State - ANDAMAN & NICOBAR ISLANDS,Urban,70-74,Graduate,41,15,56
31317,35,State - ANDAMAN & NICOBAR ISLANDS,Urban,75-79,Graduate,16,6,22
31318,35,State - ANDAMAN & NICOBAR ISLANDS,Urban,80+,Graduate,14,9,23
31319,35,State - ANDAMAN & NICOBAR ISLANDS,Urban,Age not stated,Graduate,7,7,14
